春，正月，甲申，魏主备法驾，诣道坛受符，旗帜尽青	春季，正月，甲申，北魏国主拓跋焘备好车驾，打着全青色的旗帜来到道教神坛前接受符
自是每帝即位皆受	从此以后，北魏每位皇帝即位时都要接受符
谦之又奏作静轮宫，必令其高不闻鸡犬，欲以上接天神	寇谦之又奏请建造静轮宫，并一定要建得很高，高到人在上面听不到鸡鸣犬吠之声，目的是想伸向天上与天神相接
崔浩劝帝为之，功费万计，经年不成	宰相崔浩也力劝拓跋焘兴建，花费了数以万计的财力物力，建了几年仍未完工
太子晃谏曰：天人道殊，卑高定分，不可相接，理在必然	太子拓跋晃劝谏太武帝说：上天与世人的道不同，谁高谁低已有定分，二者不能相接，这是理所当然的事
今虚耗府库，疲弊百姓，为无益之事，将安用之	现在我们白白地浪费财力物力，老百姓也累得疲惫不堪，做这种无益的事，干什么用呢
必如谦之所言，请因东山万仞之高，为功差易	如果一定要照寇谦之所说的去做，我请求建造在万仞高的东山上，这样做，工事就容易些
帝不从	拓跋焘没有接受
夏，四月，沮渠无讳将万余家，弃敦煌西就沮渠安周	夏季，四月，沮渠无讳率领一万多家舍弃敦煌，西去沮渠安周那里与他会合
未至，鄯善王比龙畏之，将其众奔且末，其世子降于安周	还没有到，鄯善王比龙很害怕，率领人马逃到且末，他的嫡长子向沮渠安周投降
无讳遂据鄯善，其士卒经流沙渴死者太半	沮渠无讳于是占据了鄯善，但他的士卒在过沙漠地区时因干渴而死亡的人超过了一半
甲戌，上以疾愈，大赦	甲戌，刘宋文帝刘义隆因病痊愈，实行大赦
甲戌晦，日有食之	甲戌晦，出现日食
冬，十月，己卯，魏立皇子伏罗为晋王，翰为秦王，谭为燕王，建为楚王，余为吴王	冬季，十月，己卯，北魏封皇子拓跋伏罗为晋王，拓跋翰为秦王，拓跋谭为燕王，拓跋建为楚王，拓跋余为吴王
甲申，柔然遣使诣建康	甲申，柔然派使节到宋都城建康
十二月，辛巳，魏襄城孝王卢鲁元卒	十二月，辛巳，北魏襄城孝王卢鲁元去世
雍州刺史晋安襄侯刘道产卒	刘宋雍州刺史晋安襄侯刘道产去世
道产善为政，民安其业，小大丰赡，由是民间有《襄阳乐歌》	刘道产善于治理政务，老百姓安居乐业，户户富庶，因此，民间流传有《襄阳乐歌》
山蛮前后不可制者皆出，缘沔为村落，户口殷盛	一直藏在山中没人能制服的山蛮都走出深山，沿着沔水定居下来，而且人丁兴旺
及卒，蛮追送至沔口	刘道产死后，山蛮们一直送他的灵柩到沔口
未几，群蛮大动，征西司马朱之讨之，不利；诏建威将军沈庆之代之，杀虏万余人	不久，山蛮纷纷叛乱，征西司马朱之出兵讨伐，没有成功；文帝诏令建威将军沈庆之代替朱之前去讨伐山蛮，结果杀伤俘虏山蛮一万多人
甲午，立皇子诞为广陵王	甲午，刘宋立皇子刘诞为广陵王
丁酉，魏大赦	丁酉，北魏实行大赦
己亥，魏主如阴山	己亥，北魏国主拓跋焘前去阴山
甲子，前雍州刺史刘真道、梁・南秦二州刺史裴方明坐破仇池减匿金宝及善马，下狱死	甲子，刘宋前雍州刺史刘真道，梁、南秦二州刺史裴方明被查出在仇池侵吞金银财宝及良马一事，被抓进牢狱，处以死刑
春，正月，己亥，帝耕藉田，大赦	春季，正月，己亥，刘宋文帝举行亲耕仪式，实行大赦
二月，辛未，魏中山王辰、内都坐大官薛辨、尚书奚眷等八将坐击柔然后期，斩于都南	二月，辛未，北魏中山王拓跋辰、内都坐大官薜辨、尚书奚眷等八名将领因在攻打柔然时没能按时到达，在平城南郊被斩首
庚辰，魏主幸庐	庚辰，北魏国主来到卢地
己丑，江夏王义恭进位太尉，领司徒	己丑，刘宋江夏王刘义恭晋升太尉，兼任司徒
庚寅，以侍中、领右卫将军沈演之为中领军，左卫将军范晔为太子詹事	庚寅，刘宋任命侍中、兼右卫将军沈演之为中领军，左卫将军范晔为太子詹事
辛卯，立皇子宏为建平王	辛卯，刘宋立皇子刘宏为建平王
三月，甲辰，魏主还宫	三月，甲辰，北魏国主回到皇宫
癸丑，魏主遣司空长孙道生镇统万	癸丑，北魏国主派司空长孙道生镇守统万
夏，四月，乙亥，魏侍中、太宰、阳平王杜超为帐下所杀	夏季，四月，乙亥，北魏侍中、太宰、阳平王杜超被手下的卫士杀死
六月，魏北部民杀立义将军衡阳公莫孤，帅五千余落北走，遣兵追击之，至漠南，杀其渠师，余徒冀、相、定三州为营户	六月，北魏北方地区百姓杀了立义将军衡阳公莫孤，聚集五千多帐落向北逃去，北魏朝廷派兵前去追击，追到漠南，杀了他们的首领，其余的百姓则迁到冀、相、定三州成为营户
吐谷浑王慕利延兄子纬世与魏使者谋降魏，慕利延杀之	吐谷浑可汗慕容慕利延的侄子慕容纬世同北魏使节密谋要向北魏投降，慕容慕利延杀了他
是月，纬世弟叱力延等八人奔魏，魏以叱力延为归义王	这个月，慕容纬世的弟弟慕容叱力延等八人投奔北魏，北魏朝廷封慕容叱力延为归义王
沮渠无讳卒，弟安周代立	沮渠无讳去世，其弟沮渠安周代替他为王
魏入中国以来，虽颇用古礼祀天地、宗庙、百神，而犹循其旧俗，所祀胡神甚众	北魏进入中原以来，虽然也常常使用古代礼仪来祭祀天地、祖庙和各种神灵，却仍在沿循旧有习俗，祭祀的胡族神很多
崔浩请存合于祀典者五十七所，其余复重及小神悉罢之	司徒崔浩请求只留下符合祭祀典章的五十七所寺庙，其余重复的寺庙和过小的神祗都取消
魏主从之	北魏国主同意他的建议
秋，七月，癸卯，魏东雍州刺史沮渠秉谋反，伏诛	秋季，七月，癸卯，北魏东雍州刺史沮渠秉图谋造反，被朝廷处死
魏主使员外散骑常侍高济来聘	北魏国主拓跋焘派员外散骑常侍高济去刘宋探访
戊辰，以荆州刺史衡阳王义季为征北大将军、开府仪同三司、南兖州刺史，以南谯夫义宣为荆州刺史	戊辰，刘宋朝廷任命荆州刺史衡阳王刘义季为征北大将军、开府仪同三司和南兖州刺史，南谯王刘义宣为荆州刺史
初，帝以义宣不才，故不用，会稽公主屡以为言，帝不得已用之	当初，文帝认为刘义宣没有什么才能，因而不用他，姐姐会稽公主总是替刘义宣说话，文帝才不得不用他
先赐中诏敕之曰：师护以在西久，比表求还，今欲听许，以汝代之	正式诏令下达之前，文帝先给他下了一份手诏，告诫他说：师护在西边呆得时间太长了，近来表奏要求回来，现在我打算答应他，让你接替他的职务
师护虽无殊绩，洁已节用，通怀期物，不恣群下，声著西土，为士庶所安，论者乃未议迁之	师护虽然没有特殊的成就，但他洁身自好，俭朴廉正，胸怀宽广，待人诚实，不骄纵属下，因而其声名在西部广为传诵，被士族和平民所拥戴，监察论政的人才没有提出调他离任的动议
今之回换，更为汝与师护年时一辈，欲各试其能	现在我换了你，还是因为你跟师护辈份一样，想试试你们各自的能力
汝往，脱有一事减之者，既于西夏交有巨碍，迁代之讥，必归责于吾矣	你去西边，假若有一件事处理得不如他，就会同荆楚一带产生隔阂，讥刺我换人不当，将责任归于我一身
此事亦易勉耳，无为使人复生评论也	对这个差事，你也不过就是努力治理，谨慎为之罢了，不能让别人又来指指点点，说出别的话来
义宣至镇，勤自课厉，事亦修理	刘义宣到了他的住地，勤勉严格，各种事务做得也很有条不紊
吐谷浑叱力延等请师于魏以讨吐谷浑王慕利延，魏主使晋王伏罗督诸军击之	吐谷浑的慕容叱力延等请求北魏朝廷出兵讨伐吐谷浑可汗慕容慕利延，北魏国主派晋王拓跋伏罗督统各路大军袭击慕容慕利延
九月，甲辰，以沮渠安周为都督凉・河・沙三州诸军事、凉州刺史、河西王	九月，甲辰，刘宋朝廷任命沮渠安周为都督凉、河、沙三州诸军事，凉州刺史和河西王
丁未，魏主如漠南，将袭柔然，柔然敕连可汗远遁，乃止	丁未，北魏国主前去漠南，准备袭击柔然，柔然敕连可汗远远逃走，于是停止
敕连寻卒，子吐贺真立，号处罗可汗	不久，敕连可汗去世，他的儿子郁久闾吐贺真继位，号称处罗可汗
冬，十月，己卯，以左军将军徐琼为兖州刺史，大将军参军申恬为冀州刺史	冬季，十月，己卯，刘宋任命左军将军徐琼做兖州刺史，大将军参军申恬为冀州刺史
徙兖州镇须昌，冀州镇历下	将兖州的治所迁到须昌，冀州治所迁到了历下
恬，谟之弟也	申恬是申谟的弟弟
十二月魏主还平城	十二月，北魏国主回到了平城
春，正月，辛卯朔，始行新历	春季，正月，辛卯朔，刘宋开始使用新历法
初，汉京房以十二律中吕上生黄钟，不满九寸，更演为六十律	当初，西汉京房将十二音律中的中吕、上生、黄钟，凡没有超过九寸的，都改到六十音律
钱乐之复演为三百六十律，日当一管	钱乐之又把它扩大到三百六十音律
何承天立议，以为上下相生，三分损益其一，盖古人简易之法，犹如古历周天三百六十五度四分度之一也	每日使用一种乐器
而京房不悟，谬为六十	何承天提出见解，认为上下相生，于三分之中增减其一，是古人所用的简便易行的方法，如同古代历法中的能见到的天空三百六十五度四分度中的一个单位，但京房却没有明白其中的真义，而把它错误地定为六十
乃更设新律，林钟长六寸一厘，则从中吕还得黄钟，十二旋宫，声韵无失	于是，何承天改设新的音律，林钟长六寸一厘，便从中吕回到黄钟的位置，每十二律吕又回到第一音级，声韵毫无损失
壬辰，以武陵王骏为雍州刺史	壬辰，刘宋文帝任命武陵王刘骏为雍州刺史
帝欲经略关、河，故以骏镇襄阳	文帝想要收回关、河一带北方土地，因此让刘骏去镇守襄阳
魏主使散骑常侍宋来聘	北魏国主让散骑常侍宋来刘宋探访
二月，魏主如上党，西至吐京，讨徙叛胡，出配郡县	二月，北魏国主来到上党，西到吐京，征讨并迁移叛变的胡人，将他们发配到各郡县
甲戌，立皇子为东海王，昶为义阳王	甲戌，文帝立皇子刘为东海王，刘昶为义阳王
三月，庚申，魏主还宫	三月庚申，北魏国主返回平城
魏诏：诸疑狱皆付中书，以经义量决	北魏朝廷下诏说：所有有疑问的诉讼案件都交给中书，中书凭借经典来衡量裁决
夏，四月，庚戌，魏主遣征西大将军高凉王那等击吐谷浑王慕利延于白兰，秦州刺史代人封敕文、安远将军乙乌头击慕利延兄子什归于罕	夏季，四月，庚戌，北魏国主派遣征西大将军高凉王拓跋那等人在白兰袭击逃亡的吐谷浑可汗慕容慕利延，秦州刺史代郡人封敕文、安远将军乙乌头在罕向慕容慕利延的侄子慕容什归发起了进攻
六月，壬辰，魏主北巡	六月，壬辰，北魏国主到北方巡视
帝谋伐魏，罢南豫州入豫州，以南豫州刺史南平王铄为豫州刺史	文帝计划讨伐北魏，他先撤销南豫州，将其归并到豫州，任命南豫州刺史南平王刘铄为豫州刺史
秋，七月，己未，以尚书仆射孟为左仆射，中护军何尚之为右仆射	秋季，七月，己未，刘宋文帝任命尚书仆射孟为左仆射，中护军何尚之为右仆射
吐谷浑什归闻魏军将至，弃城夜遁	吐谷汗的慕容什归听说北魏军将要到达罕，他放弃城池，连夜逃走
八月，丁亥，封敕文入罕，分徙其民千家还上，留乙乌头守罕	八月，丁亥，封敕文进入罕，将一千多户百姓迁入上，让乙乌头留守罕
魏主如阴山之北，发诸州兵三分之一，各于其州戒严，以须后命	北魏国主到了阴山之北，下令发动每个州三分之一的兵力在本州警戒，等待以后命令
徙诸种杂民五千余家于北边，令就北畜牧，以饵柔然	把五千多户不同民族的居民迁移到北方边地，让他们在北方放牧牲畜，以引诱柔然
十一月，魏发冀州民造浮桥于津	十一月，北魏调遣冀州百姓在津建造浮桥
辛未，魏主还宫	辛未，北魏国主回到平城宫内
魏选六州骁骑二万，使永昌王仁、高凉王那分将之为二道，掠淮、泗以北，徙青、徐之民以实河北	北魏从六个州中选出二万骁勇骑兵，派永昌王拓跋仁、高凉王拓跋那分别统率，分二路劫淮河、泗水以北的地方，迁移青州、徐州老百姓充实河北
癸未，魏主西巡	癸未，北魏国主去西部巡察
徐湛之所陈多不尽，为晔等辞所连引，上赦不问	丹杨尹徐湛之向文帝告发，有很多没有陈说出来，被范晔等人在供词中牵连出来，但文帝赦免了他，不再追究
臧质，熹之子也，先为徐、兖二州刺史，与晔厚善，晔败，以为义兴太守	臧质是臧熹的儿子，曾经做徐、兖二州的刺史，与范晔关系很好，范晔被处死之后，文帝调他做了义兴太守
初，江左二郊无乐，宗庙虽有登歌，亦无二舞	当初，江东南、北郊祭时还都没有音乐，皇室祖庙虽然有祭祀时唱的歌，但也没有文、武这二种舞蹈
是岁，南郊始设登歌	这一年，南郊祭祀开始作了祭祀歌
春，正月，庚申，尚书左仆射孟罢	春季，正月，庚申，刘宋尚书左仆射孟被免职
魏主徙长安工巧二千家于平城	北魏国主将长安的工匠、巧匠二千户迁到平城
还，至洛水，分军诛李闰叛羌	回师，走到洛水，北魏国主又派出部分军队诛杀以李闰为首反叛的羌族部落
太原颜白鹿私入魏境，为魏人所得，将杀之，诈云青州刺史杜骥使其归诚	刘宋太原人颜白鹿私下进入北魏境内，被北魏抓获，要杀他，他欺骗对方说，青州刺史杜骥派他来归降北魏
魏人送白鹿诣平城，魏主喜曰：我外家也	北魏人将颜白鹿送到平城，北魏国主高兴地说：杜骥是我外公的一家子
使崔浩作书与骥，且命永昌王仁、高凉王那将兵迎骥，攻冀州刺史申恬于历城；杜骥遣其府司马夏侯祖欢等将兵救历城	北魏国主让崔浩给杜骥写信，并且命令永昌王拓跋仁、高凉王拓跋那率军迎接杜骥，并到历城攻伐冀州刺史申恬
魏人遂寇兖、青、冀三州，至清东而还，杀掠甚众，北边骚动	杜骥派他的司马夏侯祖欢等人统率军队前去历城援救，北魏军队攻打兖、青、冀三州，直打到清水东边才回来，诛杀掳掠了许多人，刘宋北部边境的百姓深感不安，有些骚动
夏，四月，甲申，魏主至长安	夏季，四月，甲申，北魏国主到达长安
丁未，大赦	丁未，刘宋实行大赦
盖吴收兵屯杏城，自号秦地王，声势复振	北魏叛民领盖吴收集残余部众屯居杏城，自封秦地王，声势又高涨起来
魏主遣永昌王仁，高凉王那督北道诸军计之	北魏国主派永昌王拓跋仁、高凉王拓跋那督统北道各路军队前去讨伐
六月，癸未朔，日有食之	六月，癸未朔，出现日食
甲申，魏发冀、相、定三州兵二万人屯长安南山诸谷，以备盖吴窜逸	甲申，北魏出动冀、相、定三州二万兵，屯驻长安南山各个山谷中，防备盖吴败后窜逃到别的地方去
丙戌，又发司、幽、定、冀四州兵十万人筑畿上塞围，起上谷，西至河，广纵千里	丙戌，又出动司、幽、定、冀四州十万兵修筑京畿外围的要塞，这一工程东起上谷、西到黄河，绵延覆盖达一千里
帝筑北堤，立玄武湖，筑景阳山于华林园	刘宋文帝下令修筑北堤，建造玄武湖，在华林园建造景阳山
是岁，吐谷浑复还旧土	这一年，吐谷浑汗国又回到过去的土地上生活
春，正月，甲戌，大赦	春季，正月，甲戌，刘宋实行大赦
癸未，魏主如中山	癸未，北魏国主拓跋焘前往中山
魏人徒定州丁零三千家于平城	北魏将定州的丁零部落三千户迁到了平城
六月，魏西征诸将扶风公处真等八人，坐盗没军资及虏掠赃各千万计，并斩之	六月，北魏西征诸将领扶风公拓跋处真等八名大将因盗卖和吞没军用物资，及抢夺掳掠赃物每人各得钱财数以千万计，一起被处死
秋，八月，乙未，徐州刺史衡阳文王义季卒	秋季，八月，乙未，刘宋徐州刺史衡阳文王刘义季去世
义季自彭城王义康之贬，遂纵酒不事事	自从彭城王刘义康被贬后，刘义季就开始纵酒，不做他应该做的事
帝以书诮责，且戒之；义季犹酣饮自若，以至成疾而终	文帝写信讥讽责备，并且劝诫他，刘义季还是一如既往地豪饮不止，以致因酗酒过度成病而死
魏乐安宣王范卒	北魏乐安宣王拓跋范去世
十一月，甲寅，封皇子浑为汝阴王	十一月，甲寅，封皇子刘浑为汝阴王
十二月，魏晋王伏罗卒	十二月，北魏晋王拓跋伏罗去世
杨文德据葭芦城，招诱氐、羌，武都等五郡氐皆附之	杨文德占据了北魏的葭芦城，并招抚诱降氐、羌族人，武都等五个郡的氐人全部归附
春，正月，魏仇池镇将皮豹子帅诸军击之	春季，正月，北魏仇池镇将皮豹子率领各路大军攻伐杨文德
文德兵败，弃城奔汉中	杨文德军队战败，放弃葭芦城，逃回汉中
豹子收其妻子、僚属、军资及杨保宗所尚魏公主而还	皮豹子逮捕了杨文德的妻子、孩子、幕僚臣属，没收了他所有的军用物资，同时又逮捕了杨保宗所娶的北魏公主，大胜而回
闰月，己酉，帝大搜于宣武场	闰二月，己酉，刘宋文帝在宣武场举行阅兵大典
初，刘湛既诛，庾炳之遂见宠任，累迁吏部尚书，势倾朝野	当初，刘湛被诛杀后，吏部郎庾炳之受到文帝的宠信，官职不断升迁直到吏部尚书，其势力在朝野上下无人能及
炳之无文学，性强急轻浅	但是，庾炳之没有才学，而且性情暴躁又极浅薄
既居选部，好诟詈宾客，且多纳货赂；士大夫皆恶之	官居吏部尚书之后，喜欢污辱漫骂来访的客人，并且大肆接受贿赂，士大夫们都非常讨厌、憎恶他
彭城太守王玄谟上言：彭城要兼水陆，请以皇子抚临州事	刘宋彭城太守王玄谟上书文帝说：彭城位兼水陆交通要道，请求派皇子亲临彭城主持政事
夏四月，乙卯，以武陵王骏为安北将军、徐州刺史	夏季，四月，乙卯，文帝任命武陵王刘骏为安北将军、徐州刺史
五月，甲戌，魏以交趾公韩拔为鄯善王，镇鄯善，赋役其民，比之郡县	五月，甲戌，北魏任命交趾公韩拔为鄯善国国王，镇守鄯善，对老百姓征发的赋税和劳役，参照北魏内地郡县
六月，丙寅，荆州刺史南谯王义宣进位司空	六月，丙寅，刘宋荆州刺史南谯王刘义宣晋升为司空
辛酉，魏主如广德宫	辛酉，北魏国主前往广德宫
秋，八月，甲子，封皇子为淮阳王	秋季，八月，甲子，刘宋朝廷封皇子刘为淮阳王
九月，辛未，以尚书右仆射何尚之为左仆射，领军将军沈演之为吏部尚书	九月，辛未，刘宋任命尚书右仆射何尚之为左仆射，领军将军沈演之为吏部尚书
丙戌，魏主如阴山	丙戌，北魏国主前去阴山
癸亥，魏大赦	癸亥，北魏实行大赦
春，正月，戊辰朔，魏主飨群臣于漠南	春季，正月，戊辰朔，北魏国主在漠南犒劳各位大臣
甲戌，复伐柔然	甲戌，再次讨伐柔然
高凉王那出东道，略阳王羯儿出西道，魏主与太子出涿邪山，行数千里	高凉王拓跋那从东路进军，略阳王拓跋羯儿由西路挺进，北魏国主和太子拓跋晃则率军穿过涿邪山，行军几千里
柔然处罗可汗恐惧远遁	柔然国处罗可汗郁久闾吐贺真非常恐惧，远远逃走
二月，己亥，上如丹徒，谒京陵	二月，己亥，文帝前去丹徒，拜谒京陵
三月，丁巳，大赦	三月，丁巳，实行大赦
募诸州乐移者数千家以实京口	募集各个州郡愿意移居的几千户迁来充实京口
庚寅，魏主还平城	庚寅，北魏国主返回平城
夏，五月，壬午，帝还建康	夏季，五月，壬午，文帝回到建康
庚寅，魏主如阴山	庚寅，北魏国主前往阴山
春，正月，乙酉，魏主如洛阳	春季，正月，乙酉，北魏国主前去洛阳
侍中、左卫将军江湛迁吏部尚书	刘宋侍中、左卫将军江湛升任吏部尚书
湛性公廉，与仆射徐湛之并为主上所宠信，时称江、徐	江湛秉性公正廉洁，他和仆射徐湛之同时受文帝所宠信，当时并称江徐
丁未，大赦	丁未，刘宋实行大赦
魏主攻彭城，不克	北魏国主攻彭城，没有攻克
十二月，丙辰朔，引兵南下，使中书郎鲁秀出广陵，高凉王那出山阳，永昌王仁出横江，所过无不残灭，城邑皆望风奔溃	十二月，丙辰朔，北魏国主率领大军向南进发，派中书郎鲁秀发兵广陵，高凉王拓跋那出兵山阳，永昌王拓跋仁发兵横江，北魏军队途经之处无不抢掠烧杀，所有城池，听说北魏军队前来进犯，都马上奔逃溃散
戊午，建康纂严	戊午，刘宋都城建康实行戒严
已未，魏兵至淮上	己未，北魏军队抵达淮上
春，正月，丙戌朔，魏主大会群臣于瓜步山上，班爵行赏有差	春季，正月，丙戌朔，北魏国主拓跋焘在瓜步山上召集全体官员，按照功劳大小，分别封爵升官进行奖赏
魏人缘江举火；太子左卫率尹弘言于上曰：六夷如此，必走	北魏人沿长江北岸燃起烽火，刘宋太子左卫率尹弘对文帝说：胡虏这种行动，一定是要撤退
丁亥，魏掠居民，焚庐舍而去	丁亥，北魏军队劫掠驻地的居民，焚烧了老百姓的房屋，向北而去
青州民司马顺则自称晋室近属，聚众号齐王	刘宋青州平民司马顺则宣称自己是东晋皇家的近族，聚众造反，自称齐王
梁邹戍主崔勋之诣州，五月，乙酉，顺则乘虚袭梁邹城	这时，梁邹守将崔勋之前去州府办事，五月，乙酉，司马顺则乘城中防守空虚偷袭了梁邹城
又有沙门自称司马百年，亦聚众号安定王以应之	同时，又有一和尚自称司马百年，也聚众造反，号安定王，以此响应司马顺则
壬寅，魏大赦	壬寅，北魏实行大赦
已巳，以江夏王义恭领南兖州刺史，徙镇盱眙，增督十二州诸军事	己巳，刘宋朝廷任命江夏王刘义恭兼任南兖州刺史，将州府迁到了盱眙，加授他为督十二州诸军事
六月，壬戌，魏改元正平	六月，壬戌，北魏改年号为正平
魏主命太子少傅游雅、中书侍郎胡方回等更定律令，多所增损，凡三百九十一条	北魏国主命令太子少傅游雅、中书侍郎胡方回等人改订国家法律，进行了大量的更定和补充，修订完的法律共有三百九十一条
秋，七月，丁亥，魏主如阴山	秋季，七月，丁亥，北魏国主前往阴山
青、冀二州刺史萧斌遣振武将军刘武之等击司马顺则、司马百年，皆斩之	刘宋青、冀二州刺史萧斌派振武将军刘武之等前去攻打司马顺则和司马百年，将二人斩首
癸亥，梁邹平	癸亥，梁邹的反叛被彻底平息了
上遣使至魏，魏遣殿中将军郎法来修好	文帝派使节到北魏，北魏则派殿中将军郎法前来恢复友好
已巳，魏上党靖王长孙道生卒	己巳，北魏的上党靖王长孙道生去世
帝使沈庆之徙彭城流民数千家于瓜步，征北参军程天祚徙江西流民数千家于姑孰	文帝派沈庆之将几千家彭城难民迁移到瓜步，派征北参军程天祚将几千户江西难民迁移到姑孰
唐和入朝于魏，魏主厚礼之	北魏镇守西域焉耆的唐和，前往平城朝见北魏国主，北魏国主用优厚的礼仪来款待他
春，正月，魏所得宋民五千余家在中山者谋叛，州军讨诛之	春季，正月，北魏所俘获的刘宋百姓五千余户在中山居住的人图谋造反，该州军队前去讨伐，把他们全部诛杀
冀州刺史张掖王沮渠万年坐与叛者通谋，赐死	冀州刺史张掖王沮渠万年与反叛者相互勾结，北魏国主赐他自杀
庚午，立皇子休仁为建安王	庚午，刘宋文帝立皇子刘休仁为建安王
三月，辛卯，魏葬太武皇帝于金陵，庙号世祖	三月，辛卯，北魏在金陵埋葬了北魏国主太武帝拓跋焘，庙号为世祖
上闻魏世祖殂，更谋北伐，鲁爽等复劝之	刘宋文帝听到北魏世祖去世，打算再次向北讨伐，司州刺史鲁爽也表示赞成
上访于群臣，太子中庶子何偃以为淮、泗数州疮痍未复，不宜轻动	文帝征求其他文武官员的意见，太子中庶子何偃认为：淮河、泗水几个州郡，受到北魏入侵的创伤，至今还没有恢复过来，不应该轻举妄动
上不从	文帝没有接受何偃的建议
偃，尚之之子也	何偃是何尚之的儿子
尚书令何尚之以老请置仕，退居方山	尚书令何尚之因为自己年纪大了，就请求退职，去方山隐居，但人们都认为何尚之不会固守他的信念一直隐居下去
议者咸谓尚之不能固志	不久，文帝颁下诏书，前后多次传达旨令，要征召何尚之回来
既而诏书敦谕者数四，六月，戊申朔，尚之复起视事	六月，戊申朔，何尚之果然又出来接受文帝的委派处理事务
御史中丞袁淑录自古隐士有迹无名者为《真隐传》以嗤之	御史中丞袁淑为此搜集自古以来有事迹而不能确知姓名的隐士，编辑成《真隐传》，以此表示对何尚之行为的嗤笑
秋，七月，张永等至，引兵围之	秋季，七月，张永等到达，率兵包围了该城
壬辰，徙汝阴王浑为武昌王，淮阳王为湘东王	壬辰，刘宋朝廷将汝阴王刘浑改封为武昌王，淮阳王刘改封为湘东王
庚寅，鲁爽与魏豫州刺史拓跋仆兰战于大索；破之，进攻虎牢	庚寅鲁爽与北魏豫州刺史拓跋仆兰在大索会战，鲁爽击败了拓跋仆兰，而后又进攻虎牢
闻败退，与柳元景皆引兵还	此时，他听说城打了败仗撤退下来，就和柳元景一同率军撤退返回
萧道成、马汪等闻魏救兵至，还趣仇池	萧道成、马汪等听到北魏的增援部队就要到来，也撤回仇池
已丑，诏解萧思话徐州，更领冀州刺史，镇历城	己丑，文帝颁发诏书，解除了萧思话的徐州刺史职务，改兼冀州刺史，镇守历城
魏南安隐王余以违次而立，厚赐群下，欲以收众心；旬月之间，府藏虚竭	北魏南安隐王拓跋余自认为自己没有按照长幼顺序当的皇帝，就用极为优厚的东西赏赐给下属，打算以此收买人心，一个月的时间，国库被动用一空
又好酣饮及声乐、畋猎，不恤政事	加之拓跋余自己喜欢喝得酩酊大醉，纵情声色、犬马，喜欢去野外狩猎，而不过问国家大事
宗爱为宰相，录三省，总宿卫，坐召公卿，专恣日甚	宗爱身居宰相高位，总管三省政务，负责皇家的安全事务，他身居高位，对公卿等呼来唤去，专权跋扈，一日比一日厉害
余患之，谋夺其权，爱愤怒	拓跋余深为不安，就想谋划肃夺他的大权，宗爱知道后甚为愤怒
冬，十月，丙午朔，余夜祭东庙，爱使小黄门贾周等就弑余，而秘之，惟羽林郎中代人刘尼知之	冬季，十月，丙午朔，拓跋余夜里去东庙祭祀，宗爱命令小黄门贾周等人，靠近拓跋余，暗中杀死他
尼劝爱立皇孙浚，爱惊曰：君大痴人	宗爱一直封锁消息，只有羽林郎中代郡人刘尼知道
皇孙若立，岂忘正平时事乎	刘尼劝宗爱拥戴皇孙拓跋浚做皇帝，宗爱大吃一惊，说：你简直是个大白痴，如果皇孙被立为皇帝，他怎么能够忘记正平年景穆太子的事
尼曰：若尔，今当立谁	刘尼说：如果不这样做，那么现在应该立谁为皇帝呢
爱曰：待还宫，当择诸王贤者立之	宗爱说：等我们回宫之后，在各王中选拔有贤能的人做皇帝
西阳五水群蛮反，自淮、汝至于江、沔，咸被其患	刘宋西阳五水一带的各蛮族起兵反抗，从淮河、汝水，到长江、沔水，都受到骚扰
诏太尉中兵参军沈庆之督江、豫、荆、雍四州兵讨之	文帝颁发诏令，命令太尉中兵参军沈庆之统率江、豫、荆、雍四州的士卒前去讨伐
魏以骠骑大将军拓跋寿乐为太宰、都督中外诸军、录尚书事，长孙渴侯为尚书令，加仪同三司	北魏朝廷任命骠骑大将军拓跋寿乐为太宰、都督中外诸军、录尚书事，任命长孙渴侯为尚书令，加封为仪同三司
十一月，寿乐、渴侯坐争权，并赐死	十一月，拓跋寿乐和长孙渴侯因争夺权利，二人同时被命令自杀
癸未，魏广阳简王建、临淮宣王谭皆卒	癸未，北魏广阳简王拓跋建、临淮宣王拓跋谭氏去世
甲申，魏主母闾氏卒	甲申，北魏国主拓跋浚的母亲郁久闾氏去世
壬寅，庐陵昭王绍卒	壬寅，刘宋庐陵昭王刘绍去世
魏追尊景穆太子为景穆皇帝，皇妣闾氏为恭皇后，尊乳母常氏为保太后	北魏追尊景穆太子拓跋晃为景穆皇帝，母亲郁久闾氏为恭皇后，尊封乳母常氏为保太后
十二月，戊申，魏葬恭皇后于金陵	十二月，戊申，北魏朝廷把恭皇后郁久闾氏安葬在金陵
江夏王义恭还朝	刘宋江夏王刘义恭从盱眙返回建康
辛未，以义恭为大将军、南徐州刺史，录尚书如故	辛未，文帝任命刘义恭为大将军、南徐州刺史，仍然保留他的录尚书之职
春，正月，戊寅，以南谯王义宣为司徒、扬州刺史	春季，正月，戊寅，刘宋文帝任命南谯王刘义宣为司徒、扬州刺史
癸巳，劭葬太祖于长宁陵，谥曰景皇帝，庙号中宗	癸巳，刘劭把文帝安葬在长宁陵，谥号为景皇帝，庙号为中宗
初，帝之讨西阳蛮也，臧质使柳元景将兵会之	当初，刘骏奉命前去讨伐西阳蛮人的时候，雍州刺史臧质派遣柳元景率领军队前往与他的大军汇合
及质起兵，欲奉南谯王义宣为主，潜使元景帅所领西还，元景即以质书呈帝，语其信曰：臧冠军当是未知殿下义举耳	臧质起兵反抗刘劭，打算拥戴南谯王刘义宣为皇帝时，又偷偷派人让柳元景率领自己的军队赶快向西返回，柳元景把臧质的密信呈报给了刘骏，并告诉那个送信的人说：臧冠军将军一定是还不知道武陵王殿下的大义之举
方应伐逆，不容西还	现在应当讨伐叛逆之人，不容许我撤退回师
质以此恨之	臧质因此对柳元景非常痛恨
及元景为雍州，质虑其为荆、江后患，建议元景当为爪牙，不宜远出	到了朝廷任命柳元景为雍州刺史的时候，臧质十分担心柳元景将来会成为荆州和江州的后患，因此，他向刘骏建议，说柳元景是朝廷的得力帮手，不应该让他远离京师，而应留在朝廷
帝重违其言，戊申，以元景为护军将军，领石头戍事	刘骏就改变自己的决定，戊申，改任柳元景为护军将军，兼任石头戍事
己酉，以司州刺史鲁爽为南豫州刺史	己酉，刘宋任命司州刺史鲁爽为南豫州刺史
庚戌，以卫军司马徐遗宝为兖州刺史	庚戌，任命卫军司马徐遗宝为兖州刺史
辛未，徒南谯王义宣为南郡王，随王诞为竟陵王，立义宣次子宜阳侯恺为南谯王	辛未，改封南谯王刘义宣为南郡王，改封随王刘诞为竟陵王，封刘义宣的次子宜阳侯刘恺为南谯王
闰月，壬申，以领军将军沈庆之为南兖州刺史，镇盱眙	闰六月，壬申，任命领军将军沈庆之为南兖州刺史，镇守盱眙
癸酉，以柳元景为领军将军	癸酉，任命柳元景为领军将军
乙亥，魏太皇太后赫连氏殂	乙亥，北魏国的太皇太后赫连氏去世
丞相义宣固辞内任及子恺王爵	丞相刘义宣坚决辞让自己在朝廷所担任的职务以及他儿子刘恺所封的王爵爵位
甲午，更以义宣为荆、湘二州刺史，恺为宜阳县王，将佐以下并加赏秩	甲午，刘宋改任刘义宣为荆、湘二州刺史，刘恺为宜阳县王，对将佐以下的大小官员们一律加以赏赐
以竟陵王诞为扬州刺史	任命竟陵王刘诞为扬州刺史
秋，七月，辛酉朔，日有食之	秋季，七月，辛酉朔，出现日食
甲寅，诏求直言	甲寅，刘骏颁下诏令，要求文武官员畅所欲言，对朝廷内政进行评说
辛酉，诏省细作并尚方，雕文涂饰；贵戚竞利；悉皆禁绝	辛酉，再一次下诏，裁减细作署，并入尚方署；宫廷雕刻和装饰，皇亲贵戚竟相贪利，一律加以禁绝
乙丑，魏濮阳王闾若文、征西大将军永昌王仁皆坐谋叛，仁赐死于长安，若文伏诛	乙丑，北魏濮阳王闾若文和征西大将军、永昌王拓跋仁，图谋反叛，拓跋仁在长安被赐自杀，闾若文被斩首
南海太守萧简据广州反	刘宋南海太守萧简占据广州城反叛
简，斌之弟也	萧简是萧斌的弟弟
诏新南海太守南昌邓琬、始兴太守沈法系讨之	刘骏颁下诏令，任命新任南海太守、南昌人邓琬和始兴太守沈法系一齐出兵前去讨伐
法系，庆之之从弟也	沈法系是沈庆之的堂弟
简诳其众曰：台军是贼劭所遣	萧简欺骗他手下的人说：朝廷来的军队，是叛贼刘劭派遣来的
众信之，为之固守	他手下的人相信了萧简的谎言，所以为他卖命固守广州城池
琬先至，止为一攻道；法系至，曰：宜四面并攻；若守一道，何时可拔	邓琬率兵首先到达，只作一面攻击
琬不从	随后，沈法系赶到，说：我们应该从四方同时进攻，如果只是从一面攻战，什么时候才能攻下来呢
法系曰：更相申五十日	邓琬没有接受沈法系的建议
日尽又不克，乃从之	沈法系说：我们再把约定进攻期限延长五十天
八道俱攻，一日即破之	五十天的期限到了，他们仍然没有攻下广州，邓琬这才接受沈法系的建议，军队从八路同时围攻，只一天的功夫就攻克了广州城
九月，丁卯，斩简，广州平	九月，丁卯，将萧简斩首，广州叛乱全部平息
法系封府库付琬而还	沈法系查封了广州城内的仓库，把它交付给邓琬，自己率领军队返回
冬，十一月，丙午，以左军将军鲁秀为司州刺史	冬季，十一月，丙午，刘宋任命左军将军鲁秀为司州刺史
辛酉，魏主如信都、中山	辛酉，北魏国主前往信都、中山
十二月，癸未，以将置东宫，省太子率更令等官，中庶子等各减旧员之半	十二月，癸未，刘宋因为将要设置东宫，撤销太子率更令等官职，中庶子等官职按旧编制减少一半
甲午，魏主还平城	甲午，北魏国主返回平城
春，正月，己亥朔，上祀南郊，改元，大赦	春季，正月，已亥朔，刘宋孝武帝刘骏前往南郊祭天，改年号为孝建，实行大赦
甲辰，以尚书令何尚之为左光禄大夫、护军将军，以左卫将军颜竣为吏部尚书、领骁骑将军	甲辰，任命尚书令何尚之为左光禄大夫、护军将军，左卫将军颜竣为吏部尚书、领骁骑将军
壬戌，更铸孝建四铢钱	壬戌，刘宋改铸孝建四铢钱
乙丑，魏以侍中伊为司空	乙丑,北魏任命侍中伊为司空
丙子，立皇子子业为太子	丙子，刘宋孝武帝立皇子刘子业为太子
初，江州刺史臧质，自谓人才足为一世英雄；太子劭之乱，质潜有异图，以荆州刺史南郡王义宣庸暗易制，欲外相推奉，因而覆之	当初，刘宋江州刺史臧质认为自己的聪明才智，足可以称为一代英雄
质于义宣为内兄，既至江陵，即称名拜义宣	太子刘劭杀父时，臧质暗中有叛逆的打算
义宣惊愕问故	他认为荆州刺史、南郡王刘义宣昏庸无能，容易受人控制，所以，准备表面拥戴刘义宣称帝，再趁机推翻他
质曰：事中宜然	臧质是刘义宣的表哥，他到了江陵以后，却自称名字去叩拜刘义宣，刘义宣见状极为惊愕，问他为什么要这么做，臧质回答说：事变之中，理应如此
时义宣已奉帝为主，故其计不行	当时刘义宣已明确表示拥护刘骏称帝，臧质的计划没有实现
及至新亭，又拜江夏王义恭，曰：天下屯危，礼异常日	他们到达新亭的时候，臧质又用同样的礼仪去叩拜江夏王刘义恭，并且说：此刻天下危机四伏，岌岌可危，礼仪也应跟平时的日子不一样
甲午，魏主诣道坛受图	甲午，北魏国主来到道教神坛，接受道教符
丙申，以安北司马夏侯祖欢为兖州刺史	丙申，刘宋朝廷任命安北司马夏侯祖欢为兖州刺史
三月，已亥，内外戒严	三月，己亥，建康城内外戒严
辛丑，以徐州刺史萧思话为江州刺史，柳元景为雍州刺史	辛丑，任命徐州刺史萧思话为江州刺史，柳元景为雍州刺史
癸卯，以太子左卫率庞秀之为徐州刺史	癸卯，任命太子左卫率庞秀之为徐州刺史
癸亥，以吴兴太守刘延孙为尚书右仆射	癸亥，刘宋朝廷提升吴兴太守刘延孙为尚书右仆射
六月，丙寅，魏主如阴山	六月，丙寅，北魏国主前往阴山
上使王公、八座与荆州刺史朱之书，令丞相义宣自为计	孝武帝下令王、公以及八座，给荆州刺史朱之写信，让朱之告诉丞相刘义宣自己裁断
书未达，庚寅，之入江陵，杀之宣，并诛其子十六人，及同党蔡超民、从事中郎蔡超、谘议参军颜乐之等	信还没送到，庚寅，朱之已经进入江陵，杀了刘义宣，同时诛杀了刘义宣的十六个儿子以及刘义宣的同党竺超民、从事中郎蔡超、谘议参军颜乐之等
超民兄弟应从诛，何尚之上言：贼既遁走，一夫可擒	竺超民的兄弟在以前就应该在斩首，何尚之上书说：贼寇刘义宣已经远远逃走，一个人就可以抓获他
若超民反覆昧利，即当取之，非唯免愆，亦可要不义之赏	如果竺超民是个反复无常、贪图小利的人，那么，他就应该逮捕刘义宣，这样，不但自己可以免于惩处，而且，还可以得到不义的封赏
而超民曾无此意，微足观过知仁	但是，竺超民却并没有这种想法，从他的这一过失中，我们足可以看到他的仁义之心
且为官保全城府，谨守库藏，端坐待缚	而且，竺超民为朝廷保住了江陵城池，他一直是小心地坚守江陵的仓库，端坐在那里等待被抓
今戮及兄弟，则与其馀逆党无异，于事为重	如果我们今天连他的兄弟也要杀了，同其他叛贼逆党一样对待而无分别，刑罚是过于重了
上乃原之	于是，孝武帝赦免了竺超民的兄弟
秋，七月，丙申朔，日有食之	秋季，七月，丙申朔，出现日食
庚子，魏皇子弘生；辛丑，大赦，改元兴光	庚子，北魏皇子拓跋弘出生
	辛丑，北魏实行大
丙辰，大赦	丙辰，刘宋实行大赦
八月，甲戌，魏赵王深卒	八月，甲戌，北魏的赵王拓跋深去世
乙亥，魏主还平城	乙亥，北魏国主返回平城
春，正月，魏车骑大将军乐平王拔有罪赐死	春季，正月，北魏车骑大将军乐平王拓跋拔有罪，被命令自杀
镇北大将军、南兖州刺史沈庆之请老；二月，丙寅，以为左光禄大夫、开府仪同三司	镇北大将军、南兖州刺史沈庆之请求告老还乡
庆之固让，表疏数十上，又面自陈，乃至稽颡泣涕	二月，丙寅，朝廷任命沈庆之为左光禄大夫、开府仪同三司
上不能夺，听以始兴公就第，厚加给奉	沈庆之坚决辞让，几十次上奏章，同时，又当孝武帝面自己陈说，言辞恳切，甚至于到了叩头哭泣的地步，孝武帝无法改变他的意志，只好让他以始兴公爵的身份回到了自己的私宅养老，并优厚地供给他的用度和俸禄
顷之，上复欲用庆之，使何尚之往起之	不久，孝武帝想要再次起用沈庆之，就派何尚之前往去劝说
尚之累陈上意，庆之笑曰：沈公不效何公，往而复返	何尚之一次次地反复陈述孝武帝的想法，沈庆之笑着对何尚之说：沈公不致仿效何公，离开了又再次回去
尚之惭而止	何尚之听后，面有愧色，也就不再去劝说沈庆之
辛巳，以尚书右仆射刘延孙为南兖州刺史	辛己，朝廷任命尚书右仆射刘延孙为南兖州刺史
夏，五月，戊戌，以湘州刺史刘遵考为尚书右仆射	夏季，五月，戊戌，朝廷任命湘州刺史刘遵考为尚书右仆射
六月，壬戌，魏改元太安	六月，壬戌，北魏改年号为太安
甲子，大赦	甲子，刘宋朝下令大赦
甲申，魏主还平城	甲申，北魏国主返回平城
秋，七月，癸巳，立皇弟休为山阳王，休茂为海陵王，休业为鄱阳王	秋季，七月，癸巳，孝武帝立皇弟刘休为山阳王、刘休茂为海陵王、刘休业为鄱阳王
丙辰，魏主如河西	丙辰，北魏国主前往河西
丁亥，魏主还平城	丁亥，北魏国主返回平城
庚午，魏以辽西王常英为太宰	庚午，北魏任命辽西王常英为太宰
壬午，以太傅义恭领扬州刺史，竟陵王诞为司空、领南徐州刺史，建平王宏为尚书令	壬午，朝廷任命太傅刘义恭兼任扬州刺史，竟陵王刘诞为司空、领南徐州刺史，建平王刘宏为尚书令
春，正月，庚寅，立皇弟休范为顺阳王，休若为巴陵王	春季，正月，庚寅，孝武帝立皇弟刘休范为顺阳王，刘休若为巴陵王
戊戌，立皇子子尚为西阳王	戊戌，孝武帝立皇子刘子尚为西阳王
壬子，纳右卫将军何女为太子妃	壬子，孝武帝为太子刘子业娶右卫将军何的女儿何令婉为太子妃
，澄之曾孙也	何是何澄的曾孙
甲寅，大赦	甲寅，实行大赦
丁零数千家匿井陉山中为盗，魏选部尚书陆真与州郡合兵讨灭之	北魏丁零部落几千户人家，躲藏到井陉山做强盗，北魏选部尚书陆真和地主州郡联合出兵，消灭了这伙强盗
闰月，戊午，以尚书左仆射刘遵考为丹杨尹	闰三月，戊午，刘宋朝廷任命尚书左仆射刘遵考为丹杨尹
癸酉，鄱阳哀王休业卒	癸酉，刘宋鄱阳哀王刘休业去世
太傅义恭以南兖州刺史西阳王子尚有宠，将避之，乃辞扬州	太傅刘义恭因为感到南兖州刺史、西阳王刘子尚很受孝武帝的宠爱，所以他打算回避，于是，就辞去扬州刺史的官职
秋，七月，解义恭扬州；丙子，以子尚为扬州刺史	秋季，七月，孝武帝批准解除了刘义恭扬州刺史的职务
时荧惑守南斗，上废西州旧馆，使子尚移治东城以厌之	丙子，任命刘子尚为扬州刺史
扬州别驾从事沈怀文曰：天道示变，宜应之以德	此时，正值火星紧挨在南半星的旁边，孝武帝下令废除西州的旧日官府，命令刘子尚把官府移到东府城，以此镇压这一凶兆
今虽空西州，恐无益也	扬州别驾从事沈怀文说：上天星辰日月在显示变化，我们应该以推广德政来对此作出反应，现在，即使是把西州空出来恐怕也不会有什么好处
不从	孝武帝没有听他的话
怀文，怀远之兄也	沈怀文是沈怀远的哥哥
八月，魏平西将军渔阳公尉眷击伊吾，克其城，大获而还	八月，北魏平西将军、渔阳公尉眷进击伊吾，攻克了伊吾城，掳掠很多东西返回
九月，壬戌，以丹杨尹刘遵考为尚书右仆射	九月，壬戌，刘宋朝廷任命丹杨尹刘遵考为尚书右仆射
冬，十月，甲申，魏主还平城	冬季，十月，甲申，北魏国主返回平城
丙午，太傅义恭进位太宰，领司徒	丙午，刘宋太傅刘义恭晋升为太宰，兼任司徒
十二月，濮阳太守姜龙驹、新平太守杨自伦弃郡奔魏	十二月，刘宋濮阳太守姜龙驹、新平太守杨自伦放弃自己镇守的郡城，逃奔到了北魏
春，正月，辛亥朔，改元，大赦	春季，正月，辛亥朔，刘宋改年号，宣布大赦
壬戌，魏主畋于崞山，戊辰，还平城	壬戌，返回平城
魏以渔阳王尉眷为太尉、录尚书事	北魏朝廷任命渔阳王尉眷为太尉和录尚书事
魏主立其弟新成为阳平王	北魏国主封立他的弟弟拓跋新为阳平王
癸卯，魏主如阴山	癸卯，北魏国主前往阴山
八月，己亥，魏主还平城	八月，己亥，北魏国主返回平城
甲辰，徙司空、南徐州刺史竟陵王诞为南兖州刺史，以太子詹事刘延孙为南徐州刺史	甲辰，朝廷任命司空、南徐州刺史、竟陵王刘诞为南兖州刺史，太子詹事刘延孙为南徐州刺史
初，高祖遗诏，以京口要地，去建康密迩，自非宗室近亲，不得居之	当初，刘宋高祖刘裕曾留下遗言，认为京口是战略要地，距离建康非常近，除非皇室近亲，其他人不能驻守
延孙之先虽与高祖同源，而高祖属彭城，延孙属莒县，从来不序昭穆	刘延孙的祖先虽然和高祖是同一宗族，但是，高祖刘裕是彭城支系，刘延孙的祖先属于莒县支系，因此，两家从来不谈论血缘关系
上既命延孙镇京口，仍诏与延孙合族，使诸王皆序长幼	孝武帝命令刘延孙去镇守京口后，才颁下诏书，跟刘延孙家合为一族，并让各个王和刘延孙之间排列辈分和长幼
魏主将东巡，冬，十月，诏太宰常英起行宫于辽西黄山	北魏国主将要去东部巡查，冬季，十月，颁下诏令，命太宰常英在辽西黄山兴建行宫
十二月，丁亥，更以顺阳王休范为桂阳王	十二月，丁亥，刘宋朝廷改封顺阳王刘休范为桂阳王
	二年
乙酉，以金紫光禄大夫褚湛之为尚书左仆射	乙酉，刘宋朝廷任命金紫光禄大夫褚湛之为尚书左仆射
乙丑，魏东平成王陆俟卒	乙丑，北魏东平成王陆俟去世
夏，四月，甲申，立皇子子绥为安陆王	夏季，四月，甲申，刘宋孝武帝立皇子刘子绥为安陆王
帝不欲权在臣下，六月，戊寅，分吏部尚书置二人，以都官尚书谢庄、度支尚书吴郡顾觊之为之	孝武帝不希望把大权交给自己的臣属
又省五兵尚书	六月，戊寅，吏部尚书分设两名，任命都官尚书谢庄、度支尚书吴郡人顾觊之分别担任，同时，撤销了五兵尚书这一官位
九月，乙巳，魏主还平城	九月，乙巳，北魏国主返回平城
丙寅，魏大赦	丙寅，北魏实行大赦
积射将军殷孝祖筑两城于清水之东	刘宋积射将军殷孝祖，在清水东岸建造了两座城池
魏镇西将军封敕文攻之，清口戍主、振威将军傅乾爱拒破之	北魏镇西将军封敕文向那里发动进攻，清口镇将、振威将军傅乾爱率军抵抗，大败封敕文
孝祖，羡之曾孙也	殷孝祖是殷羡的曾孙
上遣虎贲主庞孟虬救清口，青、冀二州剌史颜师伯遣中兵参军苟思达助之，败魏兵于沙沟	孝武帝派遣虎贲主庞孟虬援助清口，青州、冀州刺史颜师伯派遣中兵参军苟思达也赶来相助，在沙沟大败北魏大军
师伯，竣之族兄也	颜师伯是颜竣的族兄
上遣司空参军卜天生将兵会傅乾爱及中兵参军江方兴共击魏兵，屡破之，斩魏将窟公等数人	孝武帝又派遣司空参军卜天生率领大军和傅乾爱及中兵参军江方兴会师，一起抗击北魏大军，他们几次大败敌军，并斩了北魏大将窟公等几人
十一月，魏征西将军皮豹子等将三万骑助封敕文寇青州，颜师伯御之，辅国将军焦度刺豹子坠马，获其铠具装，手杀数十人	十一月，北魏征西将军皮豹子等人率领三万骑兵援助封敕文，入侵青州，刘宋颜师伯抵御，辅国将军焦度刺中皮豹子，皮豹子从马背上摔下，焦度抢到皮豹子的铠甲、长矛等全套装备，亲手杀死几十人
度，本南安氐也	焦度本来是南安氐人
春，正月，己巳朔，兖州兵与魏皮豹子战于高平，兖州兵不利	春季，正月，己巳朔，刘宋兖州军队同北魏的征西将军皮豹子在高平大战，兖州军失利
己丑，以骠骑将军柳元景为尚书令，右仆射刘遵考为领军将军	己丑，刘宋朝廷任命骠骑将军柳元景为尚书令，右仆射刘遵考为领军将军
己酉，魏河南公伊卒	己酉，北魏河南公伊去世
三月，乙卯，以扬州六郡为王畿；更以东扬州为扬州，徙治会稽，犹以星变故也	三月，乙卯，刘宋朝廷把扬州六郡划为王畿，把东扬州改称为扬州，州府迁到了会稽，这样做，是由于天上星象变化的缘故
三月，庚寅，以义兴太守垣阆为兖州刺史	三月，庚寅，朝廷任命义兴太守垣阆为兖州刺史
阆，遵之子也	垣阆是垣遵的儿子
夏，四月，乙巳，魏主立其弟子推为京兆王	夏季，四月，乙巳，北魏国主封立他弟弟的儿子拓跋推为京兆王
六月，戊申，魏主如阴山	六月，戊申，北魏国主前往阴山
辛未，大赦	辛未，刘宋宣布大赦
丙子，以丹杨尹刘秀之为尚书右仆射	丙子，刘宋朝廷任命丹杨尹刘秀之为尚书右仆射
丙戌，以南兖州刺史沈庆之为司空，刺史如故	丙戌，刘宋任命南兖州刺史沈庆之为司空，仍旧兼任刺史
九月，壬辰，筑上林苑于玄武湖北	九月，壬辰，刘宋孝武帝下令，在玄武湖北兴建上林苑
初，晋人筑南郊坛于巳位，尚书右丞徐爰以为非礼，诏徙于牛头山西，直宫城之午位	当初，东晋在都城建康南郊巳方位置上，建了一座祭天的土坛，尚书右丞徐爰认为这样做不合古礼，所以，孝武帝诏令将其迁到牛头山的西部，面对宫城的午位
及废帝即位，以旧地为吉，复还故处	等到后来废帝刘子业即位时，认为巳位是吉利的，所以，又把它迁回到了原地
帝又命尚书左丞荀万秋造五路，依金根车，加羽葆盖	孝武帝又命尚书左丞荀万秋，制作玉、金、象、革、木五种座车，并按照金根车的样子，在每辆车上都加上珍贵的羽毛装饰的顶盖
	四年
春，正月，甲子朔，魏大赦，改元和平	春季，正月，甲子朔，北魏实行大赦，改年号为和平
乙亥，上耕籍田，大赦	乙亥，刘宋孝武帝举行扶犁耕田典礼，宣布大赦
己卯，诏祀郊庙，初乘玉路	己卯，孝武帝下诏，亲自去郊外皇家祖庙举行祭祀活动，并第一次乘坐玉车
庚寅，立皇子子勋为晋安王，子房为寻阳王，子顼为历阳王，子鸾为襄阳王	庚寅，孝武帝立皇子刘子勋为晋安王，刘子房为寻阳王，刘子顼为历阳王，刘子鸾为襄阳王
魏散骑侍郎冯阐来聘	北魏散骑常侍北阐来刘宋聘问
二月，魏卫将军乐安王良讨河西叛胡	二月，北魏卫将军、乐安王拓跋良讨伐河西反叛的胡人
三月，魏人寇北阴平，朱提太守杨归子击破之	三月，北魏军侵犯北阴平，刘宋朱提太守杨归子迎击，并大败敌人
甲申，皇后亲桑于西郊，皇太后观礼	甲申，刘宋皇后王氏亲自到建康西郊行摘桑典礼，皇太后路氏观礼
自从崔浩被诛杀，北魏的史官也就被废除了，从这年开始才正式恢复这一官职	河西叛胡诣长安首罪，魏遣使者安慰之
河西反叛胡人的首领前往长安自首认罪，北魏派出使者安抚、慰问	秋七月，遣使如魏
秋季，七月，刘宋朝廷派出使节前往北魏	甲戌，开府仪同三司何尚之卒
甲戌，刘宋开府仪同三司何尚之去世	壬午，魏主如河西
庚午，北魏国主返回平城	丁亥，徙襄阳王子鸾为新安王
丁亥，刘宋朝廷改封襄阳王刘子鸾为新安王	冬，十月，庚寅，诏沈庆之讨缘江蛮
柔然国进攻高昌，杀了沮渠安周	春，正月，戊午朔，朝贺
灭了沮梁全族，任命阚伯周为高昌王	雪落太宰义恭衣，有六出，义恭奏以为瑞；上悦
高昌国称王，从这时开始	义恭以上猜暴，惧不自容，每卑辞逊色，曲意祗奉；由是终上之世，得免于祸
五年	
三月，刘宋朝廷派遣使节前去北魏	魏主发并、肆州民五千人治河西猎道；辛巳，还平城
夏季，四月，癸巳，刘宋朝廷改封西阳王刘子尚为豫章王	庚子，诏经始明堂，直作大殿于丙、己之地，制如太庙，唯十有二间为异
秋季，七月，戊寅，北魏国主封立他的弟弟拓跋小新成为济阳王，加授征东大将军，镇守平原；拓跋天赐为汝阴王，加授征南大将军，镇守虎牢；拓跋万寿为乐浪王，加授征北大将军，镇守和龙；拔跋洛侯为广平王	壬午，魏主巡山北；八月，丁丑，还平城
戊子，孝武帝立皇子刘子仁为永嘉王，刘子真为始安王	九月，甲寅朔，日有食之
九月，甲寅朔，出现日食	沈庆之固让司空，柳元景固让开府仪同三司，诏许之；仍命庆之朝会位次司空，俸禄依三司，元景在从公之上
闰九月，戊子，皇太子的妃子何令婉去世，谥号为献妃	壬寅，更以历阳王子顼为临海王
壬寅，朝廷改封历阳王刘子顼为临海王	冬，十月，甲寅，以南徐州刺史刘延孙为尚书左仆射，右仆射刘秀之为雍州刺史
北魏广平王拓跋洛侯去世	十二月，壬申，以领军将军刘遵考为尚书右仆射
十二月，壬申，刘宋朝廷任命领军将军刘遵考为尚书右仆射	甲戌，制民户岁输布四匹
春季，正月，癸未，北魏乐浪王拓跋万寿去世	辛卯，上初祀五帝于明堂，大赦
二月，乙卯，刘宋恢复文武百官的俸禄	三月，庚寅，立皇子子元为邵陵王
五月，壬寅，刘宋太宰刘义恭被解除司徒兼职	六月，辛酉，东昌文穆公刘延孙卒
六月，辛酉，刘宋东昌文穆公刘延孙去世	庚午，魏主如阴山
秋季，七月，壬寅，北魏国主前往河西	乙未，立皇子子云为晋陵王；是日卒，谥曰孝
北魏派遣员外散骑常侍游明根等前来刘宋朝廷聘问	辛巳，加尚书令柳元景司空
辛巳，刘宋朝廷加授尚书令柳元景为司空	壬寅，魏主还平城
春季，正月，丁亥，刘宋朝廷任命尚书右仆射王僧明朗太常、卫将军，颜师伯为尚书仆射	己丑，以尚书令柳元景为骠骑大将军、开府仪同三司
己丑，朝廷任命尚书令柳元景为骠骑大将军、开府仪同三司	二月，甲寅，上巡南豫、南兖二州；丁卯，校猎于乌江；壬戌，大赦；甲子，如瓜步山；壬申，还建康
五月，丙子，孝武帝再次颁下诏令：从今以后，刺史、守宰动员百姓发起军队，都必须按照手诏实行	戊辰，以左民尚书蔡兴宗、左卫将军袁粲为吏部尚书
只有边疆偏远地区有敌人进犯，或宫廷内突然发生奸佞作乱，可以不在此限	粲，淑之兄子也
秋季，八月，乙丑，刘宋孝武帝立皇子刘子孟为淮南王，刘子产为临贺王	丙寅，魏主畋于河西；九月，辛巳，还平城
庚寅，刘宋朝廷任命新安王刘子鸾兼任司徒	丙申，立皇子子嗣为东平王
丙申，孝武帝立皇子刘子嗣为东平王	冬，十月，癸亥，以东海王为司空
冬季，十月，癸亥，朝廷任命东海王刘为司空	己巳，上校猎姑孰
十一月，癸巳，孝武帝在梁山训练水军	己未，太宰义恭加尚书令
己未，朝廷加授太宰刘义恭为尚书令	癸亥，上还建康
癸亥，孝武帝回到建康	春，正月，丁亥，魏主立其弟云为任城王
春季，正月，丁亥，北魏国主封立他的弟弟拓跋云为任城王	戊子，以徐州刺中新安王子鸾领司徒
六月，丁亥，北魏国主前往阴山	秋，七月，己亥，以晋安王子勋为江州刺史
九月，辛丑，北魏国主返回平城	癸卯，以尚书左仆射刘遵考为特进、右光禄大夫
癸卯，刘宋朝廷任命尚书左仆射刘遵考为特进、右光禄大夫	乙卯，葬文穆皇后于景宁陵
丙申，北魏实行大赦	二月，丁丑，魏主如楼烦宫
壬子，北魏任命准南王拓跋它为镇西大将军、仪同三司，镇宁凉州	魏开酒禁
北魏解除禁酒令	壬午，加柳元景南豫州刺史，加颜师伯丹杨尹
壬午，刘宋加授柳元景为南豫州刺史，加授颜师伯为丹杨尹	秋，七月，癸巳，魏以太尉乙浑为丞相，位居诸王上；事无大小，皆决于浑
北魏在金陵安葬了文成帝，庙号为高宗	九月，癸巳，帝如湖熟，戊戌，还建康
戊午，废帝召集所有妃子、公主排列在自己面前，然后强迫左右侍从侮辱她们	丙寅，湘东王即皇帝位，大赦，改元
南平王刘铄的妃子江氏不从命，废帝大怒，杀了江氏的三个儿女：南平王刘敬猷、庐陵王刘敬先、安南侯刘敬渊，抽了江氏一百鞭	其废帝时昏制谬封，并皆刊削
乙亥，追尊沈太妃为宣太后，陵园称为崇宁	初，豫州刺史山阳山休入朝，以长史、南梁郡太守殷琰行府州事，及休徙荆州，即以琰为督豫・司二州诸军事、豫州刺史
春季，正月，己丑朔，北魏宣布大赦，改年号天安	癸巳，征会稽太守寻阳王子房为抚军将军，以巴陵王休若代之
山阳王刘休，驻防历阳，辅国将军刘进军小岘	邓琬性鄙暗贪吝，既执大权，父子卖官鬻爵，使婢仆出市道贩卖；酣歌博弈，日夜不休；大自矜遇，宾客到门者，历旬不得前；内事悉委褚灵嗣等三人，群小横恣，竞为威福
叛军殷琰委任的南汝阴太守裴季之，献出合肥，投降建康朝廷	于是士民忿怨，内外离心
中书舍人戴明宝向明帝推荐派军主竟陵人黄回招兵买马，向叛军进攻，杀了寻阳政权任命的马头太守王广元	前奉朝请寿阳郑黑，起兵于淮上以应建康，东捍殷琰，西拒常珍奇；乙巳，以黑为司州刺史
散骑侍郎明僧聚众起兵，攻打青州刺史沈文秀，以响应建康朝廷	杜叔宝谓台军住历阳，不能遽进；及刘等至，上下震恐
壬午，建康朝廷任命明僧为青州刺史	刘顺等始行，唯赍一月粮，既与相持，粮尽
平原、乐安两郡太守王玄默占据琅邪，清河、广川两郡太守王玄邈占据盘阳城，高阳、勃海两郡太守刘乘民占据临济城，全都起兵响应建康朝廷	叔宝发车千五百乘，载米饷顺，自将五千精兵送之
王玄邈是王玄谟的堂弟；刘乘民是刘弥之的侄儿	吕安国闻之，言于刘曰：刘顺精甲八千，我众不能居半
沈文秀派部将解彦士攻击并攻克北海，杀了刘弥之	相持既久，强弱势殊，更复推迁，则无以自立；所赖者，彼粮行竭，我食有余耳
刘乘民的堂弟刘伯宗，集结地方武装，再夺回北海，接着，又乘势攻打青州州府所在地东阳城	若使叔宝米至，非唯难可复图，我亦不能持久
沈文秀迎战，刘伯宗战死	今唯有间道袭其米车，出彼不意，能制之，当不战走矣
明僧、王玄默、王玄邈、刘乘民合兵攻打东阳城，每次攻击都被沈文秀击败，士兵被打散又重新集结再攻，这样反复十余次，最后还是不能攻克	以为然，以疲弱守营，简精兵千人配安国及龙骧将军黄回，使从间道出顺后，于横塘抄之
张永、萧道成等与薛索儿作战，大破薛索儿军，薛索儿退守石梁，粮尽，大军溃散，薛索儿投奔乐平，被申令孙的儿子申孝叔击杀	邓琬以刘胡与沈攸之等相持久不决，乃加袁督征讨诸军事
薛安都的儿子薛道智逃往合肥，到裴季之处投降	六月，甲戌，帅楼船千艘，战士二万，来入鹊尾
傅灵越逃到淮水之西，被朝廷武卫将军沛郡人王广之活捉，押送给刘，刘指责他叛逆，傅灵越说：全国各地纷纷起义，岂只我一人	本无将略，性又怯桡，在军中未尝戎服，语不及战陈，唯赋诗谈义而已，不复抚接诸将；刘胡每论事，酬对甚简
薛安都不能任用贤才，只信任他的儿子和侄儿，这是他失败的原因	由此大失人情，胡常切齿恚恨
人生在世总归一死，实在没脸求活	胡以南运米未至，军士匮乏，就借襄阳之资，不许，曰：都下两宅未成，方应经理
刘把他押送到建康，明帝打算赦免他，但傅灵越始终不肯改口，便杀了他	又信往来之言，云建康米贵，斗至数百，以为将不攻自溃，拥甲以待之
田益之率西山蛮族军队一万多人包围义阳	安成太守刘袭，始安内史王识之，建发内史赵道生，并举郡来降
邓琬派司州刺史宠孟虬率精锐部队五千人援救，田益之不敢迎战，所率军队溃散	袭，道怜之孙也
闰正月，北魏任命顿丘王李峻为太宰	沈文秀、崔道固为土人所攻，遣使乞降于魏，且请兵自救
乙巳，刘宋车骑大将军、曲江庄公王玄谟去世	三月，魏慕容白曜进围东阳
刘在许昌击败北魏军队	魏以南郡公李惠为征南大将军、仪同三司、都督关右诸军事、雍州刺史，进爵为王
北魏任命南郡公李惠为征南大将军、仪同三司、都督关右诸军事、雍州刺史，封南郡王	五月，乙卯，魏主畋于崞山，遂如繁；辛酉，还宫
五月，乙卯，北魏国主前往崞山打猎，后又到繁	六月，魏以晶黎王冯熙为太傅
辛酉，回宫	熙，太后之兄也
秋季，七月，庚申，任命骁骑将军萧道成为南兖州刺史	八月，戊子，以南康相刘勃为交州刺史
十一月，交州变民首领李长仁派使节请求投降，自贬为代理州事，朝廷批准	十二月，魏人拔不其城，杀沈文静，入东阳西郭
夏季，四月，丙申，北魏实行大赦	五月，魏徙青、齐民于平城，置升城、历城民望于桑乾，立平齐郡以居之；自馀悉为奴婢，分赐百官
六月，北魏立皇子拓跋宏为太子	癸酉，以左卫将军沈攸之为郢州刺史
冬季，十月，丁卯朔，出现日食	魏顿丘王李峻卒
北魏顿丘王李峻去世	十一月，丁未，魏复遣使来修和亲，自是信使岁通
临海郡强盗首领田流自称东海王，抢劫海盐，杀了鄞县县令，东方各郡大为震惊	春，正月，乙亥，初制间二年一祭南郊，间一年一祭明堂
春季，正月，乙亥，开始建立祭礼规定：每隔二年，到南郊祭一次天；每隔一年，在明堂祭祀一次祖先	二月，壬寅，以司徒休仁为太尉，领司徒；固辞
北魏国主派征西大将军上党王长孙观攻打吐谷浑	夏，四月，辛丑，魏大赦
夏季，四月，辛丑，北魏实行大赦	戊申，魏长孙观与吐谷浑王拾寅战于曼头山，拾寅败走，遣别驾康盘龙入贡，魏主囚之
戊申，北魏长孙观与吐谷浑王慕容拾寅在曼头山大战，慕容拾寅战败逃走，派别驾康盘龙到北魏进贡，北魏国主把他囚入监牢	癸亥，立皇子燮为晋熙王，奉晋熙王昶后
癸亥，明帝立皇子刘燮为晋熙王，继承晋熙王刘昶为其后嗣	五月，魏立皇弟长乐为建昌王
五月，北魏立皇弟拓跋长乐为建昌王	六月，癸卯，以江州刺史王景文为尚书左仆射、扬州刺史，以尚书仆射袁粲为右仆射
冬季，十月，辛卯，宋明帝下诏说：孝武帝的儿子，因为身犯国法，全被诛杀	初，魏乙浑专政，慕容白曜颇附之
命皇子刘智随过继到孝武帝名下为子，封为武陵王	魏主追以为憾，遂称白曜谋反，诛之，及其弟如意
北魏阳平王拓跋新成去世	是岁，命龙骧将军义兴周山图将兵屯浃口讨田流，平之
八月，丁亥，北魏国主返回平城	戊子，以皇子跻继江夏文献王义恭
戊子，明帝把皇子刘跻过继给江夏文献王刘义恭	庚寅，上疾有间，大赦
庚寅，明帝病势转轻，宣布大赦	戊戌，立皇子准为安成王，实桂阳王休范之子也
明帝把原来的府邸改为庙院，称湘宫寺，装潢修建，极为壮观华丽	王景文常以盛满为忧，屡辞位任，上不许
准备兴建十层佛塔，不能成功，于是便修成两座	然中心以景文外戚贵盛，张永累经军旅，疑其将来难信，乃自为谣言曰：一士不可亲，弓长射杀人
新安太守巢尚之解除职务后，回京朝见，明帝对他说：你去过湘宫寺没有	景文弥惧，自表解扬州，情甚切至
那可是我的大功德，花费不少钱	诏报曰：人居贵要，但问心若为耳
通直散骑侍郎会稽人虞愿正在一边侍立，说：那是百姓用卖子、卖妻的钱所建造的，佛陀如果有灵，会慈悲为怀，哭泣哀叹	大明之世，巢、徐、二戴，位不过执戟，权亢人主
罪恶高过佛塔，有什么功德	今袁粲作仆射领选，而人往往不知有粲，粲迁为令，居之不疑；人情向粲，淡然亦复不改常日
在座的人脸色全都大变，明帝大怒，命人把虞愿驱逐出殿	以此居贵位要任，当有致忧竞不
虞愿慢慢离开，没有恐惧的表情	夫贵高有危殆之惧，卑贱有填壑之忧，有心于避祸，不如无心于任运，存亡之要，巨细一揆耳
春季，正月，甲寅朔，刘宋明帝因患病很久，不能痊愈，于是改年号泰豫	太阳蛮酋桓诞拥沔水以北、・叶以南八万余落降于魏，自云桓玄之子，亡匿蛮中，以智略为群蛮所宗
戊午，皇太子刘昱在东宫接见四方前来朝贺的官员，并接受各地方的贡品及报告	魏以诞为征南将军、东荆州刺史、襄阳王，听自选郡县吏；使起部郎京兆韦珍与诞安集新民，区置诸事，皆得其所
北魏献文帝返回平城	庚午，魏主耕籍田
庚午，北魏国主亲自主持耕田仪式	夏，四月，以垣崇祖行徐州事，徙戍龙沮
戊午，北魏国主前往阴山	戊辰，尊帝母陈贵妃为皇太妃，更以诸国太妃为太姬
八月，戊午，乐安宣穆公蔡兴宗去世	九月，辛巳，魏主还平城
己亥，刘宋擢升郢州刺史刘秉为尚书左仆射	中书通事舍人阮佃夫加给事中、辅国将军，权任转重
刘秉是刘道怜的孙子，性情温和懦弱，没有才干，只因他是皇族，清高显贵，所以袁粲、褚渊提出推荐他	欲用其所亲吴郡张澹为武陵郡；袁粲等皆不同，佃夫称敕施行，粲等不敢执
中书通事舍人阮佃夫被加授为给事中、辅国将军，权势更加扩大，职位更重要	魏有司奏诸祠祀合一千七十五所，岁用牲七万五千五百
他打算任用他的亲信、吴郡人张澹为武陵郡太守，袁粲等都不同意，阮佃夫声称是奉圣旨，袁粲等不敢坚持	上皇恶其多杀，诏：自今非天地、宗庙、社稷，皆勿用牲，荐以酒脯而已
春季，正月，戊寅朔，刘宋改年号元徽，实行大赦	庚辰，魏员外散骑常侍崔演来聘
庚辰，北魏员外散骑常侍崔演来访	戊戌，魏上皇还，至云中
戊戌，北魏太上皇率领大军回师，抵达云中	癸丑，魏诏守令劝课农事，同部之内，贫富相通，家有兼牛，通借无者；若不从诏，一门终身不仕
北魏任命孔子的第二十八代孙孔乘为崇圣大夫，由官府拨付十户人家，负责孔庙的清洁洒扫	秋，七月，魏诏：河南六州之民，户收绢一匹，绵一斤，租三十石
秋季，七月，北魏诏令黄河以南六州百姓，每户人家，收征缎一匹，绵一斤，谷米三十石	乙亥，魏主如阴山
乙亥，北魏国主前往阴山	八月，庚申，魏上皇如河西
八月，庚申北魏太上皇前往河西	遣使如魏
刘宋派使节前往北魏	冬，十月，癸酉，割南兖、豫州之境置徐州，治钟离
冬季，十月，癸酉，刘宋分割南兖州、豫州若干郡，设立徐州，州府设在钟离	魏上皇将入寇，诏州郡之民十丁取一以充行，户收租五十石以备军粮
北魏太上皇将要大举进攻刘宋，下令全国人民，十个青年中，征召一人入伍，每户征收五十石粮食，作为军粮储备	魏武都氐反，攻仇池，诏长孙观回师讨之
十二月，癸卯朔，出现日食	乙巳，江州刺史桂阳王休范进位太尉
乙巳，江州刺史、桂阳王刘休范升任太尉	诏起袁粲，以卫军将军摄职；粲固辞
征召袁粲以卫军将军的身份，代理尚书令，袁粲坚决辞让	壬子，柔然侵魏，柔玄镇二部敕勒应之
壬子，柔然汗国南下侵入北魏，柔玄镇所属的两个敕勒部落，起兵响应	魏州镇十一水旱，相州民饿死者二千八百余人
春季，正月，丁丑，北魏太尉源贺因病被解除职务	二月，甲辰，魏上皇还平城
二月，甲辰，北魏太上皇返回平城	三月，丁亥，魏员外散骑常侍许赤虎来聘
柔然汗国派使节来访	六月，庚子，以平南将军萧道成为中领军、南兖州刺史，留卫建康，与袁粲、褚渊、刘秉更日入直决事，号为四贵
十一月，丙戌，刘宋皇帝刘昱行加冠礼，实行大赦	十二月，癸亥，立皇弟跻为江夏王，赞为武陵王
十二月，癸亥，封皇弟刘跻为江夏王，刘赞为武陵王	是岁，魏建安贞王陆卒
本年，北魏建安贞王陆去世	春，正月，辛巳，帝祀南郊、明堂
三年	
夏季，五月，丙午，北魏国主派员外散骑常侍许赤虎来访	丁未，魏主如武州山；辛酉，如车轮山
冬季，十二月，丙寅，北魏改封建昌王拓跋长乐为安乐王	己丑，魏城阳王长寿卒
春季，正月，己亥，刘宋皇帝刘昱亲自主持耕田典礼，实行大赦	二月，魏司空东郡王陆定国坐恃恩不法，免官爵为兵
甲辰，北魏国主追尊母亲李贵人为思皇后	八月，丁卯，立皇弟为南阳王，嵩为新兴王，禧为始建王
八月，丁卯，刘宋封皇弟刘为南阳王，刘嵩为新兴王，刘禧为始建王	庚午，以给事黄门侍郎阮佃夫为南豫州刺史，留镇京师
庚午，任命给事黄门侍郎阮佃夫为南豫州刺史，仍留镇京师	九月，戊子，赐骁骑将军高道庆死
九月，戊子，下令赐骁骑将军高道庆自尽	冬，十月，辛酉，以吏部尚书王僧虔为尚书左仆射
冬季，十月，辛酉，提升吏部尚书王僧虔为尚书左仆射	十一月，戊子，魏以太尉、安乐王长乐为定州刺史，司空李欣为徐州刺史
十一月，戊子，北魏任命太尉、安乐王拓跋长乐为定州刺史，司空李为徐州刺史	春，正月，乙酉朔，魏改元太和
/顺皇帝升明元年	
春季，正月，乙酉朔，北魏改年号太和	己酉，略阳民王元寿聚众五千余家，自称冲天王；二月，辛未，魏秦、益二州刺史尉洛侯击破之
三月，庚子，北魏任命东阳王拓跋丕为司徒	夏，四月，丁卯，魏主如白登；壬申，如崞山
当初，明帝命陈昭华抚养刘准	丙子，魏诏曰：工商皂隶，各有厥分；而有司纵滥，或染流俗
戊辰，刘准尊陈昭华为皇太妃	自今户内有工役者，唯止本部丞；若有勋劳者，不从此制
九月，乙酉，北魏更改法令	戊申，封杨玉夫等二十五人为侯、伯、子、男
戊申，刘宋朝廷分别封杨玉夫等二十五人为侯爵、伯爵、子爵、男爵	冬，十月，氐帅杨文度遣其弟文弘袭魏仇池，陷之
春季，正月，己酉朔，文武百官全副武装入朝，参加元旦御前祝贺	丁亥，魏主如代汤泉；癸卯，还
丁亥，北魏国主前往代郡温泉	宕昌王弥机初立
癸卯，返回平城	三月丙子，魏遣使拜弥机征南大将军、梁・益二州牧、河南公、宕昌王
五月，北魏禁止皇族、贵戚及官员、士大夫不顾门第，与下层不同阶层人通婚，违者以违抗诏书论处	魏主与太后临虎圈，有虎逸，登阁道，几至御座，侍卫皆惊靡；吏部尚书王睿执戟御之，太后称以为忠，亲任愈重
六月，丁酉，刘宋任命辅国将军杨文弘为北秦州刺史，封武都王	庚子，魏皇叔若卒
庚子，北魏皇叔拓跋若去世	萧道成以大明以来，公私奢侈，秋，八月，奏罢御府，省二尚方雕饰器玩；辛卯，又奏禁民间华伪杂物，凡十七条
乙未，，任命萧赜为领军将军，萧嶷为江州刺史	九月，乙巳朔，日有食之
己卯，抓获叛军将领孙昙，斩首	魏员外散骑常侍郑羲来聘
壬寅，顺帝王谢梵境为皇后	十一月，癸亥，临澧侯刘晃坐谋反，与其党皆伏诛
谢梵境是谢庄的孙女	晃，秉之从子也
春季，正月，甲辰，刘宋顺帝任命江州刺史萧嶷为都督荆湘等八州诸军事、荆州刺史，任命尚书左仆射王延之为江州刺史，任命安南长史萧子良为都督会稽等五郡诸军事、会稽太守	辛亥，以竟陵世子赜为尚书仆射，进号中军大将军、平府仪同三司
丙辰，顺帝任命给事黄门侍郎萧长懋为雍州刺史	二月，丙子，邵陵殇王友卒
二月，丙子，宋邵陵殇王刘友去世	辛巳，魏太皇太后及魏主如代郡温泉
辛巳，北魏太皇太后及北魏国主孝文帝前往代郡温泉	甲午，诏申前命，命太傅赞拜不名
甲午，顺帝颁诏重申以前的命令，让太傅萧道成朝拜时，不必自己称名	已亥，魏太皇太后及魏主如西宫
己亥，北魏太皇太后及孝文帝前往西宫	三月，癸卯朔，日有食之
北魏孝文帝返回平城	魏秦州刺史尉洛侯、雍州刺史宜都王目辰、长安镇将陈提等皆坐贪残不法，洛侯、目辰伏诛，提徙边
丙寅，高帝追尊亡父为宣皇帝，追尊亡母陈氏为考皇后	丁卯，封皇子钧为衡阳王
六月，丙子，高帝诛杀游击将军姚道和，这是由于他因沈攸之起事而对朝廷怀有二心的原故	甲子，立王太子赜为皇太子；皇子嶷为豫章王，映为临川王，晃为长沙王，晔为武陵王，皓为安成王，锵为鄱阳王，铄为桂阳王，鉴为广陵王；皇孙长懋为南郡王
甲子，南齐高帝立王太子萧赜为皇太子，皇子萧嶷为豫章王，萧映为临川王，萧晃为长沙王，萧晔为武陵王，萧为安成王，萧锵为鄱阳王，萧铄为桂阳王，萧鉴为广陵王，皇孙萧长懋为南郡王	乙酉，葬宋顺帝于遂宁陵
高帝听说北魏将领准备前来侵犯，九月，乙巳，任命豫章王萧嶷为荆、湘二州刺史，仍旧担任都督的职务，还任命临川王萧映为扬州刺史	丙午，以司空褚渊领尚书令
丙午，高帝任命司空褚渊兼任尚书令	壬子，魏以侍中、司徒、东阳王丕为太尉，侍中、尚书右仆射陈建为司徒，侍中、尚书代人苟颓为司空
壬子，北魏任命侍中、司徒、东阳王拓跋丕为太尉，任命侍中、尚书右仆射陈建为司徒，任命侍中、尚书代郡人氏苟颓为司空	已未，魏安乐厉王长乐谋反，赐死
己未，北魏安乐厉王拓跋长乐谋反，孝文帝赐他自杀	庚申，魏陇西宣王源贺卒
庚申，北魏陇西宣王源贺去世	冬，十月，已巳朔，魏大赦
冬季，十月，己巳朔，北魏大赦	癸未，汝阴太妃王氏卒，谥曰宋恭皇后
契丹莫贺弗勿干率领部落一万多人前来归附北魏，在白狼水的东面居住下来	春，正月，戊戌朔，大赦
春季，正月，戊戌朔，南齐大赦	以司空褚渊为司徒，尚书右仆射王俭为左仆射；渊不受
夏季，四月，辛巳，北魏孝文帝前往白登山	自晋以来，建康宫之外城唯设竹篱，而有六门
五月，丙申朔，孝文帝前往火山	会有发白虎樽者，言白门三重关，竹篱穿不完
壬寅，返回平城	上感其言，命改立都墙
秋季，七月，辛亥，北魏孝文帝前往火山	戊午，皇太子穆妃裴氏卒
戊午，南齐皇太子穆妃裴氏故去	诏南郡王长懋移镇西州
崔慧景派遣长史裴叔保在武兴进攻李乌奴，被氐王杨文弘击败	九月，甲午朔，日有食之
九月，甲午朔，出现日食	丙午，柔然遣使来聘
丙午，柔然派遣使者前来南齐通问修好	汝南太守常元真、龙骧将军胡青苟降于魏
淮水北岸四州百姓不愿意归属北魏，经常希望返回江南地区	十一月，戊寅，丹阳尹王僧虔上言：郡县狱相承有上汤杀囚，名为救疾，实行冤暴
高帝派遣了许多暗探前去诱导他们反抗北魏	岂有死生大命，而潜制下邑
因此，徐州百姓桓标之、兖州百姓徐猛子等人到处蜂拥而起，明抢暗劫，集结民众，防守五固，推举司马朗之担任首领	愚谓囚病必先刺郡，求职司与医对共诊验，远县家人省视，然后处治
北魏派遣淮阳王尉元和平南将军薛虎子等人前去讨伐他们	上从之
二月，丁卯朔，北魏大赦	丁酉，游击将军桓康复败魏师淮阳，进攻樊谐城，拔之
丁酉，南齐游击将军桓康在淮阳再次打败北魏军队，接着进攻樊谐城，又将该城攻克	魏主自中山如信都；癸卯，复如中山；庚戌，还，至肆州
北魏孝文帝从中山前往信都	垣崇祖之败魏师也，恐魏复寇淮北，乃徙下蔡戍于淮东
癸卯，再次前往中山	既而魏师果至，欲攻下蔡；闻其内徙，欲夷其故城
庚戌，孝文帝启程返回，来到肆州	已酉，崇祖引兵渡淮击魏，大破之，杀获千计
魏法秀之乱，事连兰台御史张求等百余人，皆以反法当族	北魏法秀作乱的事情，牵连到兰台御史张求等一百多人，按照有关谋反的刑法全部应当灭族
尚书令王睿请诛首恶，宥其余党	尚书令王睿请求只诛杀罪魁祸首，而宽恕法秀残余的党羽
乃诏：应诛五族者，降为三族；三族者，门诛；门诛，止其身	于是，孝文帝颁诏说：应当诛灭五族的，降为诛灭三族；应当诛灭三族的，降为诛灭全家；应当诛灭全家的，只诛灭本人
所免千余人	因此幸免的有一千多人
夏，四月，已亥，魏主如方山	夏季，四月，己亥，北魏孝文帝前往方山
冯太后乐其山川，曰：他日必葬我于是，不必山陵也	冯太后喜爱这里山青水秀，便说：将来一定要把我安葬在此地，不一定要把我合葬在先帝的陵寝中
乃为太后作寿陵，又建永固石室于山上，欲以为庙	于是，孝文帝为冯太后预修陵墓，又在方城山上修建永固石室，准备用作陵庙
魏任城康王云卒	北魏任城康王拓跋云去世
五月，壬戌，邓至王像舒遣使入贡于魏	五月，壬戌，邓至王像舒派遣使者向北魏进贡
邓至者，羌之别种，国于宕昌之南	邓至是羌人的一个分支，在宕昌南面建立国家
六月，壬子，大赦	六月，壬子，南齐大赦
戊午，魏封皇叔简为齐郡王，猛为安丰王	戊午，北魏孝文帝将皇叔拓跋简封为齐郡王，将拓跋猛封为安丰王
秋，七月，已未朔，日有食之	秋季，七月，己未朔，出现日食
辛酉，柔然别帅他稽帅众降魏	辛酉，柔然别帅他稽率领本部归降北魏
杨文弘遣使请降，诏复以为北秦州刺史	北魏杨文弘派遣使者前来请求归降，南齐高帝颁诏重新任命他为北秦州刺史
先是，杨广香卒，其众半奔文弘，半奔梁州	此前，杨广香故去，他的部下一半投奔杨文弘，一半投奔梁州
文弘遣杨後起进据白水	杨文弘派遣杨后起进军占领了白水
上虽授以官爵，而阴敕晋寿太守杨公则使伺便图之	虽然高帝授给杨文弘官职爵位，但是暗中又敕令晋寿太守杨公则寻找方便的时机，设法除掉杨文弘
辛未，柔然主遣使来聘，与上书，谓上为足下，自称曰吾，遗上师子皮裤褶，约共伐魏	辛未，柔然可汗派遣使者前来南齐通问致意，在给高帝的国书中，称高帝为足下，自称为吾，向高帝赠送了狮子皮制成的一身骑装，约定共同讨伐北魏
春，正月，壬戌，诏置学生二百人，以中书令张绪为国子祭酒	春季，正月，壬戌，南齐高帝颁诏设置学生二百人，任命中书令张绪为国子祭酒
甲戌，魏大赦	甲戌，北魏大赦
乙丑，以褚渊录尚书事，王俭为侍中、尚书令，车骑将军张敬儿开府仪同三司	乙丑，南齐任命褚渊为录尚书事，任命王俭为侍中、尚书令，任命车骑将军张敬儿为开府仪同三司
丁卯，以前将军王奂为尚书左仆射	丁卯，任命前任将军王奂为尚书左仆射
庚午，以豫章王嶷为太尉	庚午，任命豫章王萧嶷为太尉
夏，四月，庚寅，上大行谥曰高皇帝，庙号太祖	夏季，四月，庚寅，南齐为已故的皇帝上谥号称高皇帝，庙号称作太祖
丙午，葬泰安陵	丙午，高帝被安葬在泰安陵
辛卯，追尊穆妃为皇后	辛卯，南齐武帝追尊穆妃为皇后
六月，甲申朔，立南郡王长懋为皇太子	六月，甲申朔，武帝将南郡王萧长懋立为皇太子
丙申，立太子妃王氏	丙申，武帝立王氏为太子妃
妃，琅邪人也	太子妃是琅邪人
封皇子闻喜公子良为竟陵王，临汝公子卿为庐陵王，应城公子敬为安陆王，江陵公子懋为晋安王，枝江公子隆为随郡王，子真为建安王，皇孙昭业为南郡王	武帝还封皇子闻喜公萧子良为竟陵王，临汝公萧子卿为庐陵王，应城公萧子敬为安陆王，江陵公萧子懋为晋安王，枝江公萧子隆为随郡王，萧子真为建安王，皇孙萧昭业为南郡王
司徒褚渊寝疾，自表逊位，世祖不许	南齐司徒褚渊卧病不起，自动上表请求退职，武帝没有答应
渊固请恳切，癸卯，以渊为司空，领骠骑将军，侍中、录尚书如故	褚渊恳切地再三请求，癸卯，武帝任命褚渊为司空，兼任骠骑将军，依然担任侍中、录尚书事
秋，七月，魏发州郡五万人治灵丘道	秋季，七月，北魏调集各州郡五万人修筑灵丘道
九月，丁巳，以国哀罢国子学	九月，丁巳，由于高帝的丧事，武帝命令裁撤国子学
氏王杨文弘卒，诸子皆幼，乃以兄子后起为嗣	氐王杨文弘故去，由于诸子都还幼小，便让哥哥的儿子杨后起做自己的后嗣
九月，辛酉，魏以后起为武都王，文弘子集始为白水太守	九月，辛酉，北魏任命杨后起为武都王，任命杨文弘的儿子杨集始为白水太守
既而集始自立为王，后起击破之	不久，杨集始自立为氐王，杨后起将他打败
辛未，以征南将军王僧虔为左光禄大夫、开府仪同三司、以尚书右仆射王奂为湘州刺史	辛未，南齐武帝任命征南将军王僧虔为左光禄大夫、开府仪同三司，任命尚书右仆射王奂为湘州刺史
宋故建平王景素主簿何昌、记室王及所举秀才刘，前后上书陈景素德美，为之讼冤	刘宋已故的建平王刘景素的主簿何昌寓和记室参军王以及他举荐的秀才刘，先后多次上书陈诉刘景素品德高尚，为他讼理冤屈
冬，十月，辛丑，诏听以士礼还葬旧茔	冬季，二月，辛丑，武帝颁诏准许他们以士人的礼仪将刘景素重新安葬在原来的坟墓中
，之弟也	刘是刘的弟弟
春，正月，辛亥，上祀南郊，大赦，改元	春季，正月，辛亥，南齐武帝前往建康南郊祭天，宣布大赦，更改年号为永明
诏以边境宁晏，治民之官，普复田秩	南齐武帝颁诏：由于边境安宁，应当普遍恢复各州县官员的田地俸禄
以太尉豫章王嶷领太子太傅	南齐武帝任命太尉豫章王萧嶷兼任太子太傅
嶷不参朝务，而常密献谋画，上多从之	萧嶷不肯参与朝廷政务，却经常暗中献计献策，武帝往往听从他的主张
壬戌，立皇弟锐为南平王，铿为宜都王，皇子子明为武昌王，子罕为南海王	壬戌（十三日，南齐武帝立皇弟萧锐为南平王，萧铿为宜都王，皇子萧子明为武昌王，萧子罕为南海王
二月，辛巳，以征虏将军杨炅为沙州刺史、阴平王	二月，辛巳，南齐武帝任命征虏将军杨炅为沙州刺史，封阴平王
辛丑，以宕昌王梁弥机为河、凉二州刺史，邓至王像舒为西凉刺史	辛丑，南齐武帝任命宕昌王梁弥机为河、凉二州刺史，任命邓至王像舒为西凉州刺史
闰月，癸丑，魏主后宫平凉林氏生子恂，大赦	北魏历闰四月，癸丑，北魏孝文帝后宫中的平凉人林氏生下儿子拓跋恂，于是宣布大赦
文明太后以恂当为太子，赐林氏死，自抚养恂	文明太后因拓跋恂应当被立为太子，便赐林氏自裁而死，由自己来抚养拓跋恂
五月，戊寅朔，魏主如武州山石窟佛寺	闰五月，戊寅朔，北魏孝文帝前往武州山石窟佛寺
魏使假员外散骑常侍顿丘李彪来聘	北魏派遣假员外散骑常侍顿丘人李彪前来南齐通问修好
八月，庚申，骁骑将军王洪范自柔然还，经涂三万余里	八月，庚申，骁骑将军王洪范从柔然返回，经历的途程有三万多里
十二月，乙巳朔，日有食之	十二月，乙巳朔，出现日食
癸丑，魏始禁同姓为婚	癸丑，北魏开始禁止同姓通婚
王俭进号卫将军，参掌选事	南齐王俭晋升官职名号为卫将军，参与执掌选拔官吏的事务
是岁，省巴州	本年，南齐撤销巴州的建置
魏秦州刺史于洛侯，性残酷，刑人必断腕，拔舌，分悬四体	北魏秦州刺史于洛侯，生性残酷，杀人的时候，总是要砍断手腕，割去舌头，支解四肢，分别悬挂示众
合州惊骇，州民王元寿等一时俱反	全州官民担惊受怕，州中平民王元寿等人一下子全都起来反抗
有司劾奏之，魏主遣使至州，于洛侯常刑人处宣告吏民，然后斩之	有关部门上奏弹劾于洛侯，孝文帝派遣使者来到秦州，在于洛侯经常杀人的地方，向官吏与百姓宣布朝廷的决定，然后便将于洛侯斩杀了
壬寅，以柳世隆为尚书左仆射，丹杨尹李安民为右仆射，王俭领丹杨尹	壬寅，南齐朝廷任命柳世隆为尚书左仆射，任命丹杨尹李安民为右仆射，任命王俭兼领丹杨尹
五月，甲申，魏遣员外散骑常侍李彪等来聘	五月，甲申，北魏派员外散骑常侍李彪等来访
秋，七月，甲申，立皇子子伦为巴陵王	秋季，七月，甲申，立皇子萧子伦为巴陵王
乙未，魏主如武州山石窟寺	乙未，北魏国主孝文帝前往武州山石窟寺
高丽王琏遣使入贡于魏，亦入贡于齐	高句丽国王高琏，派使节向北魏进贡，同时也向南齐进贡
时高丽方强，魏置诸国使邸，齐使第一，高丽次之	此时，高句丽王国正处于强盛时期，北魏安置各国使节住所，南齐使节排在第一位，接着就是高句丽了
乙未，魏员外散骑常侍李彪等来聘	乙未，北魏员外散骑常侍李彪等人，前来南齐访问
交州刺史李叔献既受命，而断割外国贡献；上欲讨之	交州刺史李叔献接受了朝廷的任命，却擅自截留外国对朝廷的进贡，因此，武帝打算去讨伐他
春，正月，丙辰，以大司农刘楷为交州刺史，发南康、庐陵、始兴兵以讨叔献	春季，正月，丙辰，任命大司农刘楷为交州刺史，并发动南康、庐陵、始兴三地的军队，讨伐李叔献
叔献闻之，遣使乞更申数年，献二十队纯银兜鍪及孔雀；上不许	李叔献得到消息后，立刻派使者跑到建康，乞求允许他延长几年任期，并向朝廷进贡二千四百个纯银头盔和孔雀翎，武帝拒绝了他的请求
叔献惧为楷所袭，间道自湘州还朝	李叔献深怕自己会受到刘楷的袭击，就抄小路从湘州返回建康
辛卯，上祀南郊，大赦	辛卯，南齐武帝到南郊祭祀天神，实行大敕
二月，己亥，魏制皇子皇孙有封爵者，岁禄各有差	二月，己亥，北魏规定：对有封爵的皇子皇孙们，按照不同标准等级，发放俸禄
辛丑，上祭北郊	辛丑，武帝到北郊祭祀
三月，丙申，魏封皇弟禧为咸阳王，干为河南王，羽为广陵王，雍为颍川王，勰为始平王，详为北海王	三月，丙申，北魏封皇弟拓跋禧为咸阳王，拓跋干为河南王，拓跋羽为广陵王，拓跋雍为颍川王，拓跋勰为始平王，拓跋详为北海王
文明太后令置学馆，选师傅以教诸王	太皇太后冯氏又下令设置皇家学校，遴选师傅教授各位亲王
勰于兄弟最贤，敏而好学，善属文，魏主尤奇爱之	在所有兄弟中间，拓跋勰最贤能，他敏而好学，擅长写文章，因此，孝文帝特别赏识喜欢他
初，宋太宗置总明观以集学士，亦谓之东观	当初，刘宋明帝设立总明观，聚集学士，也叫东观
上以国学既立，五月，乙未，省总明观	武帝认为，国学已经成立，所以在五月，乙未，下令撤销总明观
时王俭领国子祭酒，诏于俭宅开学士馆，以总明四部书充之	当时，王俭正兼任国子祭酒，诏令在王俭住宅内，开设学士馆，把总明观的甲、乙、丙、丁四部的图书，移交给学士馆
又诏俭以家为府	同时，又命令王俭把家作为办公的官署
六月，庚戌，进河南王度易侯为车骑将军，遣给事中吴兴丘冠先使河南，并送柔然使	六月，庚戌，北魏提升河南王慕容度易侯为车骑将军，并派遣经事中、吴兴人丘冠先出使河南同时护送柔然汗国使节
秋，七月，癸未，魏遣使拜宕昌王梁弥机兄子弥承为宕昌王	秋季，七月，癸未，北魏派遣使节前往宕昌，任命宕昌已故国王梁弥机哥哥的儿子梁弥承为新任宕昌王
初，弥机死，子弥博立，为吐谷浑所逼，奔仇池	当初，梁弥机去世，他的儿子梁弥博继承王位，被吐谷浑汗国所逼迫，逃到了仇池
仇池镇将穆亮以弥机事魏素厚，矜其灭亡；弥博凶悖，所部恶之；弥承为众所附，表请纳之	仇池镇将穆亮认为梁弥机侍奉北魏朝廷一向尽心谨慎，对宕昌国的灭亡非常同情
诏许之	可是，梁弥博性情凶狠，残暴悖逆，将士对他都很痛恨，而梁弥承却受到大家的拥护，穆亮应奏请朝廷，允许护送梁弥承回国，朝廷下诏批准
亮帅骑三万军于龙鹄，击走吐谷浑，立弥承而还	于是，穆亮就率领三万名骑兵驻扎在龙鹄，击退了吐谷浑，拥立梁弥承登上王位
亮，崇之曾孙也	穆亮是穆崇的曾孙
辛酉，魏魏郡王陈建卒	辛酉，北魏魏郡王陈建去世
十二月，乙卯，魏以侍中淮南王佗为司徒	十二月，乙卯，北魏任命侍中、淮南王拓跋佗为司徒
是岁，柔然部真可汗卒，子豆仑立，号伏名敦可汗，改元太平	这一年，柔然汗国可汗郁久闾予成去世，他的儿子郁久闾豆仑继位，号为伏名敦可汗，改年号为太平
春，正月，癸亥朔，魏高祖朝会，始服衮冕	春季，正月，癸亥朔，北魏孝文帝召集百官朝见时开始穿戴汉族皇帝的礼服和冕旒
壬午，柔然寇魏边	壬午，柔然汗国进犯北魏边塞
闰月，癸巳，立皇子子贞为邵陵王，皇孙昭文为临汝公	闰正月，癸巳，武帝立皇子萧子贞为郡陵王，立皇孙萧昭文为临汝公
辛亥，帝耕籍田	辛亥，南齐武帝亲自耕种籍田
二月，己未，立皇弟为晋熙王，铉为河东王	二月，己未，武帝立皇弟萧为晋熙王，萧铉为河东王
六月，辛酉，魏主如方山	六月，辛酉，孝文帝前往方山
秋，七月，戊戌，魏主如方山	秋季，七月，戊戌，孝文帝再次前往方山
八月，乙亥，魏给尚书五等爵已上朱衣，玉佩，大小组绶	八月，乙亥，北魏给尚书和五等爵以上的官员发放朱色官服、佩玉和佩带玉饰的丝带
九月，辛卯，魏作明堂、辟雍	九月，辛卯，北魏兴建明堂、辟雍
冬，十一月，魏议定民官依户给俸	冬季，十一月，北魏议定地方官按照他所辖户口发放俸禄
十二月，柔然寇魏边	十二月，柔然汗国进犯北魏边境
是岁，魏改中书学曰国子学	这一年，北魏将中书学改称为国子学
分置州郡，凡三十八州，二十五在河南，十三在河北	重新划分设置州郡，共有三十八个州，其中有二十五个州在黄河南，十三个州在黄河北
春，正月，丁亥朔，魏主诏定乐章，非雅者除之	春季，正月，丁亥朔，北魏孝文帝下诏，审定音乐，凡是不够典雅的音乐，一律除掉
夏，五月，壬辰，魏主如灵泉池	夏季，五月，壬辰，孝文帝国主前往灵泉池
癸巳，魏南平王浑卒	癸巳，北魏南平王拓跋浑去世
甲午，魏主还平城	甲午，孝文帝返回平城
诏复七庙子孙及外戚缌麻服已上，赋役无所与	下诏免除皇家七庙的子孙以及五服以内的外戚的赋役
柔然伏名敦可汗残暴，其臣侯医石洛候数谏止之，且劝其与魏和亲	柔然可汗郁久闾豆仑凶狠残暴，他的大臣侯医、石洛侯多次劝谏、阻止他的行为，并且建议他和北魏和好联姻
伏名敦怒，族诛之，由是部众离心	郁久闾豆仑勃然大怒，下令诛杀侯医、石洛候全族，为此，他的部众离心离德
八月，柔然寇魏边，魏以尚书陆睿为都督，击柔然，大破之	八月，柔然汗国寇犯北魏边境，北魏任命尚书陆睿为都督，迎击柔然军，北魏军大获全胜
睿，丽之子也	陆睿是陆丽的儿子
九月，辛未，魏诏罢起部无益之作，出宫人不执机杼者	九月，辛未，北魏下诏，撤销对民生无益的工程，宫中不做纺织的宫女一概驱逐
冬，十月，丁未，又诏罢尚方锦绣、绫罗之工；四民欲造，任之无禁	冬季，十日，丁未，又下诏撤去尚方署绫罗锦绣的制造工程，士、农、工、商们如果打算自己织造，听任不禁
是时，魏久无事，府藏盈积	到这时为止，北魏已很久没有战事了，所以，国库库藏充盈
诏尽出御府衣服珍宝、太官杂器、太仆乘具、内库弓矢刀钤十分之八，外府衣物、缯布、丝纩非供国用者，以其太半班赉百司，下至工、商、皂隶，逮于六镇边戍，畿内鳏、寡、孤、独、贫、癃，皆有差	朝廷下诏，拿出皇家御库房内的衣物、珍奇宝物、太官使用的器具、太仆出外乘车用具及宫内库存的弓箭刀枪十分之八，以及宫外府库的衣服用具、丝绸、丝棉，不能供应朝廷使用的，把其中的一大半赏赐给文武百官，下至工匠，商贾以及衙役，直到在六镇戍守的边防士兵，以及京畿内的鳏夫、寡妇、孤儿、老人、贫民、残疾人，都按照等级分别赏赐
魏秘书令高、丞李彪奏请改《国书》编年为纪、传、表、志；魏主从之	北魏秘书令高、秘书丞李彪上奏请把《国书》的编年体例改为纪、传、表、志，孝文帝批准这一建议
，允之从祖弟也	高和高允是同一个曾祖父，高是高允的堂弟
十二月，诏彪与著作郎崔光改修国书	十二月，下诏，令丞李彪和著作郎崔光一起负责修订《国书》
光，道固之从孙也	崔光是崔道固的堂孙
春，正月，乙未，魏诏：犯死刑者，父母、祖父母年老，更无成人子孙，旁无期亲者，具状以闻	春季，正月，乙未，北魏下诏：对犯有死罪的人，如果他的父母、祖父母年老，又无成年的子孙，身边也没有穿一年以上的丧服的亲属，可以奏报朝廷
甲子，魏大赦	甲子，北魏实行大赦
魏筑城于醴阳，陈显达攻拔之，进攻阳	北魏在醴阳兴筑城池，陈显达攻克该城，乘胜进军阳
城中将士皆欲出战，镇将韦珍曰：彼初至气锐，未可与争，且共坚守，待其力攻疲弊，然后击之	阳城里的将士们都要出来迎战，但镇将韦珍说：他们刚刚到这里时士气旺盛，我们不可以和他们直接交锋，暂且一起在城里坚守城池，等到他们进攻得疲惫不堪时，再去攻击他们
乃凭城拒战，旬有二日，珍夜开门掩击，显达还	于是，韦珍率领将士们据守阳城进行抵抗，十二天后，韦珍率军借着黑夜的掩护，打开城门，突袭陈显达，陈显达撤退
五月，甲午，以宕昌王梁弥承为河、凉二州刺史	五月，甲午，南齐任命宕昌王梁弥承为河、凉二州刺史
九月，壬寅，上如琅邪城讲武	九月，壬寅，武帝前往琅邪城讲习武事
癸卯，魏淮南靖王佗卒	癸卯，北魏淮南靖王拓跋佗去世
魏主方享宗庙，始荐，闻之，为废祭，临视哀恸	当时，孝文帝正在皇家祖庙祭祀，刚刚献上第一道祭品，就得到拓跋佗去世的报告，他当即就停止了祭祀仪式，亲自去拓跋佗遗体旁哀悼恸哭
冬，十月，庚申，立冬，初临太极殿读时令	冬季，十月，庚申，立冬，南齐武帝第一次亲临太极殿，开始阅读历书
闰月，辛酉，以尚书仆射王奂为领军将军	闰十月，辛酉，南齐朝廷任命尚书仆射王奂为领军将军
十二月，柔然伊吾戍主高羔子帅众三千以城附魏	十二月，柔然汗国的伊吾守将高羔子率领三千名部属献出伊吾城池，归附北魏
上以中外谷帛至贱，用尚书右丞江夏李之议，出上库钱五千万及出诸州钱，皆令籴买	南齐武帝由于全国各地粮食和帛的价格太贱，就采纳了尚书右丞、江夏人李的建议，拿出国库库存的五千万钱和各州州库的现款，全部用来购买粮食
魏遣兵击百济，为百济所败	北魏朝廷派人进攻百济王国，被百济王国打败
春，正月，辛亥，上祀南郊，大赦	春季，正月，辛亥，南齐武帝前往南郊祭天，实行大赦
魏主祀南郊，始备大驾	孝文帝到平城南郊祭祀天神，开始使用大驾出行
壬戌，临川献王映卒	壬戌，南齐临川献王萧映去世
三月，甲寅，立皇子子岳为临贺王，子峻为广汉王，子琳为宣城王，子珉为义安王	三月，甲寅，武帝立皇子萧子岳为临贺王，萧子峻为广汉王，萧子琳为宣城王，萧子珉为义安王
庚戌，魏主祭方泽	庚戌，孝文帝在沼泽中建筑方坛，祭祀地神
上欲用领军王奂为尚书令，以问王晏	南齐武帝想要起用领军将军王奂为尚书令，征求王晏的意见
晏与奂不相能，对曰：柳世隆有勋望，恐不宜在奂后	王晏和王奂之间彼此不相容，王晏回答说：柳世隆建过大功，很有声望，恐怕不宜在王奂之下
甲子，以尚书左仆射柳世隆为尚书令，王奂为左仆射	甲子，武帝任命尚书左仆射柳世隆为尚书令，王奂为左仆射
六月，丁亥，上如琅邪城	六月，丁亥，南齐武帝前往琅邪城
秋，七月，丙寅，魏主如灵泉池	秋季，七月，丙寅，孝文帝前往灵泉池
魏主使群臣议，久与齐绝，今欲通使，何如	孝文帝召集文武百官讨论，我国和齐国断绝交往已经很久了，如今，我打算派人出使齐国，各位认为如何
尚书游明根曰：朝廷不遣使者，又筑醴阳深入彼境，皆直在萧赜	尚书游明根说：朝廷没有派人出使齐国，又深入齐国境地兴筑了醴阳城，这二件事的道理都在萧赜一边
今复遣使，不亦可乎	如今再派遣使节前去，这不是很好吗
魏主从之	孝文帝接受游明根的建议
八月，乙亥，遣兼员外散骑常侍邢产等来聘	八月，乙亥，派遣兼员外散骑常侍的邢产等人来访
九月，魏出宫人以赐北镇人贫无妻者	九月，北魏朝廷遣散出大批宫女，把她们赏赐给北方六镇没有妻子的贫民
冬十一月，己未，魏安丰匡王猛卒	冬季，十一月，己未，北魏安丰匡王拓跋猛去世
十二月，丙子，魏河东王苟颓卒	十二月，丙子，北魏河东王拓跋苟颓去世
平南参军颜幼明等聘于魏	南齐平南参军颜幼明等人前往北魏访问
魏以尚书令尉元为司徒，左仆射穆亮为司空	北魏朝廷任命尚书令尉元为司徒，左仆射穆亮为司空
太子詹事张绪领扬州中正，长沙王晃属用吴兴闻人邕为州议曹，绪不许	太子詹事张绪兼领扬州中正时，长沙王萧晃托付他起用吴兴人闻人邕为州议曹，张绪不同意
晃使书佐固请，绪正色曰：此是身家州乡，殿下何得见逼	于是，萧晃又派书佐坚持请求，张绪面色严肃地说：这里是我自己的家乡，殿下怎么能这么逼迫我
柔然别帅叱吕勤帅众降魏	柔然汗国另外一部落首领叱吕勤率众投降北魏
春，正月，诏放隔城俘二千余人还魏	春季，正月，南齐武帝颁下诏令，命令释放在隔城战斗中俘虏的二千多名士卒，送还北魏
乙丑，魏主如方山；二月，辛未，如灵泉；壬申，还宫	乙丑，返回宫中
甲午，魏遣兼员外散骑常侍邢产等来聘	甲午，北魏派遣兼员外散骑常侍邢产等人来访
五月，己酉，库莫奚寇魏边，安州都将楼龙儿击走之	五月，己酉，库莫奚部落寇犯北魏边境，被北魏安州都将楼龙儿击退
癸卯，大赦	癸卯，南齐实行大赦
丙午，魏主如方山；丙辰，遂如灵泉池；八月，丙寅朔，还宫	丙午，返回宫中
十二月，己卯，立皇子子建为湘东王	十二月，己卯，南齐武帝立皇子萧子建为湘东王
长沙威王晃卒	长沙威王萧晃去世
以百济王牟大为镇东大将军、百济王	南齐任命百济王国国王牟大为镇东大将军、封为百济王
春，正月，辛丑，上祀南效	春季，正月，辛丑，南齐武帝前往建康南郊祭天
丁卯，魏主始听政于皇信东室	丁卯，北魏孝文帝开始到皇信东室处理朝廷事务
诏太庙四时之祭：荐宣皇帝，起面饼、鸭；孝皇后，笋、鸭卵；高皇帝，肉脍、羹；昭皇帝，茗、、炙鱼：皆所嗜也	武帝下诏令皇家祖庙四季的祭品：在宣皇帝灵牌前供献起面饼和鸭肉羹；孝皇后灵牌前供奉嫩笋和鸭蛋；高皇帝灵牌前供奉细肉和肉酱粥；在昭皇后灵牌前供奉清茶、粽子和烤鱼
上梦太祖谓己：宋氏诸帝常在太庙从我求食，可别为吾致祠	这些供奉物，都是他们生前平时最喜欢吃的东西
乃命豫章王妃庾氏四时祠二帝、二后于清溪故宅	武帝梦见高帝对他说：宋朝那些皇帝常常挤到太庙里，跟着我要食物，你可以另找一个地方祭祀我
牲牢、服章，皆用家人礼	于是，命令豫章王萧嶷的妃子庾氏，春夏秋冬四季，在清溪旧宅里祭祀祖父母和父母，祭祀时所使用祭品以及要穿什么样的衣服，都按照家庭中的礼节进行
初，魏主召吐谷浑王伏连筹入朝，伏连筹辞疾不至，辄修洮阳、泥和二城，置戍兵焉	最初，孝文帝征召吐谷浑可汗慕容伏连筹到平城朝见，慕容伏连筹声称有病，没有前来，接着，他就开始修缮洮阳、泥和两座城池，并派兵戍守
二月，乙亥，魏罕镇长孙百年请击二戍，魏主许之	二月，乙亥，北魏罕的镇将长孙百年请求前去袭击洮阳、泥和两城，孝文帝批准
始兴简王鉴卒	南齐始兴简王萧鉴去世
三月，甲辰，魏主谒永固陵	三月，甲辰，孝文帝祭拜太皇太后的永固陵
夏，四月，癸亥朔，设荐于太和庙	夏季，四月，癸亥朔，在太和庙设置进献祭品，孝文帝开始吃了点儿蔬菜，追思伤感，悲哀痛哭一整天没有吃饭
魏主始进蔬食，追感哀哭，终日不饭；侍中冯诞等谏，经宿乃饭	侍中冯诞等人劝谏，过了一夜后，孝文帝才开始吃饭
甲子，罢朝夕哭	甲子，孝文帝停止早晚各哭一次的仪式
乙丑，复谒永固陵	乙丑，再次祭拜永固陵
己卯，魏作明堂，改营太庙	己卯，北魏兴建明堂，改建太庙
五月，己亥，魏主更定律令于东明观，亲决疑狱；命李冲议定轻重，润色辞旨，帝执笔书之	五月，己亥，孝文帝在东明观修订法律，亲自裁决有疑问的诉讼案件
李冲忠勤明断，加以慎密，为帝所委，情义无间；旧臣贵戚，莫不心服，中外推之	命令尚书李冲裁定刑罚轻重，为判词润色，孝文帝亲自抄录下来
	李冲忠诚勤奋，明智果断，加上又谨慎周密，所以深受孝文帝拓跋宏的信赖和
乙卯，魏长孙百年攻洮阳、泥和二戍，克之，俘三千余人	乙卯，北魏桴罕镇将长孙百年进攻洮阳、泥和两座城池，攻克城池，并俘虏了三千多人
丙辰，魏初造五辂	丙辰，北魏首次制造皇家专用的玉车、金车、象车、革车、木车五种车辆
六月，甲戌，以尚书左仆射王奂为雍州刺史	六月，甲戌，南齐任命尚书左仆射王奂为雍州刺史
丁未，魏济阴王郁以贪残赐死	丁未，北魏济阴王拓跋郁因为贪污残暴被赐自尽
秋，闰七月，乙丑，魏主谒永固陵	秋季，闰七月，乙丑，孝文帝祭拜永固陵
冬，十月，魏明堂、太庙成	冬季，十月，北魏明堂、太庙落成
乙亥，魏大定官品	乙亥，北魏朝廷制定了完整的官员等级制度
戊戌，考诸牧守	戊戌，又对各州各郡的州郡长们进行了考核检验
魏假通直散骑常侍李彪等来聘	北魏的假通直散骑常侍李彪等人来访
十二月，壬辰，魏迁社于内城之西	十二月，壬辰，北魏把祭祀农神的祭坛迁到平城内城西边
魏以安定王休为太傅，齐郡王简为太保	北魏任命安定王拓跋休为太傅，齐郡王拓跋简为太保
乙酉，魏主始迎春于东郊	乙酉，孝文帝开始到平城南郊举行迎春典礼
自是四时迎气皆亲之	从此以后，北魏每年举行迎接四季的活动时，孝文帝都亲自主持
魏冀州刺史咸阳王禧入朝	北魏冀州刺史、咸阳王拓跋禧朝见孝文帝，有关部门上奏说：冀州三千老百姓，一致称赞拓跋禧清廉公正，施行德政，请求陛下允许他世代承袭冀州刺史的官职
有司奏：冀州民三千人称禧清明有惠政，请世胙冀州	孝文帝颁下诏令说：以前建立的世袭制度虽宜于古代，但用在今天，恐怕不一定合适
魏主诏曰：利建虽古，未必今宜；经野由君，理非下请	分疆割土，要由君王作主，按理说不是臣属的请求所能决定的
以禧为司州牧、都督司・豫等六州诸军事	于是，改命拓跋禧为司州牧，都督司、豫等六州诸军事
春，正月，戊午朔，魏主朝飨群臣于太华殿，悬而不乐	春季，正月，戊午朔，北魏孝文帝在太华殿大宴文武百官，乐器摆在那里，但未演奏
甲子，魏罢租课	甲子，北魏下令，严禁人们赤背裸体
以竟陵王子良领尚书令	南齐任命竟陵王萧子良兼任尚书令
辛卯，魏罢寒食飨	辛卯，北魏废除寒食节祭祀祖先的仪式
辛巳，魏以高丽王云为督辽海诸军事、辽东公、高句丽王，诏云遣其世子入朝	辛巳，北魏任命高句丽国王高云为督辽海诸军事、辽东公、高句丽王
云辞以疾，遣其从叔升干随使者诣平城	诏令高云派他的世子到北魏平城朝见，高云以有病作借口加以推辞，而派堂叔高升干随同使节前往平城
夏，四月，丁亥朔，魏班新《律令》，大赦	夏季，四月，丁亥朔，北魏朝廷颁布新修订的《律令》，实行大赦
辛丑，豫章文献王嶷卒，赠假黄钺、都督中外诸军事、丞相，丧礼皆如汉东平献王故事	辛丑，南齐豫章文献王萧嶷去世，武帝下令，追赠萧嶷假黄钺和都督中外诸军事、丞相，丧礼规模仪式，完全和汉东平献王刘苍的一样
嶷性仁谨廉俭，不以财贿为事	萧嶷生性仁善、恭谨、廉洁、节俭，从来不追求金钱，不接受贿赂
斋库失火，烧荆州还资，评直三千余万，主局各仗数十而已	他自己家的库房发生火灾时，将他从荆州带回家的资产全都烧光了，当时估计约有三千多万，但是，他最后不过责打了库房负责人各几十棍而已
疾笃，遗令诸子曰：才有优劣，位有通塞，运有贫富，此自然之理，无足以相陵侮也	他病得很厉害时，立下遗嘱，命令他的几个儿子说：才能，有优劣好坏之分；官位，有亨通受阻之分；运气，有贫穷高足之分，这是自然而然的道理，你们所处的位置还不足以让你们仗势欺人
上哀痛特甚，久之，语及嶷，犹欷流涕	萧嶷去世，武帝万分伤心，直到很久以后，一提起萧嶷，还是抽泣流泪
嶷卒之日，第库无见钱，上敕月给嶷第钱百万；终上之世乃省	萧嶷去世那天，他家里没有一点儿现钱，武帝下令每月接济萧嶷家一百万钱，直到武帝去世，这种接济才停止
五月，己巳，以竟陵王子良为扬州刺史	五月，己巳，武帝任命竟陵王萧子良为扬州刺史
魏文明太后之丧，使人告于吐谷浑	北魏文明太后冯太后去世时，派使节前往吐谷浑汗国报丧
吐谷浑王伏连筹拜命不恭，群臣请讨之；魏主不许	吐谷汗可汗慕容伏连筹在接受北魏报丧的消息时，态度不恭谨，因此，文武百官们请求孝文帝出兵讨伐，孝文帝没有批准
又请还其贡物	文武百官们又请求将吐谷浑汗国进贡的东西退还回去
帝曰：贡物乃人臣之礼	孝文帝说：进贡物品是作为臣属应该具有的礼节
今而不受，是弃绝之，彼虽欲自新，其路无由矣	如今我们不接受他们的进贡物品，这是继绝与他们的关系，这样一来，他们虽然打算改过自新，也无路可走了
因命归洮阳、泥和之俘	所以，孝文帝又下令，将在洮阳、泥和俘获的人全部还给吐谷浑汗国
初，柔然伏名敦可汗与其叔父那盖分道击高车阿伏至罗，伏名敦屡败，那盖屡胜	当初，柔然汗国伏名敦可汗郁久闾豆仑和他的叔父郁久闾那盖，分头袭击高车王阿伏至罗，但郁久闾豆仑不断地打败仗，而郁久闾那盖却是不断地取胜
国人以那盖为得天助，乃杀伏名敦而立那盖，号候其伏代库者可汗，改元太安	当时柔然汗国的百姓认为郁久闾那盖得到了上天的帮助，于是，就杀死了郁久闾豆仑，立郁久闾那盖为可汗，称他为候其伏代库者可汗，改年号为太安
武兴氐王杨集始寇汉中，至白马	武兴氐王杨集始进犯汉中，率军抵达白马
梁州刺史阴智伯遣军主桓卢奴，阴冲昌等击破之，俘斩数千人	梁州刺史阴智伯派军主桓卢奴、阴冲昌等人率领大军迎击杨集始，俘虏及斩杀了杨集始军队几千名将士
集始走还武兴，请降于魏；辛巳，入朝于魏	杨集始逃回到武兴，向北魏请求投降
魏以集始为南秦州刺史、汉中郡侯、武兴王	辛巳，杨集始朝见孝文帝，北魏任命杨集始为南秦州刺史、汉中郡侯、武兴王
冬，十月，甲午，上殷祭太庙	冬季，十月，甲午，南齐武帝在太庙举行大规模祭祀活动
庚戌，魏以安定王休为大司马，特进冯诞为司徒	庚戌，北魏任命安定王拓跋休为大司马，任命特进冯诞为司徒
诞，熙之子也	冯诞是冯熙的儿子
魏太极殿成	北魏太极殿建成
上使太子家令沈约撰《宋书》，疑立《袁粲传》，审之于上	南齐武帝命令太子家令沈约撰写《宋书》，沈约不能确定是否写《袁粲传》，请求武帝决定
上曰：袁粲自是宋室忠臣	武帝说：袁粲当然是宋室的忠臣
约又多载宋世祖、太宗诸鄙渎事	沈约又记载了刘宋孝武帝和明帝许多卑鄙、荒淫的事
上曰：孝武事迹，不容顿尔	武帝说：孝武帝的各种事情，不能这么写
我昔经事明帝，卿可思讳恶之义	我当过明帝的臣属，侍奉过他，你应该想到为尊者讳的《春秋》大义
于是多所删除	于是，沈约删去了很多
是岁，林邑王范阳迈之孙诸农，帅种人攻范当根纯，复得其国	这一年，林邑王国前任国王范阳迈的孙子范诸农，率领自己部落的人进攻篡夺王位的范当根纯，夺回了政权，收回了自己的国土
诏以诸农为都督缘海诸军事、林邑王	南齐武帝任命范诸农为都督缘海诸军事、林邑王
春，正月，以骠骑大将军王敬则为司空，镇军大将军陈显达为江州刺史	春季，正月，南齐任命骠骑大将军王敬则为司空，任命镇军大将军陈显达为江州刺史
显达自以门寒位重，每迁官，常有愧惧之色，戒其子勿以富贵陵人；而诸子多事豪侈，显达闻之，不悦	陈显达总认为自己出身寒门，却担任这么显要的官职，所以，每次升官时，他都面带恐惧，表情羞愧，并且告诫他的儿子，不要依仗自己富贵尊荣而欺凌他人
子休尚为郢府主簿，过九江	但是，他的儿子们却常常追求豪华奢侈，陈显达听说后，非常不高兴
显达曰：麈尾蝇拂是王、谢家物，汝不须捉此	他的儿子陈休尚担任郢府主簿的官职，途经九江，陈显达说：麈尾、蝇拂，这些都是王家、谢家那样的人使用的东西，你不需要拿着它
即取于前烧之	说完，就把这些东西拿过来，当着儿子的面烧掉了
魏遣员外散骑侍郎邢峦等来聘	北魏派员外散骑侍郎邢峦等人来访
峦，颖之孙也	邢峦是邢颖的孙子
丙子，文惠太子长懋卒	丙子，文惠太子萧长懋去世
太子风韵甚和，上晚年好游宴，尚书曹事分送太子省之，由是威加内外	萧长懋仪态风韵都很温和，武帝晚年喜欢游乐欢宴，就将尚书各曹的事务交给萧长懋处理，因此，萧长懋威望著称全国
二月，魏主始耕藉田于平城南	二月，北魏孝文帝开始在平城城南主持扶犁耕田典礼
光城蛮帅征虏将军田益宗帅部落四千余户叛，降于魏	光城蛮人首领、征虏将军田益宗率领自己部落四千多户人家反叛，向北魏投降
五月，壬戌，魏主宴四庙子孙于宣文堂，亲与之齿，用家人礼	五月，壬戌，北魏孝文帝在宣文堂摆设酒席，宴请太武帝以下四代皇帝的子孙，亲自和他们在一起谈年龄，论辈份，用对待家里人的礼节对待他们
丙子，以宜都王铿为南豫州刺史	丙子，南齐任命宜都王萧铿为南豫州刺史
先是庐陵王子卿为南豫州刺史，之镇，道中戏部伍为水军，上闻之，大怒，杀其典签；以铿代之	在这之前，曾任命庐陵王萧子卿为南豫州刺史，但萧子卿在前往任所的途中，把自己率领的军队假扮成水军模样取乐，武帝听说后，极为愤怒，下令杀了萧子卿的典签，又另派萧铿前往南豫接替萧子卿
子卿还第，上终身不与相见	萧子卿返回自己的家里，武帝直到去世，也不和他相见
襄阳蛮酋雷婆思等帅户千余求内徙于魏，魏人处之沔北	襄阳蛮酋长雷婆思等人，率领一千多户居民向北魏投降，请求迁移到北魏境内居住，北魏把他们安置在沔水以北
秋，七月，癸丑，魏立皇子恂为太子	秋季，七月，癸丑，孝文帝立皇子拓跋恂为太子
戊子，魏中外戒严，发露布及移书，称当南伐	戊子，北魏实行戒严管制，发表正式文告，并将文告转交各地，宣称要南伐
诏发扬、徐州民丁，广设召募以备之	齐武帝立刻下诏，发动扬州、徐州男子入伍，同时在各地大肆征兵买马，用以防备北魏大军的入侵
魏山阳景恒公尉元卒	北魏山阳景桓公尉元去世
九月，壬子，魏遣兼员外散骑常侍勃海高聪等来聘	九月，壬子，北魏派遣兼员外散骑常侍勃海人高聪等人来访
丁巳，魏主诏车驾所经，伤民秋稼者，亩给谷五斛	丁巳，孝文帝下诏，规定皇帝乘车所经过的地方，如果给百姓秋季庄稼造成了损害，对每亩被毁坏的田地要发给五斛稻谷，作为补偿
辛酉，追尊文惠太子为文皇帝，庙号世宗	辛酉，南齐追尊文惠太子为文皇帝，庙号世宗
戊辰，魏主济河；庚午，至洛阳；壬申，诣故太学观《石经》	戊辰，又前往以前的太学观看《石经》
乙亥，邓至王像舒彭遣其子旧朝于魏，且请传位于旧；魏主许之	乙亥，邓至王像舒彭，派他的儿子像旧到北魏朝廷晋见，请求允许他把王位传给自己的儿子像旧，孝文帝批准
壬寅，尊皇太孙太妃为太后；立妃为皇后	壬寅，萧昭业尊皇太孙太妃王氏为皇太后，立正室何婧英为皇后
癸卯，魏主如邺城	癸卯，孝文帝前往邺城
王肃见魏主于邺，陈伐齐之策	王肃在邺城晋见孝文帝，向他陈述讨伐南齐的策略
魏主与之言，不觉促席移晷	孝文帝和他谈着谈着，不知不觉地把自己的座位往前移，以便听得更仔细些，时间不知不觉地过去了很久
自是器遇日隆，亲旧贵臣莫能间也	从那以后，孝文帝对王肃的器重和待遇一天比一天隆厚，无论是亲信故旧、还是重臣，都无法离间这君臣二人之间的关系
魏主或屏左右与肃语，至夜分不罢，自谓君臣相得之晚	孝文帝有时就让左右侍从退下，单独和王肃谈话，谈到半夜，仍不停止，他自认为和王肃相见太晚了
寻除辅国将军、大将军长史	不久，任命王肃为辅国将军、大将军长史
时魏主方议兴礼乐，变华风，凡威仪文物，多肃所定	这时，孝文帝正打算推广使用礼仪和雅乐，将鲜卑人传统的风俗习惯，改变成和汉人的一样，所以，只要是展示帝王威严仪容的文物制度，大多都让王肃来确定
乙巳，魏主遣安定王休帅从官迎家于平城	乙巳，孝文帝派安定王拓跋休率领侍从官员，到平城迎接眷属
辛亥，封皇弟昭文为新安王，昭秀为临海王，昭粲为永嘉王	辛亥，南齐萧昭业封皇弟萧昭文为新安王，萧昭秀为临海王，萧昭粲为永嘉王
魏主筑宫于邺西，十一月，癸亥，徙居之	孝文帝在邺城城西兴建皇宫，十一月，癸亥，搬入新皇宫
御史中丞江淹劾奏前益州刺史刘悛、梁州刺史阴智伯脏货巨万，皆抵罪	御史中丞江淹，弹劾前益州刺史刘悛、梁州刺史阴智伯二人，指控他们贪污钱财巨万，都按律治罪。最初，刘悛在被免除广、司二州刺史时＝全部家产都变卖了，回来全部献给武帝，所以，他家里一点儿积蓄也没有
初，悛罢广、司二州，倾赀以献世祖，家无留储	在益州时，刘悛曾制作黄金的浴盆，其他物品也与此相称
在益州，作金浴盆，余物称是	郁林王即位后，刘悛进献的东西减少了
及郁林王即位，悛所献减少	萧昭业很生气，就将刘悛逮捕，交给廷尉判罪，打算杀了他
帝怒，收悛付廷尉，欲杀之；西昌侯鸾救之，得免，犹禁锢终身	幸亏西昌侯萧鸾的说情相救，才使他免于一死，但仍然还是决定对他终身监禁，不许做官
悛，之子也	刘悛是刘的儿子
春，正月，丁未，改元隆昌；大赦	春季，正月丁未，郁林王萧昭业改年号为隆昌，大赦天下
辛亥，郁林王祀南郊；戊午，拜崇安陵	辛亥拜谒其父文惠太子墓崇安陵
二月乙丑，北魏孝文帝驾临河阳，勘测划定筑建夏至日祭地时所用方泽的地址	辛卯，帝祀明堂
辛卯，南齐郁林王在明堂举行祭祀仪式	司徒参军刘等聘于魏
司徒参军刘等人出使北魏	丙申，魏徙河南王干为赵郡王，颍川王雍为高阳王
夏季，四月庚辰，北魏免去了西郊祭天仪式	辛巳，武陵昭王晔卒
闰四月丁卯，南齐镇军将军萧鸾以这个名号，开府仪同三司	戊辰，以新安王昭文为扬州刺史
戊辰，新安王萧昭文任扬州刺史	五月，甲戌朔，日有食之
六月已巳，北魏派遣兼员外散骑常侍卢昶、兼员外散骑侍郎王清石来访	秋，七月，乙亥，魏以宋王刘昶为使持节、都督吴.越.楚诸军事、大将军，镇彭城
卢昶是卢度世的儿子	魏主亲饯之
王清石世代做官于江南，北魏孝文帝告诉他说：你不要因为是南方人而有顾虑，他们之中如果有谁与你相识，想见面就见面，想说什么就说什么	以王肃为昶府长史
做使节出访别国，要以和为贵，不要一味地矜持夸耀，尤其不能从言谈举止中表现出来，否则就失去了奉命出使的本体	昶至镇，不能抚接义故，卒无成功
辛丑，北魏孝文帝到达朔州	八月，甲辰，以司空王敬则为太尉，鄱阳王锵为司徒，车骑大将军陈显达为司空，尚书左仆射王晏为尚书令
八月甲辰，南齐任命司空王敬则为太尉，鄱阳王箫锵为司徒，车骑大将军陈显达为司空，尚书左仆射王晏为尚书令	魏主至阴山
十一月癸酉，南齐任命始安王萧遥光为扬州刺史	丁丑，魏主如邺
丁丑，北魏孝文帝到了邺城	庚辰，立皇子宝义为晋安王，宝玄为江夏王，宝源为庐陵王，宝寅为建安王，宝融为随郡王，宝攸为南平王
庚辰，南齐明帝萧鸾封皇子萧宝义为晋安王，萧宝玄为江夏王，萧宝源为庐陵王，萧宝寅为建安王，萧宝融为随郡王，萧宝攸为南平王	甲申，诏曰：邑宰禄薄，虽任土恒贡，自今悉断
甲申，明帝诏令：各县令俸薄禄少，从今开始，连田赋常贡，也悉加减免	乙酉，追尊始安贞王为景皇，妃为懿后
北魏孝文帝到达洛阳	魏主敕后军将军宇文福行牧地
他想整理朝纲，澄清流品，就让尚书崔亮兼任吏部郎	福表石济以西，河内以东，距河凡十里
崔亮是崔道固的哥哥的孙子	魏主自代徙杂畜置其地，使福掌之；畜无耗失，为司卫监
早先，北魏孝文帝命令中书监高闾修治古乐，不久高闾出任相州刺史，这一年，高闾上表举荐著作郎韩显宗、大乐祭酒公孙崇参与制定钟律，孝文帝采纳了他的建议	春，正月，壬申，遣镇南将军王广之督司州、右卫将军萧坦之督徐州、尚书右仆射沈文季督豫州诸军以拒魏
春季，正月壬申，南齐派遣镇南将军王广之、右卫将军萧坦之、尚书右仆射沈文季分别督率司州、徐州、豫州三地的军队，抵抗北魏的入侵	戊子，魏太师京兆武公冯熙卒于平城
北魏城阳王拓跋鸾等人进攻赭阳，各位将领之间不能统一行动，已经围攻了一百多日，但是还不能攻下，诸将领就准备不再攻城，而采取久围长困的办法使城内无法坚持下去而屈服	魏广川刚王谐卒
只有李佐独自率部昼夜攻城，将士死伤非常多	谐，略之子也
明帝派遣太子右卫率垣历生前去援救，北魏将领以为势寡不能胜敌，想要撤退，李佐独自率领二千骑兵迎战垣历生，大败	魏主曰：古者，大臣之丧有三临之礼；魏、晋以来，王公之丧，哭于东堂
卢渊等人逃遁，垣历生乘胜追击，大获全胜	自今诸王之丧，期亲三临；大功再临；小功、缌麻一临；罢东堂之哭
垣历生是垣荣祖的堂弟	广川王于朕，大功也
南阳太守房伯玉等人又在沙2916打败了薛真度	将大敛，素服、深衣往哭之
癸卯，北魏孝文帝派遣太子到平城参加太师冯熙的丧礼	癸丑，魏诏求遗书，秘阁所无，有益时用者，加以优赏
八月乙巳，北魏选拔勇猛的武士十五万人担任羽林、虎贲，以充实皇宫宿卫	魏金墉宫成，立国子、太学、四门小学于洛阳
己丑，南齐调迁南平王萧宝攸为邵陵王、蜀郡王萧子文为西阳王、广汉王萧子峻为衡阳王、临海王萧昭秀为巴陵王、永嘉王萧昭粲为桂阳王	乙未，魏主自邺还；冬，十月，丙辰，至洛阳
丁酉，明帝诏令修缮晋代诸位皇帝的陵墓，并且增置了守护陵墓的卫士	甲子，魏主引见群臣于光极堂，颁赐冠服
早先北魏人不使用钱币，从孝文帝开始才命令铸造太和五铢钱	魏以光城蛮帅田益光为南司州刺史，所统守宰，听其铨置
到本年，已经铸造得大体齐备，因此孝文帝诏令公私方面一律开始使用钱币	后更于新蔡立东豫州，以益光为刺史
氐族首领杨炅去世	春，正月，丁卯，以杨炅子崇祖为沙州刺史，封阴平王
三年	
壬辰，北魏调迁始平王元勰为彭城王，恢复定襄县王元鸾为城阳王	二月，壬寅，魏诏：群臣自非金革，听终三年丧
丁丑，北魏孝文帝诏令：各州的中正各自举荐本乡之有德行而为乡人所尊重者，年龄在五十岁以上而家境贫寒的，授以令、长之职	壬午，诏：乘舆有金银饰校者，皆剔除之
夏季，四月，甲辰，北魏广州刺史薛法护向南齐请求投降	魏寇司州，栎城戍主魏僧珉拒破之
丁巳，北魏相州刺史南安惠王元桢去世	九月，戊辰，魏主讲武于小平津；癸酉，还宫
九月戊辰，北魏孝文帝在小平津讲武	冬，十月，戊戌，魏诏：军士自代来者，皆以为羽林、虎贲
癸酉，孝文帝还宫	司州民十二夫调一，吏以供公私力役
北魏吐京胡反叛，孝文帝诏令朔州刺史元彬代管汾州事务，让他统领并州、肆州的人马去讨伐叛贼	魏主引见群臣于清徽堂，议废太子恂
元彬是元桢的儿子	太子太傅穆亮、少保李冲免冠顿首谢
元彬派遣统军奚康生攻打反叛的胡人，打败了他们，又追击至车突谷，两次获胜，俘获各种牲畜上万头	帝曰：卿所谢者私也，我所议者国也
孝文帝诏令元彬为汾州刺史，胡人去居等六百多人据险而不服，元彬请求朝廷拨兵两万去讨伐，有关部门上奏孝文帝请示批准，孝文帝勃然大怒，说：小小的一股寇贼，那有朝廷发兵去讨伐的道理呢	大义灭亲，古人所贵
可以自己根据实际情况而安排讨伐	今恂欲违父逃叛，跨据恒、朔，天下之恶执大焉
如果不能攻克，必须大兵去讨伐，那就先斩了刺史，然后再发兵	若不去之，乃社稷之忧也
元彬非常害怕，亲自督率州兵，身先士卒，去讨伐去居，终于获胜	闰月，丙寅，废恂为庶人，置于河阳无鼻城，以兵守之，服食所供，粗免饥寒而已
戊辰，北魏设置常平仓	戊寅，太子宝卷冠
二月壬戌，北魏孝文帝到达太原	甲子，以左仆射徐孝嗣为尚书令，征虏将军萧季敞为广州刺史
丁卯，北魏把军队分为六部分，以便决定哪些参加南征，哪些留守	秋，七月，魏立昭仪冯氏为皇后，后欲母养太子恪；恪母高氏自代如洛阳，暴卒于共县
戊辰，北魏任命穆亮为征北大将军、开府仪同三司、冀州刺史	八月，丙辰，魏诏中外戒严
八月，丙辰，北魏即将南伐，宣布内外戒严	壬戌，魏立皇子愉为京兆王，怿为清河王，怀为广平王
壬戌，北魏封立皇子元愉为京兆王，元怿为清河王，元怀为广平王	追尊景皇所生王氏为恭太后
春季，正月，癸未朔，南齐大赦天下	加中军大将军徐孝嗣开府仪同三司，孝嗣固辞
北魏孝文帝任命彭城王元勰为宗师，命令他监督检查皇室成员，如有谁不听从教导，就向自己汇报	夏，四月，甲寅，改元
庚午，北魏征召各州郡之兵二十万人，时间定于八月中旬，会集悬瓠，准备再行南伐	魏赵郡灵王卒
八月，辛亥，北魏太子从洛阳到悬瓠朝见孝文帝	壬子，奉朝请邓学以齐兴郡降魏
北魏孝文帝入侵南齐时，派遣使者去向高车调兵，但是高车人害怕远途劳役，因此奉袁纥树者为头领，率众叛变向北	八月，葬明皇帝于兴安陵，庙号高宗
孝文帝派遣征北将军宇文福去讨伐，但是大败而回，宇文福因此而被黜官	东昏侯恶灵在太极殿，欲速葬，徐孝嗣固争，得逾月
孝文帝又命令平北将军江阳王元继为都督北讨诸军事，去讨伐高车，自怀朔以东全部归他掌管调遣，并摄镇平城	帝每当哭，辄云喉痛
元继是拓跋熙的曾孙	太中大夫羊阐入临，无发，号恸俯仰，帻遂脱地，帝辍哭大笑，谓左右曰：秃啼来乎
南齐林邑王范诸农入朝晋见，在海上遇到风暴，溺水而死，南齐封其子范文款为林邑王	春，正月，戊寅朔，大赦，改元
春季，正月，戊寅朔，南齐大赦天下，改年号为永元	太尉陈显达督平北将军崔慧景军四万击魏，欲复雍州诸郡；癸未，魏遣前将军元英拒之
乙酉，北魏孝文帝从邺城出发返回洛阳	辛卯，帝礼南郊
北魏太保齐郡灵王元简去世	二月，辛亥，魏以咸阳王禧为太尉
五月，癸亥，南齐加封始安王萧遥光开府仪同三司	丙申，魏葬孝文帝于长陵，庙号高祖
闰八月，丙子，南齐封立江陵公萧宝览为始安王，并过继为始安靖王之后代	以沈陵为北徐州刺史
九月，丁未，南齐任命豫州刺史裴叔业为南兖州刺史，任命征虏长史张冲为豫州刺史	壬戌，以频诛大臣，大赦
己酉，南齐江夏王萧宝玄伏法被诛	壬子，大赦
壬子，南齐大赦天下	六月，丙子，魏彭城王勰进位大司马，领司徒；王肃加开府仪同三司
六月，丙子，北魏彭城王元勰升任大司马，兼任司徒，王肃加授开府仪同三司	大阳蛮田育丘等二万八千户附于魏，魏置四郡十八县
二月，乙丑，南齐南康王萧宝融任命冠军长史王茂为江州刺史，任命竟陵太守曹景宗为郢州刺史，任命邵陵王萧宝攸为荆州刺史	甲戌，魏大赦
甲戌，北魏大赦天下	壬午，东昏侯遣羽林兵击雍州，中外纂严
巴东献武公萧颖胄以萧与蔡道恭相持不决，忧愤成疾；壬午，卒	巴东献武公萧颖胄因萧与蔡道恭相持不下，所以忧愤成疾，壬午，病死
夏侯详秘之，使似其书者假为教命，密报萧衍，衍亦秘之	夏侯详封锁了萧颖胄的死讯，使与萧颖胄的笔迹相似的人假冒其名写成命令，秘密地送给萧衍，萧衍亦秘而不宣
详征兵雍州，萧伟遣萧将兵赴之	夏侯详在雍州征兵，萧伟派遣萧率兵前去
等闻建康已危，众惧而溃，及鲁休烈皆降	萧闻知建康已经危在旦夕，部下惧怕而溃散，萧以及鲁休烈都投降了
乃发颖胄丧，赠侍中、丞相；于是众望尽归于衍	江陵方面这才给萧颖胄发丧，追赠他侍中、丞相，于是天下众望全归于萧衍
夏侯详请与萧共参军国，诏以详为侍中、尚书右仆射，寻除使持节、抚军将军、荆州刺史	夏侯详向和帝请求与萧一起参与军国事务，和帝诏令夏侯详为侍中、尚书右仆射，很快又任命他为使持节、抚军将军、荆州刺史
详固让于	夏侯详再三辞让，把上述官职推让给了萧
乃以行荆州府州军	于是，和帝就让萧率管荆州府州军队
魏改筑圜丘于伊水之阳；乙卯，始祀于其上	北魏把祭天的圜丘改筑在伊水的北面，乙卯，首次在上面祭祀
春，正月，齐和帝遣兼侍中席阐文等慰劳建康	春季，正月，南齐和帝萧宝融派遣兼侍中席阐文等人到建康慰劳
大司马衍下令：凡东昏时浮费，自非可以习礼乐之容，缮甲兵之备者，余皆禁绝	大司马萧衍下令：凡是东昏侯时不必要的开支，除了用以操习礼乐法度、修缮军事装备者外，其余一概禁绝
己亥，以宁朔将军萧m监南兖州诸军事	己亥，宣德太后任命宁朔将军萧m监南兖州诸军事
m，衍之从父弟也	萧m是萧衍的堂弟
壬寅，进大司马衍都督中外诸军事，剑履上殿，赞拜不名	壬寅，宣德太后提升萧衍为都督中外诸军事，特许他可以佩剑穿鞋上殿，以及朝见赞拜可以不报姓名
己酉，以大司马长史王亮为中书监、尚书令	己酉，宣德太后任命大司马王亮为中书监、尚书令
丙寅，诏梁国选诸要职，悉依天朝之制	丙寅，宣德太后诏令梁国选任各种要职官员，全部依照朝廷之制
于是以沈约为吏部尚书兼右仆射，范云为侍中	于是，任命沈约为吏部尚书兼右仆射，范云为侍中
辛丑，杀齐邵陵王宝攸、晋熙王宝嵩、桂阳王宝贞	辛丑，南齐邵陵王萧宝攸、晋熙王萧宝嵩、桂阳王萧宝贞被杀
齐和帝东归，以萧为都督荆・湘等六州诸军事、荆州刺史	南齐和帝萧宝融将东归建康，他任命萧为都督荆、湘等六州诸军事及荆州刺史
荆州军旅之后，公私空乏，厉精为治，广屯田，省为役，存问兵死之家，供其乏困	荆州经过战争之后，公私两方在财用方面都非常空乏，萧励精图治，广开屯田，省免劳役，抚问有家人当兵阵亡了的人家，供应救济他们
自以少年居重任，谓佐吏曰：政之不臧，士君子所宜共惜	他自以为年纪轻而居于重任，所以特别用心，对手下的官吏们说：政事如果没有办好，大家都应该共同努力
吾今开怀，卿其无隐	我现在开诚布公于你们，希望你们也不要有所隐瞒
于是人人得尽意，民有讼者皆立前待符教，决于俄顷，曹无留事	于是，人人都感到心情舒畅，办事效率大增，民众如有诉讼者站在一旁等待处理，很快就可以做出决定，官署中设有积压的事情
荆人大悦	因此，荆州人非常高兴
齐和帝至姑孰，丙辰，下诏禅位于梁	南齐和帝到达姑孰，于两辰，下诏令禅让皇位于梁
丁巳，庐陵王宝源卒	丁巳，庐陵王萧宝源去世
鲁阳蛮鲁北燕等起兵攻魏颍州	鲁阳的蛮人鲁北等人起兵攻打北魏颍州
夏，四月，辛酉，宣德太后令曰：西诏至，帝宪章前代，敬禅神器于梁，明可临轩，遣使恭授玺绂，未亡人归于别宫	夏季，四月辛酉，宣德太后发令：西边的诏令已经到了，皇帝效法前代，把皇位恭敬地禅让给梁，明天早晨我要来到殿前，派使者向梁公恭授印玺，之后我将回到别宫去居住
壬戌，发策，遣兼太保、尚书令亮等奉皇帝玺绂诣梁宫	壬戌，宣德太后发出策书，派遣兼太保、尚书令王亮等人奉送皇帝印玺到梁宫
丙寅，梁王即皇帝位于南郊，大赦，改元	丙寅，梁王萧衍于南郊即位登基，大赦天下，改年号为天监
是日，追赠兄懿为丞相，封长沙王，谥曰宣武，葬礼依晋安平献王故事	在这天，萧衍追赠其兄萧懿为丞相，封为长沙王，谥号为宣武，并且依照晋代安葬安平献王的先例重新安葬了萧懿
诏凡后宫、乐府、西解、暴室诸归女一皆放遣	武帝诏令，凡是后宫、乐府、西解、暴室中的妇女全部放还回家
庚午，诏：有司依周、汉故事，议赎刑条格，凡在官身犯鞭杖之罪，悉入赎停罚，其台省令史、士卒欲赎者听之	庚午，武帝诏令：官吏们依照周代、汉代的先例，议定赎刑条例，凡是身居官位而犯有该受鞭杖之刑的人，全部可以出赎金而停止惩罪，各台省的令史以及士卒犯罪而愿意赎刑者，亦听任其便
以谢沭县公宝义为巴陵王，奉齐祀	武帝封谢沭县公萧宝义为巴陵王，让他奉祀南齐祖先
宝义幼有废疾，不能言，故独得全	萧宝义幼有残疾，是个哑巴，所以才得以保全
诏征谢F为左光禄大夫、开府仪同三司，何胤为右光禄大夫，何点为侍中；胤、点终不就	武帝诏征谢F为左光禄大夫、开府仪同三司，何胤为右光禄大夫，何点为侍中，但是何胤与何点到底也没有就任
癸酉，诏公车府谤木、肺石傍各置一函，若肉食莫言，欲有横议，投谤木函；若以功劳才器冤沈莫达，投肺石函	癸酉，武帝诏令：在公车府谤木和肺石旁边各放置一个盒子，如果布衣处士欲对朝政提出议论，而在官位的人又没有谈到，就把其意见投入谤木旁边的盆子里；如果有谁因功劳或才识被冤沉而没有上报，如欲申诉，把申拆书投入肺石旁边的盒子中
鲁阳蛮围魏湖阳，抚军将军李崇将兵击破之，斩鲁北燕，徒万余户于幽、并诸州及六镇，寻叛南走，所在追讨，比及河，杀之皆尽	鲁阳蛮围攻北魏湖阳，抚军将军李崇率兵击败了他们，斩了鲁北；北魏迁移一万余户当地的蛮人到幽、并等州以及六镇，但不久这些人就纷纷叛逃南归，他们所到之处都派兵追捕，追到黄河边时，把他们全部杀害了
闰月，丁巳，魏顿丘匡公穆亮卒	闰月，丁巳，北魏顿丘匡公穆亮去世
齐东昏侯嬖臣孙文明等，虽经赦令，犹不自安，五月，乙亥夜，帅其徒数百人，因运荻炬，束仗入南、北掖门作乱，烧神虎门、总章观，入卫尉府，杀卫尉洮阳愍侯张弘策	南齐东昏侯的宠臣孙文明等人，虽然被赦免，但是仍然感到不安，于五月乙亥夜间，带领同伙几百人，借运交芦苇火把之机，把兵器藏在柴中，乘机进入南、北掖门，暴动作乱，放火烧了神虎门、总章观，闯入卫尉府，杀了卫尉、洮阳愍侯张弘策
前军司马吕僧珍直殿内，以宿卫兵拒之，不能却	前军司马吕僧珍在殿内当值，以宿卫兵抵抗暴待们，但是抵挡不了
上戎服御前殿，曰：贼夜来，是其众少，晓则走矣	这时，武帝身穿戎服来到前殿，说道：反贼们乘夜间而来，是因为他们的人数少，天亮了就会逃跑的
命击五鼓，领军将军王茂、骁骑将军张惠绍闻难，引兵赴救，盗乃散走，讨捕，悉诛之	他命令击响五鼓，即东方青鼓、南方赤鼓、西方白鼓、北方黑鼓、中方黄鼓，鼓声一响，领军将军王茂、骁骑将军张惠绍知道天子有难，即刻带兵前来解救，贼盗们纷纷逃散，经过搜捕，全部杀掉了他们
江州刺史陈伯之，目不识书，得文牒辞讼，唯作大诺而已，有事，典签传口语，与夺决于主者	江州刺史陈伯之目不识丁，收到文件和诉讼材料，只会核批画行，有何事情，都是通过典签口头来传达，所以予夺大权实际上完全掌握在典签手中
豫章人邓缮、永兴人戴永忠有旧恩于伯之，伯之以缮为别驾，永忠为记室参军	豫章人邓缮、永兴人戴永忠过去的恩于陈伯之，陈伯之就委任邓缮为别驾，戴永忠为记室参军
河南褚居建康，素薄行，仕宦不得志，频造尚书范云，云不礼之	河南人褚住在建康，向来品行不端正，所以仕途很不得志，他就频繁地去拜访尚书范去，但是范云不礼遇他
怒，私谓所亲曰：建武以后，草泽下族悉化成贵人，吾何罪而见弃	因此，褚很生气，私下里对自己的亲信说：自从建武年间以来，身处草泽的低贱家族都变成了贵人，而我却因何罪被弃之不用呢
今天下草创，饥馑不已，丧乱未可知	如今天下草创，饥荒不停，所以再次发生大乱也未可知
陈伯之拥强兵在江州，非主上旧臣，有自疑之意；且荧惑守南斗，讵非为我出邪	陈伯之拥有强大的兵权，坐镇江州，而他又不是皇上的旧臣，所以有自疑的心理，况且火星又出现在南斗位置上，预示将有更换天子之事，岂知不是为我而出现的吗
今者一行事若无成，入魏不失作河南郡守	如今，我们就去奔投陈伯之，以便行事，假若事情不能成功，就去投靠北魏，也不失能做河南郡守
遂投伯之，大见亲狎	于是，褚就去投靠了陈伯之，得到陈伯之异常的亲近
伯之又以乡人朱龙符为长流参军，并乘伯之愚暗，恣为奸利	陈伯之又委任同乡人朱龙符为长流参军，于是褚和朱龙符两人一起乘着陈伯之愚昧不明，肆意而为，恶行不断
魏扬州小岘戍主党法宗袭大岘戍，破之，虏龙骧将军邾菩萨	北魏扬州小岘戍戍主党法宗袭击梁朝大岘戍，克敌获胜，俘虏了梁朝龙骧将军邾菩萨
陈伯之闻王茂来，谓褚等曰：王观既不就命，郑伯伦又不肯从，便应空手受困	陈伯之闻知王茂前来讨伐，对褚等人说：王观不来就命，郑伯伦又不肯顺从，我们将会空手受困
今先平豫章，开通南路，多发丁力，益运资粮，然后席卷北向，以扑饥疲之众，不忧不济	现在，我们先占取豫章，开通南边的道路，多加发动丁役，增运粮食物资，然后以卷席之势北上，直扑饥饿疲劳之众，不愁不得成功
六月，留乡人唐盖人守城，引兵趣豫章，攻伯伦，不能下	六月，陈伯之留下同乡人唐盖人防守寻阳城，自己领兵向豫章进发，攻打郑伯伦，但是不能攻下
王茂军至，伯之表里受敌，遂败走，间道渡江，与虎牙等及褚俱奔魏	王茂的军队到了，陈伯之里外受敌，力不能支，于是败逃而去，抄小道渡过了长江，与陈虎牙等人以及褚一起奔投北魏
上遣左右陈建孙送刘季连子弟三人入蜀，使谕旨慰劳	武帝派遣身边人陈建孙送刘季连子弟三人入蜀，使他们宣谕圣旨，加以慰劳
季连受命，饬还装，益州刺史邓元起始得之官	刘季连接受了使命，收拾准备回去时的行装，因此，益州刺史邓元起始得去赴任
秋，八月，丁未，命尚书删定郎济阳蔡法度损益王植之集注旧律，为《梁律》，仍命与尚书令亮、侍中王莹、尚书仆射沈约、吏部尚书范云等九人同议定	秋季，八月丁未，武帝命令尚书删定郎、济阳人蔡法度审定王植之集注的旧律，定为《梁律》，又命令其与尚书令王亮、侍中王莹、尚书仆射沈约、吏部尚书范云等九人一同议定
上素善钟律，欲厘正雅乐，乃自制四器，名之为通	武帝素来精通钟律，想要整理、订正雅乐，于是自己制四件乐，起名为通
每通施三弦，黄钟弦用二百七十丝，长九尺，应钟弦用一百四十二丝，长四尺七寸四分差强，中间十律，以是为差	每通施用三弦，黄钟弦用二百七十丝，长九尺；应钟弦用一面四十二丝，长四尺七寸四分多，中间的十律，以此而递减
因为通声转推月气，悉无差违，而还得相中	于是，用通声转过来推算月气，一点差错也没有，而反过来再一推算，也能相合
又制十二笛，黄钟笛长三尺八寸，应钟笛长二尺三寸，中间十律以是为差，以写通声，饮古钟玉律，并皆不差	武帝又制了十二笛，黄钟笛长三尺八寸，应钟笛长二尺三寸，中间的十律以此而递减，以十二笛之声对校于通声，并且酌对于古钟玉律，都互相符合一致，没有差误
于是被以八音，施以七声，莫不和韵	于是，以此被以金、石、丝、竹、匏、土、革、木八音，施以宫、商、角、徵、羽、变宫、变徵七声，无不合韵
先是，宫悬止有四D钟，杂以编钟、编磬、衡钟凡十六D	早先之时，四面只有四D钟，杂以编钟、编磬、衡钟等共十六
上始命设十二D钟，各有编钟、编磬，凡上三十六，而去衡钟，四隅植建鼓	武帝开始命令设置十二D钟，各有编钟、编磬，总共三十六D，而去抻衡钟，在四个角上安放建鼓
魏高祖之丧，前太傅平阳公丕自晋阳来赴，遂留洛阳	北魏孝文帝的丧礼，前太傅、平阳公元丕从晋阳来参加，于是留居洛阳
丕年八十余，历事六世，位极公辅，而还为庶人	元丕年届八十多岁，历事六世，位极三公和辅相，而回家之后成为平民
魏主以其宗室耆旧，矜而礼之	北魏宣武帝因元丕是宗室中的遗老，尊敬而礼待他
乙卯，以丕为三老	乙卯，宣武帝以元丕为三老
魏扬州刺史任城王澄表请攻钟离，魏主使羽林监敦煌范绍诣寿阳，共量进止	北魏扬州刺史、任城王元澄上表宣武帝，请求攻打钟离，宣武帝派遣羽林监、敦煌人范绍到达寿阳，与元澄共同商量如何具体行动
澄曰：当用珍十万，往来百日，乞朝廷速办粮伏	元澄说：应当用兵十万，来去一百天，请求朝廷迅速备办军粮和兵器
绍曰：今秋已向末，方欲调发，兵仗可集，粮何由致	范绍说：今年的秋天已经快过去了，你方才要征发兵粮，兵器可以收集得到，但是粮食上哪里去找呢
有兵无粮，何以克敌	有兵而无粮，如何克敌取胜呢
澄沈思良久曰：实如卿言	元澄沉思了很久，说道：确实如您讲的这样，是不好办
乃止	于是，就停止了这一行动
九月，丁巳，魏主如邺	九月丁巳，北魏宣武帝到达邺城
冬，十月，庚子，还至怀，与宗室近侍射远，帝射三百五十余步，群臣刻铭以美之	冬季，十月庚子，返回到怀地，同宗室近侍比赛射箭，看谁射得远，宣武帝射了三百五十多步远，群臣们刻铭树碑来赞美这件事
早辰，还洛阳	甲辰，宣武帝回到洛阳
甲子，立皇子统为太子	甲子，梁朝立皇子萧统为太子
魏洛阳宫室始成	北魏洛阳的宫室方始建成
十二月，将军张嚣之侵魏淮南，取木陵戍；魏任城王澄遣辅国将军成兴击之，嚣之败走，魏复取木陵	十二月，梁朝将军张嚣之入侵北魏淮南，占领了木陵戍；北魏任城王元澄派遣辅国将军成兴去攻击，张嚣之败逃，北魏收复了木陵
刘季连遣其将李奉伯等拒邓元起，元起与战，互有胜负	刘季连派遣其将领李奉伯等人抵御邓元起，邓元起与他们交战，双方互有胜负
久之，奉伯等败，还成都，元起进屯西平	许久之后，李奉伯等人战败，回到成都，邓元起进驻了西平
季连驱略居民，闭城固守	刘季连驱赶掠夺居民，闭城固守
元起进屯蒋桥，去成都二十里，留辎重于V	邓元起进驻蒋桥，离成都二十里远近，把辎重物资留在V城
奉伯等间道袭V，陷之，军备尽没	李奉伯等人抄小道袭击V城，攻打下了V城，邓元起的军备全部丧失
元起舍V，径围州城；城局参军江希之谋以城降，不克而死	邓元起放弃V城，径直去围攻州城，城局参军江希之打算献城投降，但是没有实现而死去
是岁，江东大旱，米斗五斤，民多饿死	这一年，江东大旱成灾，一斗米卖到五千钱，百姓饿死很多
	二年（癸未、503
春，正月，乙卯，以尚书仆射沈约为左仆射，吏部尚书范云为右仆射，尚书令王亮为左光禄大夫	春季，正月，乙卯，梁武帝任命尚书仆射沈约为左仆射，吏部尚书范云为右仆射，尚书令王亮为左光禄大夫
丙辰，亮坐正旦诈疾不登殿，削爵，废为庶人	丙辰，王亮因在正月初一假称有病不登殿朝贺而获罪，被削去爵位，黜为平民
乙亥，魏主耕籍田	乙亥，北魏宣武帝到籍田举行亲耕仪式
魏梁州氐杨会叛，行梁州事杨椿等讨之	北魏梁州氐人杨会反叛，行梁州事杨椿等人讨伐他
三月，己巳，魏皇后蚕于北郊	三月，己巳，北魏皇后在北郊举行养蚕仪式
庚辰，魏扬州刺史任城王澄遣长风城主奇道显入寇，取阴山、白蒿二戍	庚辰，北魏扬州刺史任城王元澄派遣长风城城主奇道显入侵梁朝，占取了阴山、白藁两个城堡
五月，丁巳，霄城文侯范云卒	五月丁巳，霄城文侯范云去世
壬申，断诸郡县献奉二宫，惟诸州及会稽许贡任土，若非地产，亦不得贡	壬申，梁武帝敕令停止各郡县为上宫和东宫贡献物品，只准许各州以及会稽郡可以根据本土的具体情况制定贡奉物品种类，但是如果不是本地所产的，也不得上贡
甲戌，魏杨椿等大破叛氐，斩首数千级	甲戌，北魏杨椿等人大败叛乱的氐族部落，斩首数千人
六月，壬午朔，魏立皇弟悦为汝南王	六月，壬午朔，北魏封立宣武帝的弟弟元悦为汝南王
魏扬州刺史任城王澄表称：萧衍频断东关，欲令巢湖乏溢以灌淮南诸戍	北魏扬州刺史、任城王元澄上表讲道：萧衍频频地阻断东关，想使巢湖泛滥，以便淹灌淮河南边的各个城堡
吴、楚便水，且灌且掠，淮南之地将非国有	吴、楚之地有水域之便，他们可以一边淹灌，一边掠夺，所以淮河南边的地盘将非我国所有了
寿阳去江五百余里，众庶惶惶，并惧水害，脱乘民之愿，攻敌之虚，豫勒诸州，纂集士马，有秋大集，应机经略，虽混壹不能必果，江西自是无虞矣	寿阳离长江五百多里，民众惶惶不安，都害怕水害到来，如果乘民众担心梁朝水淹其地的机会，攻打敌人于不备，预先勒令各州，准备兵士和战马，到秋天汇齐集中，根据情况布署决定行动方案，这样虽然统一天下不一定必能成功，但是长江之西却从此没有什么可忧虑的了
丙戌，魏发冀、定、瀛、相、并、济六州二万人，马一千五百匹，令仲秋之中毕会淮南，并寿阳先兵三万，委澄经略；萧宝寅、陈伯之皆受澄节度	丙戌，北魏调发冀、定、瀛、相、并、济六个州的两万人，一千五百匹马，令于仲秋之中期全部在淮南会合，加上寿阳原有的三万兵力，一并委于元澄指挥调遣，萧宝寅和陈伯之也受元澄指挥
甲午，以中书监王莹为尚书右仆射	甲午，任命中书监王莹为尚书右仆射
秋，七月，乙卯，魏平阳平公丕卒	秋季，七月，乙卯，北魏平阳公元丕去世
魏既罢盐池之禁，而其利皆为富强所专	北魏撤销了关于盐池的禁令之后，盐池的利益都被富豪们所夺去
庚午，复收盐池利入公	庚午，北魏重新宣布收盐池之利入公
辛未，魏以彭城王勰为太师，勰固辞	辛未，北魏任命彭城王元勰为太师，元勰坚决推辞而不接受
魏主赐诏敦谕，又为家人书，祈请恳至；勰不得已，受命	北魏宣武帝赐给元勰诏书，谆谆劝谕，以小辈身分给他写了家信，一再祈请，恳切至备，元勰不得已，只好受命
八月，庚子，魏以镇南将军元英都督征义阳诸军事	八月庚子，北魏委任镇南将军元英都督征义阳诸军事
司州刺史蔡道恭闻魏军将至，遣骁骑将军杨由帅城外居民三千余家保贤首山，为三栅	梁朝司州刺史蔡道恭闻知北魏军队将要到了，派遣骁骑将军杨由率领城外的居民三千多家去保卫贤首山，杨由建立了三重栅垒以作防守
冬，十月，元英勒诸军围贤首栅，栅民任马驹斩由降魏	冬季，十月，元英统率各部兵众围住了贤首栅，栅内的民众任马驹斩了杨由，投降北魏
乙亥，尚书左仆射沈约以母忧去职	乙亥，梁朝尚书左仆射沈约因为母亲去世而离职
乙酉，将军吴子阳与魏元英战于白沙，子阳败绩	乙酉，梁朝将军吴子阳与北魏元英交战于白沙，吴子阳败北
魏东荆州蛮樊素安作乱，乙酉，以左卫将军李崇为镇南将军、都督征蛮诸军事，将步骑讨之	北魏东荆州蛮人樊素安作乱，乙酉，北魏委任左卫将军李崇为镇南将军、都督征蛮诸军事，率领步、骑兵去讨伐樊素安
魏主纳高肇兄偃之女为贵嫔	北魏宣武帝纳高肇的哥哥高偃的女儿为贵嫔
春，正月，庚戌，征虏将军赵祖悦与魏江州刺史陈伯之战于东关，祖悦败绩	春季，正月，庚戌，梁朝征虏将军赵祖悦与北魏江州刺史陈伯之战于东关，赵祖悦战败
癸丑，以尚书右仆射王莹为左仆射，太子詹事柳次右仆射	癸丑，梁朝任命尚书右仆射王莹为左仆射，太子詹事柳次右仆射
丙辰，魏东荆州刺史杨大眼击叛蛮樊季安等，大破之	丙辰，北魏东荆州刺史杨大眼攻击反叛的蛮人樊季安等人，大获全胜
季安，素安之弟也	樊季安是樊素安的弟弟
丙寅，魏大赦，改元正始	丙寅，北魏大赦天下，改年号为正始
萧宝寅行及汝阴，东城已为梁所取，乃屯寿阳栖贤寺	萧宝寅行到汝阳之时，东城已经被梁朝军队占取了，于是就改驻在寿阳的栖贤寺
二月，戊子，将军姜庆真乘魏任城王澄在外，袭寿阳，据其外郭	二月，戊子，梁朝将军姜庆真乘北魏任城王元澄在外，袭击寿阳城，占据了寿阳城的外城
长史韦缵仓猝失图；任城太妃孟氏勒兵登陴，先守要便，激厉文武，安慰亲旧，将士咸有奋志	北魏长史韦缵仓促之中不知如何才好，任城太妃孟氏率兵登上女墙，先据守了要害之处，她勉励文武官员，安慰新投附来的寿阳兵民和旧有的将士，所以将士们都士气高昂
太妃亲巡城守，不避矢石	太妃亲自巡察城防，不避敌方飞箭流石
萧宝寅引兵至，与州军合击之，自四鼓战至下晡，庆真败走	萧宝寅领兵到了，与州军合力奋战，从四更激战到夕阳西下之时，姜庆真败逃而去
韦缵坐免官	韦缵因临阵失措而被免去官职
六月，癸未，大赦	六月癸未，梁朝大赦天下
秋，七月，癸丑，角城戍主柴庆宗以城降魏，魏徐州刺史元鉴遣淮阳太守吴秦生将千余人赴之	秋季，七月癸丑，梁朝角城戍主柴庆宗献出城池投降北魏，北魏徐州刺史元鉴派遣淮阳太守吴秦生率领一千多人赶赴角城
淮阴援军断其路，秦生屡战，破之，遂取角城	梁朝派遣淮阴的军队去增援角城不愿意降魏的人，阻断了吴秦生的去路，吴秦生屡次交战，打败了梁朝的援军，于是占取了角城
甲子，立皇子综为豫章王	甲子，梁朝封立皇子萧综为豫章王
魏李崇破东荆叛蛮，生擒樊素安，进讨西荆诸蛮，悉降之	北魏李崇攻破东荆州叛乱的蛮人，活捉了樊素安，进而讨伐西荆州各部蛮人，使各部都投降归顺
卫尉郑绍叔忠于事上，外所闻知，纤豪无隐	卫尉郑绍叔忠心耿耿奉侍武帝，凡在外面听到什么，毫无隐瞒地讲给武帝
每为上言事，善则推功于上，不善则引咎归已，上以是亲之	每次给武帝汇报事情，如果是好事，他就把功绩归结于武帝；如果不是好事，他则把责任归结于自身，因此武帝特别亲近他
诏于南义阳置司州，移镇关南，以绍叔为刺史	武帝诏令在南义阳设置司州，州治所移于关南，任命郑绍叔为刺史
绍叔立城隍，缮器械，广田积谷，招集流散，百姓安之	郑绍叔到任之后，筑建城壕，修缮器械，增广农田，积储谷物，招集流散人口，因此百姓安居乐业
九月，壬子，以吐谷浑王伏连筹为西秦・河二州刺史、河南王	九月壬子，梁朝任命吐谷浑王慕容伏连筹为西秦州和河州刺史、河南王
柔然侵魏之沃野及怀朔镇，诏车骑大将军源怀出行北边，指授方略，随须征发，皆以便宜从事	柔然国入侵北魏的沃野和怀朔镇，北魏宣武帝诏令车骑大将军源怀出征北方，凡是指挥布置、军需物品的调发等，都授权他全权处理
怀至云中，柔然遁去	源怀到达云中，柔然人远遁而去
怀以为用夏制夷，莫如城郭，还，至恒、代，按视诸镇左右要害之地，可以筑城置戍之处，欲东西为九城，及储粮积仗之宜，犬牙相救之势，凡五十八条，表上之，曰：今定鼎成周，去北遥远，代表诸国颇或外叛，仍遭旱饥，戎马甲兵十分阙八	源怀认为用中原的方法制服蛮夷，最好是修建城池，所以返回后，到了恒、代之地，视察了各镇周围的要害之地，选定可以修城筑寨之处，准备从东到西共修建九座城池，以及选定适合于储备粮食兵器而呈犬牙交错之势可以互相援救的据点，共五十八条建议，表奏朝廷，讲道：现在迁都洛阳，离开北边非常遥远，故都代京以北的各部落多有外叛，同时又遭受旱灾，出现饥荒，以致戎马甲兵十分中缺去八分
谓宜准旧镇，东西相望，令形势相接，筑城置戍，分兵要害，劝农积粟，警急之日，随便翦讨	所以，我建议应该依照旧镇那样，为了做到可以东西相望，形势相连，在此修筑城堡，分兵把守要害之地，平时令他们屯田积粮，紧急之时，可以随时应战
彼游骑之寇，终不敢攻城，亦不敢越城南出	柔然游骑之寇，终不敢攻城，也不敢越过城堡而南下
如此，北方无忧矣	如此，北方就可以无忧了
魏主从之	宣武帝同意了这一建议
冬，十一月，戊午，魏诏营缮国学	冬季，十一月戊午，北魏宣武帝诏令营建修缮国学
时魏平宁日久，学业大盛，燕、齐、赵、魏之间，教授者不可胜数，弟子著录多者千余人，少者犹数百，州举茂异，郡贡孝廉，每年逾众	当时，北魏国内平静安宁日久，兴学之风大盛，燕、齐、赵、魏等地，讲学授业的人不可胜数，其弟子登记在册者多的有一千多人，少的也有几百名，州里举荐茂材异等的卓越人才，郡里举贡孝廉，人数一年比一年多
甲子，除以金赎罪之科	甲子，梁朝废除用钱赎罪的法令
十二月，丙子，魏诏殿中郎陈郡袁翻等议立律令，彭城王勰等监之	十二月丙子，北魏诏令殿中郎陈郡人袁翻等人议定设立法规律令，彭城王元勰等人担任总监
己亥，魏主幸伊阙	己亥，北魏宣武帝到达伊阙
上雅好儒术，以东晋、宋、齐虽开置国学，不及十年辄废之，其存亦文具而已，无讲授之实	武帝一向喜好儒术，认为东晋、宋、齐虽然开办了国学，但是不及十年都废止了，即使存在，也仅仅是形式而已，没有讲授之实
春，正月，癸卯朔，诏曰：二汉登贤，莫非经术，服膺雅道，名立行成	春季，正月，癸卯朔，武帝发布诏令：两汉时期的读书人登贤入仕，莫不是通过经术之业，他们都信奉大雅之道，个个饱学，因此能立功名，成大业
魏、晋浮荡，儒教沦歇，风节罔树，抑此之由	魏、晋以来，士人浮华放荡，而儒教衰败，风节得不到树立，当是其根本原因
可置《五经》博士各一人，广开馆宇，招内后进	所以，可以设置《五经》博士各一人，广开馆宇，招纳后进
于是以贺及平原明山宾、吴兴沈峻、建平严植之补博士，各主一馆，馆有数百生，给其饩廪，其射策通明者即除为吏	于是，将贺及平原人明山宾、吴兴人沈峻、建平人严植之补为博士，让他们各主持一馆，讲学执教，每馆有好几百名学生，由朝廷供给口粮等生活资用，其中在射策考试时应对自如，风解深刻透彻者，即被任为官吏
期年之间，怀经负笈者云会	因此，一年之间，天下士子怀经负笈，云集而至
，循之玄孙也	贺是贺循的玄孙
又选学生，往会稽云门山从何胤受业，命胤选门徙中经明行修者，具以名闻	朝廷又挑选学生，送他们去会稽云门山跟从何胤接受学业，命令何胤选拨门徒中通晓经学、品行优秀者，把他们的姓名上报朝廷
分遣博士祭酒巡州郡立学	朝廷又分遣博士祭酒巡视各州郡的立学情况
初，谯国夏侯道迁以辅国将军从裴叔业镇寿阳，为南谯太守，与叔业有隙，单骑奔魏	原先，谯国人夏侯道迁以辅国将军的身份随从裴叔业镇守寿阳，担任南谯太守，因与裴叔业不合，于是就一个人骑马奔投了北魏
魏以道迁为骁骑将军，从王肃镇寿阳，使道迁守合肥	北魏任命夏侯道迁为骁骑将军，随从王肃镇守寿阳，王肃指派夏侯道迁驻守合肥
肃卒，道迁弃戍来奔，从梁、秦二州刺史庄丘黑镇南郑，以道迁为长史，领汉中太守	王肃去世，夏侯道迁丢下戍所来投靠南朝，随从梁、秦二州刺史庄丘黑镇守南郑，庄丘黑任命夏侯道迁为长史，兼汉中太守
黑卒，诏以都官尚书王珍国为刺史，未至，道迁阴与军主考城江忱之等谋降魏	庄丘黑死后，朝廷诏令都官尚书王珍国为刺史，没有到任，夏侯道迁便私下里与军主考城人江忱之等人密谋投降北魏
辛亥，上祀南郊，大赦	辛亥，梁武帝在南郊祭祀，并诏令大赦天下
乙丑，魏以骠骑大将军高阳王雍为司空，加尚书令广阳王嘉仪同三司	乙丑，北魏任命骠骑大将军高阳王元雍为司空，加封尚书令广阳王元嘉仪同三司
二月，丙子，魏以宕昌世子梁弥博为宕昌王	二月丙子，北魏封容昌世子梁弥博为宕昌王
上谋伐魏，壬午，遣卫尉卿杨公则将宿卫兵塞洛口	武帝策谋讨伐北魏，壬午，派遣卫尉卿杨公则率领宿卫兵堵塞了洛口
壬辰，交州刺史李凯据州反，长史李讨平之	壬辰，交州刺史李凯占据了州城反叛朝廷，长史李讨伐并平定了李凯的反叛
魏邢峦至汉中，击诸城戍，所向摧破	北魏邢峦到达汉中，对各城堡发起了攻击，所向无敌，无坚不摧
晋寿太守王景胤据石亭，峦遣统军李义珍击走之	晋寿太守王景胤占据着石亭，邢峦派遣统军李义珍打跑了他
魏以峦为梁、秦二州刺史	北魏任命邢峦为梁、秦二州刺史
巴西太守庞景民据郡不下，郡民严玄思聚众自称巴州刺史，附于魏，攻景民，斩之	巴西太守庞景民占据郡城，拒不投降，郡中之民严玄思聚集群众，自封为巴州刺史，投附于北魏，攻打庞景民并将他斩首
杨集起、集义闻魏克汉中而惧，闰月，帅群氐叛魏，断汉中粮道，峦屡遣军击破之	杨集起、杨集义得知北魏攻克汉中的消息之后害怕了，于闰三月，率领氐族部落反叛了北魏，切断了汉中的粮道，邢峦多次派遣军队去袭击、打败了他们
夏，四月，丁巳，以行宕昌王梁弥博为河・凉二州刺史、宕昌王	夏季，四月丁巳，梁朝任命行宕昌王梁弥博为河、凉二州刺史和宕昌王
冠军将军孔陵等将兵二万戍深杭，鲁方达戍南安，任僧褒等戍石同，以拒魏	梁朝冠军将军孔陵等人率兵两万戍守深杭，鲁方达戍守南安，任僧褒等人戍守石同，以便抵拒北魏
邢峦遣统军王足将兵击之，所至皆捷，遂入剑阁	邢峦派遣统军王足带兵去袭击，所到之处无不告捷，于是进入剑阁
陵等退保梓潼，足又进击，破之	孔陵等人只好退保梓潼，王足又进攻，打败了他们
梁州十四郡地，东西七百里，南北千里，皆入于魏	于是，梁州十四郡之地，东西七百里，南北一千里，全部归入北魏版图
六月，庚戌，初立孔子庙	六月庚戌，梁朝初立孔子庙
豫州刺史王超宗将兵围魏小岘	豫州刺史王超宗率兵围攻北魏小岘
丁卯，魏扬州刺史薛真度遣兼统军李叔仁等击之，超宗兵大败	丁卯，北魏扬州刺史薛真度派遣兼统军李叔仁等人出击，王超宗的军队一败涂地
冠军将军王景胤、李畎、辅国将军鲁方达等与魏王足战，屡败，秋，七月，足进逼涪城	冠军将军王景胤、李畎、辅国将军鲁方达等同北魏的王足交战，屡战屡败，秋季，七月，王足进逼涪城
八月，壬寅，魏中山王英寇雍州	八月壬寅，北魏中山王元英入侵雍州
庚戌，秦、梁二刺史鲁方达与魏王足统军纪洪雅、卢祖迁战，败，方达等十五将皆死	庚戌，梁朝秦、梁二州刺史鲁方达与北魏王足手下的统军纪洪雅、卢祖迁交战，战败，鲁方达等十五员将领都战死
壬子，王景胤等又与祖迁战，败，景胤等二十四将皆死	壬子，王景胤等人又与卢祖迁交战，也战败，王景胤等二十四位将领全部战死
杨公则至洛口，与魏豫州长史石荣战，斩之	杨公则到达洛口，与北魏豫州长史石荣交战，将石荣斩首
甲寅，将军姜庆真与魏战于羊石，不利，公则退屯马头	甲寅，将军姜庆真与北魏军队在羊石交战，没有取胜，杨公则只好退驻于马头
雍州蛮沔东太守田青喜叛降魏	担任沔东太守的雍州蛮人田青喜反叛梁朝，投降了北魏
魏有芝生于太极殿之西序，魏主以示侍中崔光，光上表，以为此《庄子》所谓气蒸成菌者也	北魏朝廷太极殿内的西墙下生长出了灵芝，北魏宣武帝拿来给侍中崔光看，崔光就此事而上表皇上，认为：这只是《庄子》一书中所讲的气蒸成菌罢了
柔脆之物，生于墟落秽湿之地，不当生于殿堂高华之处；今忽有之，厥状扶疏，诚足异也	这种柔脆的菌类之物，一般生长在废墟角落污秽潮湿的地方，不应当生长在殿堂这样高贵华丽之处；如今忽然生长出来了，而且其形状繁茂，实在是奇怪之事
夫野木生朝，野鸟入庙，古人皆以为败亡之象，故太戊、中宗惧灾修德，殷道以昌，所谓家利而怪先，国兴而妖豫者也	野木生于朝庭，野鸟飞入宗庙，古人都认为这是败亡的征兆，所以商王太戊、高宗有惧于祥桑、谷共生于朝内以及野鸡飞在鼎上之异兆而修德积善，国运因此而得以复兴昌盛，这正是所谓家族吉利而怪异先行，国家兴盛而妖异预见
今西南二方，兵革未息，郊甸之内，大旱逾时，民劳物悴，莫此之甚，承天育民者所宜矜恤；伏愿陛下侧躬耸意，惟新圣道，节夜饮之乐，养方富之年，则魏祚可以永隆，皇寿等于山岳矣	如今西方和南方兵戈未息，京郊周围大旱久时，百姓劳苦，万物憔悴，已经到了万分严重的地步，而承受上天旨意养育万民的天子在此之际正应该加以体恤，所以恳请陛下关心朝廷内外之事，亲身过问，弘扬圣道，节制夜间饮酒的娱乐，保养正值年轻的身体，如此则北魏的国祚可以永远兴隆，皇寿与山岳等齐
于是魏主好宴乐，故光言及之	此时，北魏宣武帝喜好宴饮欢乐，所以崔光在上表中特意提到这点
九月，己巳，杨公则等与魏扬州刺史元嵩战，公则败绩	九月己巳，杨公则等人与北魏扬州刺史元嵩交战，杨公则败北
冬，十月，丙午，上大举伐魏，以扬州刺史临川王宏都督北讨诸军事，尚书右仆射柳为副，王公以下各上国租及田谷以助军	冬季，十月丙午，武帝发动军队大举征伐北魏，任命扬州刺史临川王萧宏为都督北讨诸军事，尚书右仆射柳为副，王公以下者各上交封国所收之租和职田所收之谷以便资助军队
宏军于洛口	萧宏驻军于洛口
杨集起、集义立杨绍先为帝，自皆称王	杨集起、杨集义拥立杨绍先为帝，自己都称王
十一月，戊辰朔，魏遣光禄大夫杨椿将兵讨之	十一月戊辰朔，北魏派遣光禄大夫杨椿率兵讨伐杨集起等
十二月，庚申，魏遣骠骑大将军源怀讨武兴氐，邢峦等并受节度	十二月庚申，北魏派遣骠骑大将军源怀讨伐武兴的氐族部落，邢峦等人一并接受源怀的指挥调遣
司徒、尚书令谢以母忧去职	梁朝司徒、尚书令谢因为母亲守丧而去职
是岁，大穰，米斛三十钱	这一年，大丰收，米价每斛三十钱
	五年
春，正月，丁卯朔，魏于后生子昌，大赦	春季，正月，丁卯朔，北魏于皇后生下儿子元昌，大赦天下
杨集义围魏关城，邢峦遣建武将军傅竖眼讨之，集义逆战，竖眼击破之；乘胜逐北，壬申，克武兴，执杨绍先，送洛阳	杨集义围攻北魏关城，邢峦派遗建武将军傅竖眼去讨伐，杨集义迎战，傅竖眼击败了杨集义，并乘胜追逐败军，壬申，攻克了武兴，抓获了杨绍先，押送往洛阳
杨集起、杨集义亡走，遂灭其国，以为武兴镇，又改为东益州	杨集起、杨集义逃跑了，于是灭掉了他们所建之国，改为武兴镇，其后又改为东益州
乙亥，以前司徙谢为中书监、司徒	乙亥，梁朝任命前司徒谢为中书监、司徒
冀州刺史桓和击魏南青州，不克	梁朝冀州刺史桓和攻打北魏的南青州，没有攻克
魏秦州屠各王法智聚众二千，推秦州主簿吕苟儿为主，改元建明，置百官，攻逼州郡	北魏秦州匈奴屠各部落的王法智聚集两千人，推举秦州主簿吕苟儿为首领，改年号为建明，设置了百官，攻逼州郡
泾州民陈瞻亦聚众称王，改元圣明	泾州的百姓陈瞻也聚众称王，改年号为圣明
己卯，杨集起兄弟相帅降建〔魏〕	己卯，杨集起兄弟一起投降了北魏
甲申，封皇子纲为晋安王	甲申，梁朝封皇子萧纲为晋安王
二月，丙辰，魏主诏王公以下直言忠谏	二月丙辰，北魏宣武帝诏令王公以下的官员对自己直言忠谏
治书侍御史阳固上表，以为当今之务，宜亲宗室，勤庶政，贵农桑，贱工贾，绝谈虚穷微之论，简桑门无用之费，以救饥寒之苦	诏书侍御史阳固上表，认为：圣上当今所应做的是要亲近宗室，勤于庶政，鼓励农桑，抑制工商，杜绝一切不切合实际的谈论玄虚之理，压缩佛门无用的费用，用以救济饥寒之苦
时魏主委任高肇，疏薄宗室，好桑门之法，不亲政事，故固言及之	当时宣武帝把政事委任于高肇，疏远皇室宗亲，热衷于佛法，不亲自过问朝廷政事，所以阳固才有上述之言
戊午，魏遣右卫将军元丽都督诸军讨吕苟儿	戊午，北魏派遣右卫将军元丽督率各路军队讨伐吕苟儿
丽，小新成之子也	元丽是小新成的儿子
乙丑，徐州刺史历阳昌义之与魏平南将军陈伯之战于梁城，义之败绩	乙丑，，梁朝徐州刺史历阳人昌义之同北魏平南将军陈伯之在梁城交战，昌义之战败
将军萧将兵击魏徐州，围淮阳	梁朝将军萧率兵攻打北魏徐州，围攻淮阳
三月，丙寅朔，日有食之	三月，丙寅朔，发生日食
己卯，魏荆州刺史赵怡、平南将军奚康生救淮阳	己卯，北魏荆州刺史赵怡、平南将军奚康生前去援救淮阳
魏咸阳王禧之子翼，遇赦求葬其父，屡泣请于魏主，魏主不许	北魏咸阳王元禧的儿子元翼，遇赦后请求安葬父亲，数次在宣武帝面前哭着请求，宣武帝没有准许
癸未，翼与其弟昌、晔来奔	癸未，元翼同其弟弟元昌、元晔前来奔投梁朝
上以翼为咸阳王，翼以晔嫡母李妃之子也，请以爵让之，上不许	武帝封元翼为咸阳王，元翼因为元晔是正室母亲李妃所生，所以请求把爵位让给元晔，但是武帝没有准许
辅国将军刘思效败魏青州刺史元系于胶水	梁朝的辅国将军刘思效在胶水击败了北魏青州刺史元系
临川王宏使记室吴兴丘迟为书遗陈伯之曰：寻君去就之际，非有他故，直以不能内审诸已，外受流言，沈迷猖蹶，以至于此	临川王萧宏让记室吴兴人丘迟写信送给陈伯之，信中说道：思量您投降北魏之时，没有别的原因，只是因为内心不能自审，外受流言的影响，迷乱而猖狂，以至于到了这样的地步
主上屈法申恩，吞舟是漏，将军松柏不翦，亲戚安居，高台未倾，爱妾尚在	当今皇上不惜不按法律以申恩德，即使再大的罪过也能宽宥，所以将军您的祖坟没有被毁，松柏茂盛；您留在江南的亲戚都没有以叛党连坐，而安居自苦；您的宅第没有受损，池台如故；您的爱妾还守在家中，没有被官家收去或流落于其他人家
而将军鱼游于沸鼎之中，燕巢于飞幕之上，不亦惑乎	可是，将军您却如鱼游于沸鼎之中，如燕筑巢于飞动的幕布之上，至今身在敌营，这不是非常糊涂的事吗
想早励良图，自求多福	希望您能早日替自己谋一条好的出路，以便获得日后的幸福
庚寅，伯之自寿阳梁城拥众八千来降，魏人杀其子虎牙	庚寅，陈伯之从寿阳梁城率领八千人马来投降梁朝，北魏人杀了他的儿子陈虎牙
诏复以伯之为西豫州刺史；未之任，复以为通直散骑常侍	武帝诏令仍以陈伯之为西豫州刺史，陈伯之还没有到任，又任命他为通直散骑常侍
久之，卒于家	后来，陈伯之在家中去世
初，魏御史中尉甄琛，表称：《周礼》，山林川泽有虞、衡之官，为之厉禁，盖取之以时，不使戕贼而已，故虽置有司，实为民守之也	起初，北魏御史中尉甄琛上表讲道：《周礼》中制定了专管山林川泽的山虞、林衡、川衡、泽虞之官，制定了关于山林川泽的严厉禁令，这是使百姓在规定的时令内获取利益，而不让随意乱砍滥取，所以虽然设置了这样的官员，实际上却是百姓自己守护
夫一家之长，必惠养子孙，天下之君，必惠养兆民，未有为人父母而吝其醯醢，富有群生而榷其一物者也	一家之长，必须抚养他的子孙，天下之君，必须惠养万民，没有做父母吝啬醋酱、富有天下万物而专占一物的
今县官鄣护河东盐池而收其利，是专奉口腹而不及四体也	如今朝廷独霸河东的盐池而坐收其利，这是专奉口腹而不及四体
盖天子富有四海，何患于贫	天子富有四海，何患于贫
乞驰盐禁，与民共之	所以，乞请放松盐禁，与民共享其利
录尚书事勰、尚书邢峦奏，以为琛之所陈，坐谈则理高，行之则事阙	录尚书事元勰和尚书邢峦也上奏，认为：甄琛所讲的，坐着谈论则高明合理，而实际执行则行不通
窃惟古之善治民者，必污隆随时，丰俭称事，役养消息以成其性命	我们认为古来善于统治百姓的，必定升降依时，丰俭随事，役使养育互为消长以成全他们性命
若任其自生，随其饮啄，乃是刍狗万物，何以君为	如果任其自生自长，随其饮水啄食，那是把百姓当作刍草狗畜，还要君主做什么呢
是故圣人敛山泽之货以宽田畴之赋，收关市之税以助什一之储，取此与彼，皆非为身，所谓资天地之产，惠天地之民也	所以，圣人获取山泽之货，收取关市之税，来补助田亩什一之赋之不足，以供国用，此处取来用到彼处，都不是为了自己，正所谓利用天地的出产，施惠于天下之民
今盐池之禁，为日已久，积而散之，以济军国，非专为供太官之膳羞，给后宫之服玩	如今禁止私人采盐，已经实行了很长时间了，集中其财富而使用，是为了维持国家和军队的开支，并不是专门为了供给皇宫的饮食，以及后宫的服饰玩物
既利不在已，则彼我一也	既然不是为了皇上一人享乐，那么让老百姓获利同让国家获利都是一样的
然自禁盐以来，有司多慢，出纳之间，或不如法	然而，自从禁盐以来，官员们多有不经心的，收支出纳中间，或者有不按照法令执行的行为
是使细民嗟怨，负贩轻议，此乃用之者无方，非作之者有失也	因此，使老百姓抱怨在心，商贩们非议在口，这只不过是管理者无方，并非是制定禁令的人有过失
一旦罢之，恐乖本旨	一旦撤销盐池禁令，恐怕有违于本初之意
一行一改，法若弈棋，参论理要，宜如旧式	一行一改，没有定法，正如奕棋者那样举棋不定，所以按理而论，应该维持过去的样子而不变
魏主卒从琛议，夏，四月，乙未，罢盐池禁	宣武帝最终采纳了甄琛的建议，夏季，四月乙未，撤销了盐池禁令
庚戌，魏以中山王英为征南将军、都督扬・徐二州诸军事，帅众十余万以拒梁军，指授诸节度，所至以便宜从事	庚戌，北魏任命中山王元英为征南将军，都督扬、徐二州诸军事，统率十多万大军抵抗梁朝军队，指挥各路军队，所到之处随机而行事
癸未，魏遣征西将军于劲节度秦、陇诸军	癸未，北魏派遣征西将军于劲指挥秦、陇之地的军队
丁亥，庐江太守闻喜裴邃克魏羊石城，庚寅，又克霍丘城	丁亥，又攻克了霍丘城
乙巳，魏安西将军元丽击王法智，破之，斩首六千级	乙巳，北魏安西将军元丽进攻王法智，打败了他，斩首六千多
张惠绍与假徐州刺史宋黑水陆俱进，趣彭城，围高冢戍，魏武卫将军奚康生将兵救之，丁未，惠绍兵不利，黑战死	张惠绍与代理徐州刺史的宋黑水陆并进，直抵彭城，围攻高冢戍，北魏武卫将军奚康生率兵前去援救，丁未，张惠绍出兵失利，宋黑战死
丁巳，魏以度支尚书邢峦都督东讨诸军事	丁巳，北魏委派度支尚书邢峦都督东讨诸军事
秋，七月，丙寅，桓和击魏兖州，拨固城	秋季，七月丙寅，桓和攻打北魏兖州，攻占了固城
吕苟儿率众十余万屯孤山，围逼秦州，元丽进击，大破之	梁朝吕苟儿率领十多万人驻扎在孤山，围逼秦州，元丽进攻，大败吕苟儿
行秦州事李韶掩击孤山，获其父母妻子，庚辰，苟儿帅其徒诣丽降	代理秦州刺史李韶偷袭孤山，抓获了吕苟儿的父母、妻子和儿女，庚辰，吕苟儿率领部下向元丽投降
戊子，徐州刺史王伯敖与魏中山王英战于阴陵，伯敖兵败，失亡五千余人	戊子，徐州刺史王伯敖与北魏中山王元英在阴陵交战，王伯敖兵败，失散伤亡五千多人
丁酉，梁兵围义阳者夜遁，魏郢州刺史娄悦追击，破之	丁酉，梁朝围攻义阳的军队听说洛口的军队溃逃，于夜间逃遁，北魏郢州刺史娄悦追击，击败了梁朝的逃兵
柔然库者汗可汗卒，子伏图立，号佗汗可汗，改元始平	柔然国库者可汗去世，其子伏图继立，号称佗汗可汗，改年号为始平
戊申，佗汗遣使者纥奚勿六跋如魏请和	戊申，佗汗派遣使节纥奚勿六跋来到北魏求和
魏主不报其使，谓勿六跋曰：蠕蠕远祖社仑，乃魏之叛臣，往者包容，暂听通使	宣武帝不愿和解，没有派使节回访，对勿六跋说：蠕蠕的远祖社仑，乃是北魏的叛臣，过去我们容纳它，暂时允许互通使节
仿蠕蠕衰微，不及畴昔，大魏之德，方隆周、汉，正以江南未平，少宽北略，通和之事，未容相许	现在蠕蠕衰落了，比不上从前了，而我们大魏国的仁德，正和周朝、汉朝一样方兴未艾，只是因为江南尚未平定，所以对北方稍微有所宽容，和好的事情，是不会答应的
若修藩礼，款诚昭著者，当不尔孤也	如果你们能对我们执藩国之礼，而且能明显地表示诚意，我们一定不会对不起你们的
魏京兆王愉、广平王怀国臣多骄纵，公行属请，魏主诏中尉崔亮穷治之，坐死者三十余人，其不死者悉除名为民	北魏京兆王元愉、广平王无怀的藩国中臣子大多骄奢纵肆，公然地营私舞弊，宣武帝诏令中尉崔亮彻底整治他们，结果获罪而被处死的有三十多人，那些没有被处死的全部除名为民
惟广平右常侍杨昱、文学崔楷以忠谏获免	唯有广平王的右常侍杨昱、文学崔楷因忠谏而获免
昱，椿之子也	杨昱是杨椿的儿子
初，汉归义侯势之末，群獠始出，北自汉中，南至邛、笮，布潢山谷	起初，汉代归义侯刘势的后期，獠人各部落才开始扩展，北自汉中，南至邛、笮，布满山谷
势既亡，蜀民多东徙，山谷空地皆为獠所据	刘势死后，蜀地之民大多东迁，山谷空地全被獠人所占据
其近郡县与华民杂居者，颇输租赋，远在深山者，郡县不能制	那些靠近郡县与汉族民众杂居的獠人，还交纳赋税，至于那些远住在深山之中的，郡县根本管不着他们
梁、益二州岁伐獠以自润，公私利之	梁、益两州每年都讨伐獠人，无论公私都从中得到了好处
及邢峦为梁州，獠近者皆安堵乐业，远者不敢为寇	邢峦做梁州刺史时，住在近处的獠人都安居乐业，住得远的也不敢出来抢掠
峦既罢去，魏以羊祉为梁州刺史，傅竖眼为益州刺史	邢峦被调走之后，北魏任命羊祉为梁州刺史，傅竖眼为益州刺史
祉性酷虐，不得物情	羊祉这个人性格残暴，不得人心
獠王赵清荆引梁兵入州境为寇，祉遗兵击破之	獠王赵清荆带梁朝兵进入州境侵掠，羊祉派兵击败了他们
竖眼施恩布信，大得獠和	傅竖眼广旋恩惠，立信于众，结果与獠人之间取得了和解
十二月，癸卯，都亭靖侯谢卒	十二月癸卯，都亭侯谢去世
魏人议乐，久不决	北魏人议定乐律，久而不决
	六年
春，正月，公孙崇请委卫军将军、尚书右仆射高肇监其事；魏主知肇不学，诏太常卿刘芳佐之	春季，正月，北魏公孙崇奏请委任卫军将军、尚书右仆射高肇监督制定乐律之事，宣武帝知道高肇不学无术，诏令太常卿刘芳辅佐他
魏中山王英与平东将军杨大眼等众数十万攻钟离	北魏中山王元英与平东将军杨大眼等数十万人马攻打钟离
钟离城北阻淮水，魏人于邵阳洲两岸为桥，树栅数百步，跨淮通道	钟离城北边有淮水为阻，北魏人在邵阳洲两岸架桥，树立栅栏数百步长，跨过淮水连通了南北道路
英据南岸攻城，大眼据北岸立城，以通粮运	元英占据南岸攻城，杨大眼占据北岸修筑城堡，以便粮运畅通
城中众才三千人，昌义之督帅将士，随方抗御	钟离城中才有三千人，昌义之督率将士，随机应变地守卫
魏人以车载土填堑，使其众负土随之，严骑蹙其后，人有未及回者，因以土迮之，俄而堑满	北魏人用车载土填入城壕之中，让大伙背着土跟随车后，又派骑兵紧跟在后面，那些来不及返回来的人，就被土埋进去了，不一会儿城壕就被填满了
冲车所撞，城土辄颓，义之用泥补之，冲车虽入而不能坏	北魏人用冲车撞城墙，所撞之处城墙上的土就掉下来一大片，昌义之用泥巴涂补，因此冲车虽然能撞入但不能撞毁城墙
魏人昼夜苦攻，分番相代，附而复升，莫有退者	北魏军队昼夜苦攻，轮班相替，从云梯上掉下来再上去，没有人后退
一日战数十合，前后杀伤万计，魏人死者与城平	每天交战数十次，前后杀伤的人以万计数，北魏死去的人的尸体堆的与城墙一般高
夏，四月，己酉，以江州刺史王茂为尚书右仆射，安成王秀为江州刺史	夏季，四月己酉，梁朝任命江州刺史王茂为尚书右仆射，安成王萧秀为江州刺史
秀将发，主者求坚船以为斋舫，秀曰：吾岂爱财而不爱士乎	萧秀将要出发赴任，管事的人要求用坚固船只装载库中财物，萧秀说：我怎么能爱财物而不爱士呢
乃以坚者给参佐，下者载斋物，既而遭风，斋舫遂破	于是把坚固船只让给参佐人士们乘坐，用差的船装载物资，途中遇上大风，装运物资的船只破而沉没了
丁巳，以临川王宏为骠骑将军、开府仪同三司，建安王伟为扬州刺史，右光禄大夫沈约为尚书左仆射，左仆射王莹为中军将军	丁巳，梁朝任命临川王萧宏为骠骑将军、开府仪同三司，建安王萧伟为扬州刺史，右光禄大夫沈约为尚书左仆射，左仆射王莹为中军将军
六月，丙午，冯翊等七郡叛降魏	六月丙午，冯翊等七个郡反叛投降了北魏
秋，七月，丁亥，以尚书右仆射王茂为中军将军	秋季，七月丁亥，梁朝任命尚书右仆射王茂为中军将军
八月，戊子，大赦	八月戊子，梁朝大赦天下
九月，己亥，魏以司空高阳王雍为太尉，尚书令广阳王嘉为司空	九月己亥，北魏任命司空高阳王元雍为太尉，尚书令广阳王元嘉为司空
甲子，魏开斜谷旧道	甲子，北魏开通了斜谷旧道
冬，十月，壬寅，以五兵尚书徐勉为吏部尚书	冬季，十月壬寅，梁朝任命五兵尚书徐勉为吏部尚书
勉精力过人，虽文案填积，坐客充满，应对如流，手不停笔	徐勉这个人精力过人，虽然文案上堆积满要处理的公文，宾客满座，他却可以应对如流，而手中的笔还不停止批阅公文
又该综百氏，皆为避讳	他还熟悉各个家族的情况，在和他们应对交往时避免触犯他们的家讳
尝与门人夜集，客虞求詹事五官，勉正色曰：今夕止可谈风月，不可及公事	有一天夜里，徐勉与门人们会集在一起，有个客人虞向他请求詹事五官的职位，徐勉严肃地说道：今晚只可以谈论风月，不可以涉及公事
时人咸服其无私	当时的人都佩服他无私心
闰月，乙丑，以临川王宏为司徙、行太子太傅，尚书左仆射沈约为尚书令、行太子少傅，吏部尚书袁昂为右仆射	闰月乙丑，梁朝任命临川王萧宏为司待、行太子太傅，尚书左仆射沈约为尚书令、行太子少傅，吏部尚书袁昂为右仆射
丁卯，魏皇后于氏殂	丁卯，北魏皇后于氏去世
是时高贵嫔有宠而妒，高肇势倾中外，后暴疾而殂，人皆归咎高氏，宫禁事秘，莫能详也	这时，高贵嫔得宠而妒心十足，高肇权倾朝廷内外，于皇后暴疾而死，人们都归咎于高氏，宫闱中的事情神秘，不能知道详情
甲申，以光禄大夫夏侯详为尚书左仆射	甲申，梁朝任命光禄大夫夏侯详为尚书左仆射
乙酉，魏葬顺皇后于永泰陵	乙酉，北魏安葬顺皇后于永泰陵
十二月，丙辰，丰城景公夏侯详卒	十二月丙辰，梁朝丰城景公夏侯详去世
乙丑，魏淮阳镇都军主常邕和以城来降	乙丑，北魏淮阳镇都军主常邕和献城投降梁朝
春，正月，魏颍川太守王神念来奔	春季，正月，北魏颍川太守王神念来投奔梁朝
壬子，以卫尉吴平侯兼领军将军	壬子，梁朝任命卫尉吴平侯萧兼领军将军
诏吏部尚书徐勉定百官九品为十八班，以班多者为贵	武帝诏令吏部尚书徐勉定百官九品为十八班，以班多者为贵
二月，乙丑，增置镇、卫将军以下为十品，凡二十四班；不登十品，别有八班	二月乙丑，增置镇、卫将军以下为十品，一共二十四班；不入十品之内的，另有八班
又置施外国将军二十四班，凡一百九号	又设置用于外国的将军二十四班，一共一百零九号
庚午，诏置州望、郡宗、乡豪各一人，专掌搜荐	庚午，武帝诏令设置州望、郡宗、乡豪各一人，专门掌管搜求人才向上举荐
三月，戊子，魏皇子昌卒，侍御师王显失于疗治，时人皆以为承高肇之意也	三月戊子，北魏皇子元昌去世，侍御师王显疗治有失，当时的人们都认为他是秉承了高肇的旨意而行事的
夏，四月，乙卯，皇太子纳妃，大赦	夏季，四月乙卯，梁朝皇太子纳妃子，大赦天下
五月，己亥，诏复置宗正、太仆、大匠、鸿胪，又增太府、太舟，仍先为十二卿	五月己亥，武帝又设置宗正、太仆、大匠、鸿胪，并增设太府、太舟，加上原先的共为十二卿
癸卯，以安成王秀为荆州刺史	癸卯，梁朝任命安成王萧秀为荆州刺史
先是，巴陵马营蛮缘江为寇，州郡不能讨，秀遣防文炽帅众燔其林木，蛮失其险，州境无寇	原先，巴陵的马营蛮沿长江为寇，州郡无法讨平，萧秀派遣防文炽率领一帮人马烧掉了江边的林木，蛮子失去了天险，无所依赖，故不敢再出来抢，从此州境内无有寇患
八月，癸丑，竟陵壮公曹景宗卒	八月癸丑，竞陵壮公曹景宗去世
初，魏主为京兆王愉纳于后之妹为妃，愉不爱，爱妾李氏，生子宝月	起初，北魏宣武帝为京兆王元愉纳于皇后的妹妹为妃子，元愉不喜爱她，而喜爱妾李氏，生下儿子宝月
于后召李氏入宫，棰之	于皇后把李氏召入宫中，用棒打她
愉骄奢贪纵，所为多不法	元愉骄奢贪纵，所做的大多是不法之事
帝召愉入禁中推按，杖愉五十，出为冀州刺史	宣武帝把元愉召入宫中询问调查，打了他五十大棍，让他出任冀州刺史
愉自以年长，而势位不及二弟，潜怀愧恨	元愉自以为年长，但权势位置都比不上两个弟弟，因此心中暗怀愧恨
又，身与妾屡被顿辱，高肇数谮愉兄弟，愉不胜忿；癸亥，杀长史羊灵引、司马李遵，诈称得清河王怿密疏，云高肇弑逆	同时，由于自己和妾屡次被侮辱，高肇又数次谗言陷害自己兄弟三人，所以元愉内心不胜忿恨；癸亥，元愉杀了长史羊灵引、司马李遵，假称获得清河王元怿的秘密报告，报告中有高肇弑君叛逆之言
遂为坛于信都之南，即皇帝位，大赦，改元建平，立李氏为皇后	于是，元愉就在信都的南郊筑坛祭天，登上了皇帝位，发出大赦令，改年号为建平，并且立李氏为皇后
法曹参军崔伯骥不从，愉杀之	法曹参军崔伯骥不顺从，元愉就杀了他
在北州镇皆疑魏朝有变，定州刺史安乐王诠具以状告之，州镇乃安	冀州之北的州镇都怀疑北魏朝廷有变故，定州刺史安乐王元诠把真实情况一一告诉他们，各州镇才安心了
乙丑，魏以尚书李平为都督北讨诸军、行冀州事以讨愉	乙丑，北魏使命尚书李平为都督北讨诸军、行冀州事，让他去讨伐元愉
平，崇之从父弟也	李平是李崇叔父的弟弟
丁卯，魏大赦，改元永平	丁卯，北魏大赦天下，改年号为永平
魏京兆王愉遣使说平原太守清河房亮，亮斩其使；愉遣其将张灵和击之，为亮所败	北魏京兆王元愉派遣使者去游说平原太守清河人房亮，房亮斩了来使；元愉派遣他的将领张灵和去攻打房亮，被房亮打败
李平军至经县，诸军大集，夜，有蛮兵数千斫平营，矢及平帐，平坚卧不动，俄而自定	李平的军队到了经县，各路军队汇集一起，夜间，有数千名蛮兵来冲击李平的营地，飞箭射到了李平的帐内，但是李平坚卧不动，不一会儿就自行平定下来了
九月，辛巳朔，愉逆战于城南草桥，平奋击，大破之，愉脱身走入城，平进围之	九月辛巳朔，元愉在城南草桥迎战李平，李平奋力攻击，大败敌军，元愉脱身而逃入城中，李平进军围城
壬辰，安乐王诠破愉兵于城北	壬辰，安乐王元诠在城北打败了元愉的军队
癸巳，立皇子绩为南康王	癸巳，梁朝立皇子萧绩为南康王
魏高后之立也，彭城武宣王勰固谏，魏主不听	北魏立高皇后之时，彭城武宣王元勰再三劝谏不可，宣武帝不听
高肇由是怨之，数谮勰于魏主，魏主不之信	高肇由此而怨恨元勰，数次在宣武帝面前进谗言诋毁元勰，宣武帝不听信
勰荐其舅潘僧固为长乐太守，京兆王愉之反，胁僧固与之同，肇因诬勰北与愉通，南招蛮贼	元勰推荐自己的舅舅潘僧固为长乐太守，京兆王元愉反叛，胁迫潘僧固与他同伙，高肇因此而诬告元勰北与元愉勾结相通，南招蛮贼
彭城郎中令魏偃、前防阁高祖珍希肇提擢，构成其事	彭城武宣王元勰手下的郎中令魏偃、原先的防阁高祖珍希望高肇提拔他们，就与高肇勾结一起陷害元勰
肇令侍中元晖以闻，晖不从，又令左卫元珍言之	高肇命令侍中元晖上报宣武帝，元晖不从，又命令左卫元珍去报告了
帝以问晖，晖明勰不然；又以问肇，肇引魏偃、高祖珍为证，帝乃信之	宣武帝就此事询问元晖，元晖说明元勰不会如此；宣武帝又以此事问高肇，高肇叫来魏偃和高祖珍作证，宣武帝就相信了高肇的诬陷
戊戌，召勰及高阳王雍、广阳王嘉、清河王怿、广平王怀、高肇俱入宴	戊戌，宣武帝召元勰以及高阳王元雍、广阳王元嘉、清河王元怿、广平王元怀、高肇一起入宴
勰妃李氏方产，固辞不赴	元勰的妃子李氏正在生产，因此他再三推辞不去赴宴
中使相继召之，不得已，与妃决而登车	中使相继而来宣召，元勰万不得已，只好与李氏诀别，然后登车而去，进入东掖门，过小桥，拉车的牛不肯向前，打了它很久还是不向前迈进，又有使者责备元勰来的迟了，于是只好去掉牛，由人把车拉进去
入东掖门，度小桥，牛不肯进，击之良久，更有使者责勰来迟，乃去牛，人挽而进	宴会在宫中举行，到了夜间，全都喝醉了，宣武帝令他们各就方便之处休息
宴于禁中，至夜，皆醉，各就别所消息	不一会儿，元珍带着武士送毒酒来了，元勰说：我没有罪，希望能一见圣上，死而元恨
俄而元珍引武士赍毒酒而至，勰曰：吾无罪，愿一见至尊，死无恨	元珍说：圣上怎么可以复见呢
元珍曰：至尊何可复见	元勰说：皇上对明，不应该没有事就把我杀掉，乞求与诬告我的人当面对质
勰曰：至尊圣明，不应无事杀我，乞与告者一对曲直	武士用刀环向元勰的脸上打去，元勰大声呼喊道：冤枉啊
武士以刀钚筑之，勰大言曰：冤哉，皇天	老天爷
忠而见杀	我如此忠心反而被杀
武士又筑之，勰乃饮毒酒，武士就杀之，向晨，以褥裹尸载归其第，云王因醉而薨	武士又打，元勰只好饮喝毒酒，武士上前杀了元勰，天亮之后，用褥子裹了尸体装在车上送回他的府第，声称大王因酒醉而死去
李妃号哭大言曰：高肇枉理杀人，天道有灵，汝安得良死	李妃放声大哭，高声喊道：高肇冤枉杀人，伤天害理，老天爷有灵，你怎么能得到好死呢
魏主举哀于东堂，赠官、葬礼皆优厚加等	宣武帝在东堂为元勰举哀，赠官和葬礼莫不优厚加倍
在朝贵贱，莫不丧气，行路士女皆流涕曰：高令公枉杀贤王	朝廷之内的大小官员，无不丧气叹息，行路男女都流着眼泪说：高令公冤枉地杀害了贤德的彭城王
由是中外恶之益甚	从此朝廷内外对高肇更加憎恨得厉害了
庚子，魏郢州司马彭珍等叛魏，潜引梁兵趋义阳，三关戍主侯登等以城来降	庚子，北魏郢州司马彭珍等人叛国，偷偷地带领梁朝兵赶往义阳，三关戌的主将侯登等人献城投降了梁朝
郢州刺史娄悦婴城自守，魏以中山王英都督南征诸军事，将步骑三万出汝南以救之	郢州刺史娄悦环城自守，北魏任命中山王元英为都督南征诸军事，统率步、骑兵三万出汝南前去援救
丙寅，以吴兴太守张稷为尚书左仆射	丙寅，梁朝任命吴兴太守张稷为尚书左仆射
魏以尚书邢峦行豫州事，将兵击白早生	北魏委任尚书邢峦兼管豫州事务，率兵攻打白早生
魏主问之曰：卿言，早生走也，守也	宣武帝问邢峦：你说，白早生是逃跑，还是顽守呢
何时可平	何时可以讨平他
对曰：早生非有深谋大智，正以司马悦暴虐，乘众怒而作乱，民迫于凶威，不得已而从之	邢峦回答：白早生没有深谋大智，只因司马悦暴虐残忍，因此利用众人之愤怒而反叛作乱，百姓迫于他的凶威，不得已而顺从了他
纵使梁兵入城，水路不通，粮运不继，亦成禽耳	即使梁朝军队入城了，但是水路不通，粮运跟不上，也会被我们抓住的
早生得梁之援，溺于利欲，必守而不走	白早生得到梁朝的援助，被利欲冲昏头脑，必定死守而不跑
若临以王师，士民必翻然归顺，不出今年，当传首京师	如果派朝廷军队前去讨伐，士民大众们必定翻然归顺，不出今年，一定能把白早生的首级送到京师来
魏主悦，命峦先发，使中山王英继之	宣武帝十分高兴，命令邢峦先出发，让中山王元英随后出发
这一年，柔然佗汗可汗又派遣纥奚勿六跋向北魏进献貂裘，宣武帝不受，仍如前次那样作了答复	宋、齐旧仪，祀天皆服兖冕，兼著作郎高阳许懋请造大裘，从之
刘宋、南齐时期的旧仪式，祀天时都穿戴兖冕，兼著作郎高阳人许懋奏请裁制大裘，得到采纳	上将有事太庙，诏以斋日不乐，自今舆驾始出，鼓吹从而不作，还宫，如常仪
夏季，四月戊申，梁朝任命临川王萧宏为司空，加封车骑将军王茂开府仪同三司	丁卯，魏楚王城主李国兴以城降
丁卯，北魏楚王城的主将李国兴献城投降梁朝	秋，七月，癸巳，巴陵王萧宝义卒
秋季，七月癸巳，梁朝巴陵王萧宝义去世	九月，辛巳，魏封故北海王详子颢为北海王
丁巳，北魏汾州山胡刘龙驹聚众造反，侵拢夏州，北魏宣武帝诏令谏议大夫薛和征调东秦、汾、华、夏四州的兵力讨伐刘龙驹	辛酉，上祀明堂
辛酉，武帝在明堂祭祀	三月，琅邪民王万寿杀东莞、琅邪二郡太守刘晰，据朐山，召魏军
三月，琅邪百姓王万寿杀了东莞、琅邪二郡太守刘晰，占据了朐山，召请北魏军队前来	壬戌，魏广阳懿烈王嘉卒
甲戌，北魏薛和打败了刘龙驹，把他的党羽全部铲平，并上表设置了东夏州	五月，丙辰，魏禁天文学
春季，正月壬辰，武帝诏令：自今开始，流放之家以及罪该以身抵押服劳役者，如果有老人或小孩，可以把他们除外	以临川王宏为太尉，骠骑将军王茂为司空、尚书令
夏季，四月，北魏朝廷命令尚书与各官署审理狱讼案件，又令饥民到燕、恒二州以及六镇去渡灾	乙酉，魏大赦，改元延昌
己酉，临川王萧宏因公事而降职为骠骑大将军	是岁，魏以桓叔兴为南荆州刺史，治安昌，隶东荆州
这一年，北魏任命桓叔光为南荆州刺史，治所在安昌，附属于东荆州	春，正月，辛卯，上祀南郊，大赦
十二年	
春季，正月辛卯，梁武帝在南郊祭天，大赦天下	二月，辛酉，以兼尚书右仆射袁昂为右仆射
二月辛酉，梁朝任命兼尚书右仆射袁昂为右仆射	己卯，魏高阳王雍进位太保
六月癸巳，梁朝新建成太庙	秋，八月，戊午，以临川王宏为司空
秋季，八月戊午，梁朝任命临川王萧宏为司空	魏恒、肆二州地震、山鸣，逾年不已，民覆压死伤甚众
秋季，七月乙亥，梁朝立皇子萧纶为邵陵王，萧绎为湘东王，萧纪为武陵王	冬，十月，庚辰，魏主遣骁骑将军马义舒慰谕柔然
北魏降将王足献策，请求拦堵淮水以淹灌寿阳	魏以前定州刺史杨津为华州刺史，津，椿之弟也
梁武帝同意这一计策，命令水工陈承伯、材官将军祖视察地形，陈、祖二人都说：淮水中沙土松软流动不坚实，工程无法完成	先是，官受调绢，尺度特长，任事因缘，共相进退，百姓苦之
武帝不听，征调徐、扬之地的民，每二十户中征五丁，拦水筑堰，命令太子右卫率康绚都督淮上诸军事，并且守护筑堰工程，设置官属于钟离	津令悉依公尺，其输物尤善者，赐以杯酒；所输少劣，亦为受之，但无酒以示耻
筑堰的劳和兵士共二十万人，南起浮山，北抵石，依岸筑土，合龙于淮水中流	于是人竞相劝；官调更胜旧日
春季，正月，乙巳朔，梁武帝在太极殿给太子举行冠礼，并且大赦天下	辛亥，上祀南郊
魏之伐蜀也，军至晋寿，蜀人震恐	北魏的军队攻打蜀地，大军开到晋寿，蜀人非常恐惧
傅竖眼将步兵三万击巴北，上遣宁州刺史任太洪自阴平间道入其州，招诱氐、蜀，绝魏运路	傅竖眼率领三万步兵攻打巴北，梁武帝派宁州刺史任太洪从阴平抄小路进入州城，招诱氐人、蜀人，并且断绝了北魏军队的运输线路
会魏大军北还，太洪袭破魏东洛、除口二戍，声言梁兵断至，氐、蜀翕然从之	正赶上北魏大部队向北返回，任太洪袭击了北魏的东洛、除口二个戍地，并且声称梁朝军队紧接着就会到来，氐人、蜀人都归顺了他
太洪进围关城，竖眼遣统军姜喜等击太洪，大破之，太洪弃关城走还	任太洪进军包围了关城，傅竖眼派统军姜喜等人攻打任太洪，击败了他的部队，任太洪放弃关城逃了回来
癸未，魏以高阳王雍为太傅、领太尉，清河王怿为司徒，广平王怀为司空	癸未，北魏任命高阳王元雍担任太傅、兼太尉，清河王元怿为司徒，广平王元怀为司空
甲午，魏葬宣武皇帝于景陵，庙号世宗	甲午，，北魏将宣武帝安葬在景陵，庙号为世宗
己亥，尊胡贵嫔为皇太妃	己亥，尊胡贵嫔为皇太妃
三月，甲辰朔，以高太后为尼，徙居金墉瑶光寺，非大节庆，不得入宫	三月甲辰朔，使高太后作了尼姑，把她迁居到金墉瑶光寺，不遇到大的节日庆典，不许入宫
魏左仆射郭祚表称：萧衍狂悖，谋断川渎，役苦民劳，危亡已兆；宜命将出师，长驱扑讨	北魏左仆射郭祚上书宣称：萧衍狂妄无道，谋划切断山川沟渠，以致国内劳役繁重，百姓疲弊，灭亡的危险已显露出来，我国应当派将出兵，长驱直入，讨伐敌人
魏诏平南将军杨大眼督诸军镇荆山	于是朝廷诏令平南将军杨大眼率领军队镇守荆山
丙子，魏尊胡太妃为皇太后，居崇训宫	丙子，北魏尊封胡太妃为皇太后，让她住进崇训宫
于忠领崇训卫尉，刘腾为崇训太仆，加侍中，侯刚为侍中抚军将军	于忠担任崇训宫的卫尉，刘腾担任崇训宫的太仆，加官侍中，侯刚为侍中抚军将军
又以太后父国珍为光禄大夫	又封胡太后的父亲胡国珍为光禄大夫
庚辰，定州刺史田超秀帅众三千降魏	庚辰，梁朝定州刺史田超秀率领三千兵马投降了北魏
戊子，魏大赦	戊子，北魏实行大赦
己丑，魏清河王怿进位太傅，领太尉，广平王怀为太保，领司徒，任城王澄为司空	己丑，北魏清河王元怿晋升太傅的职位，兼任太尉，广平王元怀作了太保，兼任司徒，任城王元澄任司空
庚寅，魏以车骑大将军于忠为尚书令，特进崔光为车骑大将军，并加开府仪同三司	庚寅，北魏孝明帝任命车骑大将军王忠为尚书令，特进崔光为车骑将军，并加封开府仪同三司
左游击将军赵祖悦袭魏西硖石，据之以逼寿阳；更筑外城，徙缘淮之民以实城内	梁朝左游击将军赵祖悦在西硖石一带袭击了北魏军队，并以西硖石为根据地逼近寿阳，又筑起外城，将淮河周围的百姓都迁进来充实内城
将军田道龙等散攻诸戍，魏扬州刺史李崇分遣诸将拒之	将军田道龙等人分别去攻打北魏的各个寨堡，北魏扬州刺史李崇分别派遣众将领去抵抗
癸亥，魏遣假镇南将军崔亮攻西硖石，又遣镇东将军萧宝寅决淮堰	癸亥，北魏派遣代理镇南将军崔亮攻打西硖石，又派镇东将军萧宝寅掘开淮河堰
冬，十月，乙酉，魏以胡国珍为中书监、仪同三司，侍中如故	冬季，十月乙酉，北魏任命胡国珍为中书监、认同三司，并保留侍中的职务
甲午，弘化太守杜桂举郡降魏	甲午，弘化太守杜桂率领全郡投降北魏
己酉，魏崔亮至硖石，赵祖悦逆战而败，闭城自守，亮进围之	己酉，北魏崔亮来到硖石，赵祖悦迎战崔亮失败，只好闭城坚守，崔亮进兵包围了他们
丁卯，魏主及太后谒景陵	丁卯，北魏孝明帝和太后参拜景陵
是冬，寒甚，淮、泗尽冻，浮山堰士卒死者什七八	这一年冬季，异常寒冷，淮河、泗水都结了冰，浮山堰的兵士死掉十分之七八
魏南荆州刺史恒叔兴表请不隶东荆州，许之	北魏南荆州刺史桓叔兴上书请求不再隶属东荆州，被批准
	十五年
春，正月，戊辰朔，魏大赦，改元熙平	春季，正月戊辰，北魏大赦天下，改年号为熙平
三月，戊戌朔，日有食之	三月戊戌朔，出现日食
魏论西硖石之功，辛未，以李崇为骠骑将军，加仪同三司，李平为尚书右仆射，崔亮进号镇北将军	北魏朝廷议论给西硖石之战中的将领行赏，辛未，任命李崇为骠骑将军，加封仪同三司，李平为尚书右仆射，崔亮增加镇北将军的封号
亮与平争功于禁中，太后以亮为殿中尚书	崔亮和李平在朝廷中争夺功劳，最后太后让崔亮作了殿中尚书
夏，四月，淮堰成，长九里，下广一百四十丈，上广四十五丈，高二十丈，树以杞柳，军垒列居其上	夏季，四月，淮河大坝修成，长九里，下宽一百四十丈，上宽四十五丈，高二十丈，种上了杞柳树，军营就驻扎在坝上
魏胡太后追思于忠之功，曰：岂宜以一谬弃其余勋	北魏胡太后追忆于忠的功劳，说：怎么能凭着一次错误就不承认他的其他功绩
复封忠为灵寿县公，亦封崔光为平恩县侯	便重新封于忠为灵寿县公，也封崔光为平恩县侯
魏元法僧遣其子景隆将兵拒张齐，齐与战于葭萌，大破之，屠十余城，遂围武兴	北魏元法僧派他的儿子元景隆带兵抗击张齐，张齐与景隆在葭萌作战，大败景隆，在十多个城市进行屠杀，最后包围了武兴
法僧婴城自守，境内皆叛，法僧遣使间道告急于魏	元法僧闭城固守，境内军民都背叛了他，元法僧派使节从小路去向北魏告急
魏驿召镇南军司傅竖眼于淮南，以为益州刺史、西征都督，将步骑三千以赴之	北魏用驿车从淮南召回镇南军司傅竖眼，让他作益州刺史、西征都督，率领步兵、骑兵三千人开赴武兴
竖眼入境，转战三日，行二百余里，九遇皆捷	傅竖眼进入武兴境内，转战三天，走了二百多里，作战九次都取得胜利
五月，竖眼击杀梁州刺史任太洪	五月，傅竖眼杀死了梁州刺史任太洪
民、獠闻竖眼至，皆喜，迎拜于路者相继	百姓、獠人听说傅竖眼来到，都很高兴，在路上欢迎接待的人络绎不绝
张齐退保白水，竖眼入州，白水以东民皆安业	张齐退回去保卫白水，傅竖眼进入梁州，白水城以东的百姓都安居乐业了
六月，庚子，以尚书令王莹为左光禄大夫、开府仪同三司，尚书右仆射袁昂为左仆射，吏部尚书王为右仆射	六月庚子，梁朝任命尚书令王莹为左光禄大夫、开府仪同三司，任命尚书右仆射袁昂为左仆射，吏部尚书王为右仆射
，俭之子也	王是王俭的儿子
八月，乙巳，魏以胡国珍为骠骑大将军、开府仪同三司、雍州刺史	八月乙巳，北魏任命胡国珍为骠骑大将军、开府仪同三司、雍州刺史
国珍年老，太后实不欲令出，止欲示以方面之荣；竟不行	胡国珍年老，太后实际上不想让他出行，只不过想给他统治一方的荣誉，所以最终也没有出行
壬辰，大赦	壬辰，梁朝颁布大赦令
魏胡太后数幸宗戚勋贵之家，侍中崔光表谏曰：《礼》，诸侯非问疾吊丧而入诸臣之家，谓之君臣为谑	北魏胡太后多次驾临皇室贵戚以及功臣显贵的家中，侍中崔光上书劝谏说：《礼记》上讲，诸侯如果不是为了慰问病人或追悼死人而进入大臣的家中，就叫作君臣之间失礼戏谑
不言王后夫人，明无适臣家之义	没有提到王后夫人，是为了表明她们根本没有去大臣家的道理
夫人，父母在有归宁，没则使卿宁	诸侯的夫人，父母在时可以回家问侯，父母不在就派大臣去问侯
汉上官皇后将废昌邑，霍光，外祖也，亲为宰辅，后犹御武帐以接群臣，示男女之别也	汉朝的上官皇后将要废掉昌邑王时，霍光是她的外祖父，担任宰相，皇后仍然悬挂武帐来接见众大臣，是为了表明男女要加以区分
今帝族方衍，勋贵增迁，祗请遂多，将成彝式	现在皇族正当繁衍兴盛之时，宗戚勋贵升官的很多，请您的人就多起来了，快要成为常规了
愿陛下简息游幸，则率土属赖，含生仰悦矣	希望您减少和停止出游探视，如此则天下归心，众生仰戴
冬，十一月，交州刺史李斩交州反者阮宗孝，传首建康	冬季，十一月，梁朝交州刺史李杀死了交州叛乱的阮宗孝，将他的首级送到了国都建康
魏征南大将军田益宗求为东豫州刺史，以招二子，太后不许，竟卒于洛阳	北魏征南大将军田益宗请求去作东豫州刺史，以便去招降他的两个叛乱的儿子，胡太后不答应，最后他死在了洛阳
春，正月，辛未，上祀南郊	春季，正月辛未，梁武帝在南郊祭天
魏大乘余贼复相聚，突入瀛州，刺史宇文福之子员外散骑侍郎延帅奴客拒之	北魏大乘流匪重新聚集起来，冲入瀛州，刺史宇文福的儿子员外散骑侍郎宇文延率领手下的奴仆和佃客抗拒敌兵
贼烧斋阁，延突火抱福出外，肌发皆焦，勒众苦战，贼遂散走，追讨，平之	流匪烧了斋门，宇文延冲入火中抱出宇文福，他的身体头发都被烧焦，仍然督促众人苦战，流匪终于逃散，他又率兵追杀，消灭了流匪
甲戌，魏大赦	甲戌，北魏大赦天下
魏人多窃冒军功，尚书左丞卢同阅吏部勋书，因加检核，得窃阶者三百余人，乃奏：乞集吏部、中兵二局勋簿，对句奏案，更造两通，一关吏部，一留兵局	北魏很多人假冒军功，尚书左丞卢同查阅吏部的功绩簿，并加以审核，发现了三百多个冒取官位的人，于是上奏说：请求集中吏部、中兵二局的功劳簿，核对审查上报的文书，抄写二份，一份放在吏部、一份存放兵局
又，在军斩首成一阶以上者，即令行台军司给券，当中竖裂，一支付勋人，一支送门下，以防伪巧	另外，在军队里杀敌可升一级以上的人，就命令行台军司颁发证书，证书从中间竖着分开，一份交给立功的人，一份送交门下省，以便防止耍花招作假
太后从之	胡太后听从了他的建议
同，玄之族孙也	卢同是卢玄的族孙
中尉元匡奏取景明元年已来，内外考簿、吏部除书、中兵勋案、并诸殿最，欲以案校窃阶盗官之人，太后许之	中尉元匡上书请求把景明元年以来内外考核的帐簿、吏部任职的文书、中兵的功劳查询记录，以及历次考核中的最高等和最低等的名单都取出来，以便核查冒功盗官的人，胡太后批准了他的请求
尚书令任城王澄表以为：法忌烦苛，治贵清约	尚书令任城王元澄上书认为：律法最怕烦杂苛刻，治政贵在清平简约
御史之体，风闻是司，若闻有冒勋妄阶，止应摄其一簿，研检虚实，绳以典刑	御史台的职责，在于有所风闻就可以上奏，如果知道有冒取功劳官职的人，只须取一本簿籍，调查检验出真假，绳之以法便可
岂有移一省之案，寻两纪之事，如此求过，谁堪其罪	怎能取尚书省的全部档案到御史台去审查，查找二十多年的旧帐，象这样追查过失，谁能受得了这种罪责
斯实圣朝所宜重慎也	这实在是贤圣的王朝应当慎重对待的事
太后乃止	胡太后这才停止追究
又以匡所言数不从，虑其辞解，欲奖安之，乃加镇东将军	胡太后又因为元匡的多次建议都没有被采纳，怕他提出辞职，想要奖励安慰他，就加封他为镇东将军
二月，丁未，立匡为东平王	二月丁未，又封元匡为东平王
三月，丙子，敕织官，文锦不得为仙人鸟兽之形，为其裁翦，有乖仁恕	三月丙子，梁朝下令给织官，命令锦纹不能织仙人鸟兽的形状，因为这样剪裁起来，违背了仁爱
丁亥，魏广平文穆王怀卒	丁亥，北魏广平文穆王元怀去世
夏，四月，戊申，魏以中书监胡国珍为司徒	夏季，四月戊申，北魏任命中书监胡国珍为司徒
秋，八月，丁未，诏魏太师高阳王雍入居门下，参决尚书奏事	秋季，八月丁未，北魏诏令太师高阳王元雍入居门下省，参决尚书奏事
乙卯，魏诏，北京士民未迁者，悉听留居为永业	乙卯，北魏朝廷下诏令，凡在北方代都的没有迁徒的士民，都听任他们留作长久居民
十一月，甲子，巴州刺史牟汉宠叛，降魏	十一月甲子，巴州刺史牟汉宠反叛，投降了北魏
是岁，以右卫将军冯道根为豫州刺史	这一年，梁朝任命右卫将军冯道根为豫州刺史
道根谨厚木讷，行军能检敕士卒；诸将争功，道根独默然	冯道根憨厚口拙，行军作战能督促士兵；众将争夺功劳时，只有冯道根一个人不说话
为政清简，吏民怀之	他为政清廉，官吏、百姓都感激他
上尝叹曰：道根所在，令朝廷不复忆有一州	梁武帝曾经赞叹说：冯道根在的地方，一切无不放心，能让朝廷想不起来还有这个州
魏尚书崔亮奏请于王屋等山采铜铸钱，从之	北魏尚书崔亮上书请求在王屋山等地采掘铜铸造钱币，建议被采纳
是后民多私铸，钱稍薄小，用之益轻	从此以后，百姓常常私自铸钱，钱币比较薄小，使用一段时间就更轻了
	十七年
春，正月，甲子，魏以氐酋杨定为阴平王	春季，正月甲子，北魏封氐族酋长杨定为阴平王
魏秦州羌反	北魏秦州的羌人造反
二月，癸巳，安成康王秀卒	二月癸巳，安成康王萧秀去世
秀虽与上布衣昆弟，及为君臣，小心畏敬过于疏贱，上益以此贤之	萧秀虽然和梁武帝在贫贱时是兄弟，等到成为君臣关系之后，对梁武帝的谨慎小心、恭恭敬敬超过了朝中那些关系疏远、出身低贱的臣子，梁武帝也更因此而认为他贤良
秀与弟始兴王尤相友爱，久为荆州，常中分其禄以给秀，秀称心受之，亦不辞多也	萧秀和弟弟始兴王萧相互友爱，萧一直作荆州刺史，常常把他的俸禄给萧秀一半，萧秀实心实意地接受，也不认为给的太多而不受
甲辰，大赦	甲辰，梁朝大赦天下
己酉，魏大赦，改元神龟	己酉，北魏大赦天下，改年号为神龟
魏东益州氐反	北魏东益州的氐人造反
三月，辛未，魏灵寿武敬公于忠卒	三月辛未，北魏灵寿武敬公于忠去世
魏南秦氐反，遣龙骧将军崔袭持节谕之	北魏南秦州的氐人造反，朝廷派龙骧将军崔袭持符节去晓谕他们
临川王宏妾弟吴法寿杀人而匿于宏府中，上敕宏出之，即日伏辜	临川王萧宏的小妾的弟弟吴法寿杀人之后藏在萧宏府内，梁武帝命令萧宏交出他，当天就把吴法寿依法治罪
南司奏免宏官，上注曰：爱宏者兄弟私亲，免宏者王者正法；所奏可	南司奏请免去萧宏官职，梁武帝在奏折上批示：怜爱萧宏是兄弟的私情，免除萧宏的官职是帝王的法律，批准南司的奏请
五月，戊寅，司徒、骠骑大将军、扬州刺史临川王宏免	五月戊寅，司徒、骠骑大将军、扬州刺史临川王萧宏被免职
魏宦者刘腾，手不解书，而多奸谋，善揣人意；胡太后以其保护之功，累迁至侍中、右光禄大夫，遂干预政事，纳赂为人求官，无不效者	北魏宦官刘腾，不会写字，却很有奸计，善于揣摸别人的心意
河间王琛，简之子也	胡太后因为他有保护自己的功劳，多次升迁他，直到当了侍中、右光禄大夫，于是他便开始干预政事，收取贿赂替人求官，行贿者没有达不到目的的
为定州刺史，以贪纵著名，及罢州还，太后诏曰：琛在定州，唯不将中山宫来，自余无所不致，何可更复叙用	河间王元琛是元简的儿子，作定州刺史，以贪婪放纵而闻名，他卸任回来之后，胡太后诏令说：元琛在定州时，只没把中山宫带回来，其他没有不弄到手的，怎么可以再任用他
遂废于家	于是就把他闲置在家中
琛乃求为腾养息，赂腾金宝钜万计	元琛就请求刘腾，叙利亚了他的养子，贿赂了刘腾上万的金子珠宝
腾为之言于太后，得兼都官尚书，也为秦州刺史	刘腾替他在太后那里说情，使他兼任了都官尚书，出京作了秦州刺史
会腾疾笃，太后欲及其生而贵之，九月，癸未朔，以腾为卫将军，加仪同三司	恰在这时，刘腾病得很厉害，胡太后想在他活着时让他富贵，便于九月癸未朔，让刘腾当了卫将军，并加封仪同三司
魏胡太后以天文有变，欲以崇宪高太后当之	北魏胡太后因为天象有变化，便想让崇宪高太后承担凶兆
戊申夜，高太后暴卒；冬，十月，丁卯，以尼礼葬于北邙，谥曰顺皇后	戊申，用安葬尼姑的礼节将她安葬在北邙，谥号为顺皇后
百官单衣邪巾送至墓所，事讫而除	百官们都没有穿着丧服而只是穿着单衣服，头上还都加有驱邪的符，送丧到墓地，丧事完毕之后，便改换了服装
乙亥，以临川王宏为司徒	乙亥，梁朝任命临川王萧宏为司徒
是岁，魏太师雍等奏：盐池天藏，资育群生，先朝为之禁限，亦非苟与细民争利	这一年，北魏太师元雍等人上书说：盐池是上天的宝藏，用来养育众生，前代都为此制定了一定的禁令，这并不是为了和百姓争利
但利起天池，取用无法，或豪贵封护，或近民吝守，贫弱远来，邈然绝望	但是由于人们都想通过盐池来获利，因此取用没有法度，或者被豪门贵戚封占，或者被临近的百姓独自把守，以致那些贫弱之人和远道而来的人都望池兴叹，不能获其利
因置主司，令其裁察，强弱相兼，务令得所	因此就设置了一个主管部门，令其裁决、督察采盐事务，使强弱都一样，务必使大众都得到利益
什一之税，自古有之，所务者远近齐平，公私两宜耳	征收十分之一的税收方法，自古以来就有，其目的是为了使远近平均，对公对私都有好处
及甄琛启求禁集，乃为绕池之民尉保光等擅自固护；语其障禁，倍于官司，取与自由，贵贱任口	等到甄琛启请解除了盐池禁令之后，盐池就被绕池而住的百姓尉保光等人擅自霸占起来，据说他们所立的限禁，加倍地超过了官府的限禁，取与由他们定，盐价贵贱由他们说
请依先朝禁之为便	请求按前朝的做法对此加以限禁才好
诏从之	北魏孝明帝诏令采纳了这一建议
春，正月，甲申，以尚书左仆射袁昂为尚令，右仆射王为左仆射，太子詹事徐勉为右仆射	春季，正月甲申，梁朝任命尚书左仆射袁昂为尚书令，右仆射王为左仆射，太子詹事徐勉为右仆射
丁亥，魏主下诏，称太后临朝践极，岁将半纪，宜称诏以令宇内	丁亥，北魏国主颁布诏令，宣布：太后临朝执政已经将近六年，应当用诏书的名义来向全国发令
辛卯，上祀南郊	辛卯，梁武帝在南郊祭天
夏，四月，丁巳，大赦	夏季，四月丁巳，梁朝大赦天下
五月，戊戌，魏以任城王澄为司徒，京兆王继为司空	五月戊戌，北魏任命任城王元澄为司徒，京兆王元继为司空
魏累世强盛，东夷、西域贡献不绝，又立互市以致南货，至是府库盈溢	北魏接连几代都很强盛，东夷、西域都不断地向其进贡，他们又设立了互换物品的市场来取得南方的货物，因此国库非常充实
胡太后尝幸绢藏，命王公嫔主从行者百余人各自负绢，称力取之，少者不减百余匹	胡太后曾经临幸藏绢的仓库，命令随行的一百多个王公、妃嫔、公主各自取绢，按自己的力气而取之，拿得最少的也不下一百多匹
尚收令・仪同三司李崇、章武王融，负绢过重，颠仆于地，崇伤腰，融损足，太后夺其绢，使空出，时人笑之	尚书令、仪同三司李崇和章武王元融因为扛的绢太重，跌倒在地，李崇扭伤了腰，元融扭伤了脚，胡太后夺下了他们的绢，让他们空手而出，当时的人们都把这事当成了笑话
融，太洛之子也	元融是元太洛的儿子
侍中崔光止取两匹，太后怪其少，对曰：臣两手唯堪两匹	侍中崔光只取了两匹，胡太后嫌他拿得少，他回答说：我的两只手只能拿得动两匹绢
众皆愧之	其他的人听了后都很惭愧
九月，庚寅朔，胡太后游嵩高；癸巳，还宫	九月庚寅朔，回到宫中
冬，十二月，癸丑，魏任城文宣王澄卒	冬季，十二月癸丑，北魏任城文宣王元澄去世
庚申，魏大赦	庚申，北魏大赦天下
是岁，高句丽王云卒，世子安立	这一年，高句丽王高云去世，他的长子高安继位
魏以郎选不精，大加沙汰，唯朱元旭、辛雄、羊深、源子恭及范阳祖莹等八人以才用见留，余皆罢遣	北魏因为感到选拔官员过滥而不精，就大加淘汰，只有朱元旭、辛雄、羊深、源子恭以及范阳人祖莹等八人因为有才能而留用，其他人都被罢职送回去
深，祉之子也	羊深是羊祉的儿子
	普通元年
春，正月，乙亥朔，改元大赦	春季，正月乙亥，梁朝改年号并大赦天下
丙子，日有食之	丙子，发生日食
己卯，以临川王宏为太尉、扬州刺史，金紫光禄大夫王份为尚书左仆射	己卯，梁朝任命临川王萧宏为太尉、扬州刺史，金紫光禄大夫王份为尚书左仆射
份，奂之弟也	王份是王奂的弟弟
左军将军豫宁威伯冯道根卒	左军将军豫宁威伯冯道根去世
是日上春，祠二庙，既出宫，有司以闻	这一天在正月，梁武帝去太庙和小庙祭祀，出宫以后，有关部门把冯道根去世的消息告诉了他
上问中书舍人朱异曰：吉凶同日，今可行乎	梁武帝问中书舍人朱异说：吉凶的事发生在同一天，现在我能去吊唁他吗
对曰：昔卫献公闻柳庄死，不释祭服而往	朱异回答：从前卫献公听到柳庄的死讯，不脱掉祭服就前去吊唁
道根虽未为社稷之臣，亦有劳王室，临之，礼也	冯道根虽然算不上是国家重臣，但也对王室有过贡献，去看望他，是合乎礼仪的
上即幸其宅，哭之甚恸	于是梁武帝就来到冯道根的住宅，非常忧伤地哭悼他
高句丽世子安遣使入贡	高句丽的太子高安派遣使节前来向梁朝进贡
二月，癸丑，以安为宁东将军、高句丽王，遣使者江法盛授安衣冠剑佩	二月癸丑，梁武帝任命高安为宁东将军、高句丽王，并且派使节江法盛授给他衣服、王冠和佩剑
魏光州兵就海中执之，送洛阳	北魏光州的军队在海中抓获了江法盛，把他送到了洛阳
己卯，江、淮、海并溢	己卯，长江、淮河及海水一同暴涨
辛卯，魏主加元服，大赦，改元正光	辛卯，北魏为孝明帝举行加冠礼，大赦天下，改年号为正光
甲子，侍中、车骑将军永昌严侯韦睿卒	甲子，梁朝侍中、车骑将军永昌严侯韦睿去世
时上方崇释氏，士民无不从风而靡，独睿自以位居大臣，不欲与俗俯仰，所行略如平日	当时梁武帝正尊崇佛教，百姓全都跟着信教，只有韦睿自以为身为大臣，不想顺从这种习俗，行事全和平时一样
九月，戊戌，魏以高阳王雍为丞相，总摄内外，与元义同决庶务	九月戊戌，北魏任命高阳王元雍为丞相，总管内外朝政，与元义一同处理日常事务
魏清河王怿死，汝南王悦了无恨元义之意，以桑落酒候之，尽其私佞	北魏清河王元怿死后，汝南王元悦没有一点仇恨元义之心，反而用桑落酒讨好元义，极尽谄媚讨好之能事
义大喜，冬，十月，乙卯，以悦为侍中、太尉	元义非常高兴，冬季，十月乙卯，任命元悦为侍中、太尉
悦就怿子求怿服玩，不时称旨，杖百下，几死	元悦向元怿的儿子元索取元怿的服饰和古玩，因为没有按时送去而所送的又不合元悦的心意，元悦就用大杖打了元一百下，几乎把元打死
辛酉，魏以京兆王继为司徒	辛酉，北魏任命京兆王元继为司徒
魏遗使者刘善明来聘，始复通好	北魏派刘善明出使梁朝，两国又开始亲善往来
	二年
春，正月，辛巳，上祀南郊	春季，正月辛巳，梁武帝在南郊祭天
置孤独园于建康，以收养穷民	梁朝在建康设立孤独园，用来收养穷困百姓
戊子，大赦	戊子，，梁朝大赦天下
魏南秦州氐反	北魏南秦州的氐人造反
辛丑，上祀明堂	辛丑，梁武帝在明堂祭祖
庚戌，魏使假抚军将军邴虬讨南秦叛氐	庚戌，北魏派代理抚军将军邴虬讨伐南秦州反叛的氐人
辛巳，魏南荆州刺史恒叔兴据所部来降	辛巳，北魏南荆州刺史恒叔兴率领部将投降了梁朝
癸卯，琬琰殿火，延烧后宫三千间	癸卯，梁朝琬琰殿失火，火势漫延，烧毁后宫三千间
十一月，癸丑，魏侍中、车骑大将军侯刚加仪同三司	十一月癸丑，北魏加封侍中、车骑大将军侯刚仪同三司
魏以东益、南秦氐皆反，庚辰，以秦州刺史河间王琛为行台以讨之	北魏因为东益、南秦二州的氐人都反叛了，庚寅，任命秦州刺史、河间王元琛成立行台去讨伐
琛恃刘腾之势，贪暴无所畏忌，大为氐所败	元琛倚仗刘腾的权势，贪婪残暴、肆无忌惮，被氐人打得大败
中尉弹奏，会赦，除名，寻复王爵	中尉弹奏了他，正赶上大赦，因此只被除名，但不久又恢复了王爵
魏以安西将军元洪超兼尚书行台，诣敦煌安置柔然婆罗门	北魏任命安西将军元洪超兼任尚书行台，到敦煌去安置柔然国的婆罗门
	三年
春，正月，庚子，以尚书令袁昂为中书监，吴郡太守王3113为尚书左仆射	春季，正月庚子，梁朝任命尚书令袁昂为中书监，吴郡太守王3113为尚书左仆射
辛亥，魏主耕藉田	辛亥，北魏孝明帝举行耕种籍田仪式
魏宋云与惠生自洛阳西行四千里，至赤岭，乃出魏境，又西行，再期，至乾罗国而还	北魏宋云和惠生从洛阳出发，西行四千里，到达赤岭，才出了北魏国境，继续西行两年以后，到达乾罗国后返回
二月，达洛阳，得佛经一百七十部	于二月回到洛阳，得到一百七十部佛经
高车王伊匐遣使入贡于魏	高车王伊匐派使节向北魏进贡
夏，四月，庚辰，魏以伊匐为镇西将军、西海郡公、高车王	夏季，四月庚辰，北魏任命伊匐为镇西将军、西海郡公、高车王
久之，伊匐与柔然战败，其弟越居杀伊匐自立	很久以后，伊匐和柔然国交战失败，他的弟弟越居杀了伊匐自立为王
五月，壬辰朔，日有食之，既	五月壬辰朔，发生日全食
癸巳，大赦	癸巳，梁朝大赦天下
冬，十一月，甲午，领军将军始兴忠武王卒	冬季，十一月甲午，梁朝领军将军始兴忠武王萧去世
乙巳，魏主祀圜丘	乙巳，北魏孝明帝在圜丘祭天
初，魏世祖以《玄始历》浸疏，命更造新历	当初，魏世祖认为《玄始历》渐渐不准确了，下令另制新的历法
至是，著作郎崔光表取荡寇将军张龙祥等九家所上历，候验得失，合为一历，以壬子为元，应魏之水德，命曰《正光历》	到现在，著作郎崔光选取荡寇将军张龙祥等九家所上呈的历法，经过验证得失，合并成一种历法，以壬子为起首，以便于与北魏以水德而王相应，命名为《正光历》，表秦朝廷
丙午，初行《正光历》，大赦	丙午，开始实行《正光历》，并大赦天下
十二月，乙酉，魏以车骑大将军、尚书右仆射元钦为仪同三司，太保京兆王继为太傅，司徒崔光为太保	十二月乙酉，北魏任命车骑大将军、尚书右仆射元钦为仪同三司，太保京兆王元继为太傅，司徒崔光为太保
柔然阿那求粟为种，魏与之万石	柔然国的阿那请求给他们谷子作种子，北魏给了一万石
春，正月，辛卯，上祀南郊，大赦	春季，正月辛卯，梁武帝在南郊祭天，大赦天下
丙午，祀明堂	丙午，又在明堂祭祀
二月，乙亥，耕藉田	二月乙亥，耕种藉田
三月，魏司空刘腾卒	三月，北魏司空刘腾去世
宦官为腾义息重服者四十余人，衰送葬者以百数，朝贵送葬者塞路满野	宦官中刘腾的干儿子穿戴重丧服的有四十多人，送葬的数以百计，前来送葬的朝中权贵披麻挂孝，弃塞了道路和田野
夏，四月，魏元孚持白虎幡劳阿那于柔玄、怀荒二镇之间	夏季，四月，北魏元孚秉承朝廷之令持白虎幡在柔玄、怀荒二镇之间慰问阿那
阿那众号三十万，阴有异志，遂拘留孚，载以d车	阿那手下共有三十万人马，他暗中怀有反叛之意，于是就扣留了元孚，把他关在卧车之中
每集其众，坐孚东厢，称为行台，甚加礼敬	阿那每次集合他的部下，都让元孚坐在车厢中，称他为行台，特别地表示尊敬
引兵而南，所过剽掠，至平城，乃听孚还	阿那率兵向南开进，所过之处横加掠劫，到了平城，才允许元孚回去
有司奏孚辱命，抵罪	有关部门上奏元孚有辱使命，令他将功抵罪
甲申，魏遣尚书令李崇、左仆射元纂帅骑十万击柔然	甲申，北魏派尚书令李崇、左仆射元纂统率十万骑兵攻打柔然
阿那闻之，驱良民二千、公私马牛羊数十万北遁，崇追之三千余里，不及而还	阿那听到消息，抓走二千百姓，驱赶了公家和私人的几十万头马牛羊，向北方逃窜而去，李崇追赶了三千多里，没有追上，只好撤回
魏景明之初，世宗命宦者白整为高祖及文昭高后凿二佛龛于龙门山，皆高百尺	北魏景明初年，宣武帝命令宦官白整给孝文帝和文昭高后在龙门山凿两个佛龛，佛龛全都高达百尺
永平中，刘腾复为世宗凿一龛，至是二十四年，凡用十八万二千余工而未成	永平年间，刘腾又替宣武帝凿了一个佛龛，到现在已经二十四年了，一共用了十八万二千多个工，却还没有完成
秋，七月，辛亥，魏诏：见在朝官，依令七十合解者，可给本官半禄，以终其身	秋季，七月辛亥，北魏孝明帝诏令；现在在朝中的官员，按年龄到了七十岁应当退仕解职的人，可以付给他原来官职一半的俸禄，一直到他终年
九月，魏诏侍中、太尉汝南王悦入居门下，与丞相高阳王雍参决尚书奏事	九月，北魏孝明帝诏令侍中、太尉汝南王元悦入居门下省，和丞相高阳王元雍一同参决尚书奏事
冬，十月，庚午，以中书监、中卫将军袁昂为尚书令，即本号开府仪同三司	冬季，十月庚午，梁朝任命中书监、中卫将军袁昂为尚书令，并以中卫将军的身份开府仪同三司
魏平恩文宣公崔光疾笃，魏主亲抚视之，拜其子励为齐州刺史，为之撤乐，罢游眺	北魏平恩文宣公崔光病重，孝明帝亲自去看望他，任命他的儿子崔励为齐州刺史，并为了他的病而取消音乐，停止游玩
丁酉，光卒，帝临，哭之恸，为减常膳	丁酉，崔光去世，孝明帝临丧，悲痛地哭悼他，并且为此而减少自己正常的饮食
十一月，癸未朔，日有食之	十一月，癸未朔，发生日食
甲辰，尚书左仆射王3117卒	甲辰，梁朝尚书左仆射王3117去世
魏以汝南王悦为太保	北魏任命汝南王元悦为太保
春，正月，辛丑，魏主祀南郊	春季，正月辛丑，北魏孝明帝在南郊祭天
三月，魏以临淮王都督北讨诸军事，讨破六韩拔陵	三月，北魏委任临淮王元都督北讨诸军事，去讨伐破六韩拔陵
壬申，加崇使持节、开府仪同三司、北讨大都督，命抚军将军崔暹、镇军将军广阳王深皆受崇节度	壬申，北魏委任李崇为使持节、开府仪同三司、北讨大都督，命令抚军将军崔暹、镇军将军广阳王元深一并接受李崇指挥调遣
深，嘉之子也	元深是元嘉的儿子
六月，以豫州刺史裴邃督征讨诸军事以伐魏	六月，梁朝委任豫州刺史裴邃负责征讨诸军事，去讨伐北魏
丁酉，魏大赦	丁酉，北魏大赦天下
秋，七月，甲寅，魏遣吏部尚书元义兼尚书仆射，为西道行台，帅诸将讨莫折念生	秋季，七月甲寅，北魏委任吏部尚书元义兼尚书仆射，为西道行台，统率众将去讨伐莫折念生
崔暹违李崇节度，与破六韩拔陵战于白道，大败，单骑走还	崔暹不服从李崇指挥，与破六韩拔陵在白道交战，一败涂地，单人匹马跑了回来
拔陵并力攻崇，崇力战，不能御，引还云中，与之相持	破六韩拔陵集中兵力攻打李崇，李崇全力迎战，但是抵挡不住，便带领部队回到云中，与破六韩拔陵相持
丁丑，莫折念生遣其都督杨伯年攻仇鸠、河池二戍，东益州刺史魏子建遣将军伊祥等击破之，斩首千余级	丁丑，莫折念生派遣他属下的都督杨伯年攻打仇鸠、河池两个寨堡，东益州刺史魏子建派将军伊祥等人击败了杨伯年，斩首一千多人
东益州本氐王杨绍先之国，将佐皆以城民劲勇，二秦反者皆其族类，请先收其器械，子建曰：城民数经行阵，抚之足以为用，急之则腹背为患	东益州本来是氐王杨绍先的封国，将佐们都因为州城中的民众勇悍不驯，南秦州和秦州的反叛者都是杨绍先的同族之人，于是请求要先没收城里人手中的兵器械仗，魏子建说：城中民众数次经历打仗之事，安抚好他们便可为我所用，逼的太急了则会成为我们的心腹之患
乃悉召城民，慰谕之，既而渐分其父兄子弟外戍诸郡，内外相顾，卒无叛者	于是把城中民众都召集起来，安抚晓谕他们，然后逐渐把他们父子兄弟分派到外地各郡去戍守，这样内外相顾，到底也没有出现反叛者
子建，兰根之族兄也	魏子建是魏兰根的族兄
魏凉州幢帅于菩提等执刺史宋颖，据州反	北魏凉州幢帅于菩提等人拘押了刺史宗颖，占据凉州而反
八月，庚寅，徐州刺史成景俊拔魏童城	八月庚寅，梁朝徐州刺史成景俊攻拔北魏的童城
魏员外散骑侍郎李苗上书曰：凡食少兵精，利于速战；粮多卒众，事宜持久	北魏员外散骑侍朗李苗上书说：粮少兵精，利于速战速决；粮多兵众，利于打持久之战
今陇贼猖狂，非有素蓄，虽据两城，本无德义，其势在于疾攻，日有降纳，迟则人情离沮，坐待崩溃	当今陇地贼寇猖狂，但是这些贼寇没有多少粮资储备，虽然占据了两座城，但本来没有德义，所以其势在于急攻，以使每日都有所降纳，迟缓了则会使人心离散，情绪颓丧，从而坐待崩溃
夫飚至风举，逆者求万一之功；高壁深垒，王师肯全制之策	飚至风举，逆反者求的是万一之功；高壁深垒，王师有全制之策
但天下久泰，人不晓兵，奔利不相待，逃难不相顾，将无法令，士非教习，不思长久之计，各有轻敌之心	但是天下长久安泰，人们已经不知晓行伍征战了，都变得追逐利益唯恐落后，逃灾避难互不相顾，将帅没有法令，士兵不演习操练，人人不思长远之计，个个都有轻敌之心
如令陇东不守，军败散，则两秦遂强，三辅危弱，国之右臂于斯废矣	如果使陇东失守，地元志的军队败溃，秦州和南秦州莫折念生及张长命等反贼的势力便可强大，那么长安附近顿时就会变得危而又弱，作为国家的右臂于是便废了
宜敕大将坚壁勿战，别命偏裨帅精兵数千出麦积崖以袭其后，则、陇之下，群妖自散	应该旨令主将坚壁而守，不要出战，另外命令副帅偏将率领兵数千名出麦积崖从背后袭击叛贼，如此则、陇之地，群妖自散
东西部敕勒皆叛魏，附于破六韩拔陵，魏主始思李崇及广阳王深之言	东部和西部的敕勒人都反叛了北魏，投附于破六韩拔陵，北魏孝明帝这才开始想到了李崇和广阳王元深曾经说过的话
丙申，下诏：诸州镇军贯非有罪配隶者，皆免为民	丙申，孝明帝诏令：各州镇在册的军人中凡不是因犯罪而被流放服役的，全都免为平民
改镇为州，以怀朔镇为朔州，更命朔州曰云州	改镇为州，以怀朔镇为朔州，又改名朔州为云州
遣兼黄门侍郎郦道元为大使，抚慰六镇	派遣兼黄门侍郎郦道元为大使，让他去安抚宣慰六镇
时六镇已尽叛，道元不果行	当时六镇已经全部反叛，郦道元没有成行
戊戌，莫折念生遣都督窦双攻魏盘头郡，东益州刺史魏子建遣将军窦念祖击破之	戊戌，莫折念生派遣都督窦双攻打北魏盘头郡，东益州刺史魏子建派遣将军窦念祖击败了窦双
九月，戊申，成景俊拔魏睢陵	九月戊申，成景俊攻取了北魏的睢陵
戊午，北兖州刺史赵景悦围荆山	戊午，北兖州刺史赵景悦围困荆山
裴邃帅骑三千袭寿阳，壬戌夜，斩关而入，克其外郭	裴邃率领三千骑兵袭击寿阳，于壬戌夜，攻破城门，攻克了寿阳外城
魏扬州刺史长孙稚御之，一日九战，后军蔡秀成失道不至，邃引兵还	北魏扬州刺史长孙稚抗击裴邃，一天交战了九次，后军蔡秀成迷路而没有赶来，裴邃只好领兵撤返
别将击魏淮阳，魏使行台郦道元、都督河间王琛救寿阳，安乐王鉴救淮阳	梁朝派遣别将攻打北魏淮阳，北魏派遣行台郦道元、都督河间王元琛去援救寿阳，派安乐王元鉴去援救淮阳
鉴，诠之子也	元鉴是元诠的儿子
魏西道行台元义得风疾，不能治军	北魏西道行台元义得了风疾，不能指挥军队了
壬申，魏以尚书左仆射齐王萧宝寅为西道行台大都督，帅诸将讨莫折念生	壬申，北魏任命尚书左仆射齐王萧宝寅为西道行台大都督，令他统率众将去讨攻莫折念生
魏营州城民刘安定、就德兴执刺史李仲遵，据城反	北魏营州城的百姓刘安定、就德兴抓住了刺史李仲遵，占据州城而反
城民王恶儿斩安定以降；德兴东走，自称燕王	城中的百姓王恶儿斩了刘安定而投降，就德兴向东逃跑，自称燕王
胡琛遣其将宿勤明达寇豳、夏、北华三州，魏遣都督北海王颢帅诸将讨之	胡琛派遣手下将领宿勤明达侵扰豳、夏、北华三州，北魏派遣都督北海王元颢统率众将去讨伐
颢，详之子也	元颢是元详的儿子
甲申，彭宝孙拔檀丘	甲申，梁朝彭宝孙攻取了檀丘
辛卯，裴邃拔狄城；丙申，又拔甓城，进屯黎浆	辛卯，又攻取了甓城，进驻黎将
壬寅，魏东海太守韦敬欣以司吾城降	壬寅，北魏东海太守韦敬欣献上司吾城投降
定远将军曹世宗拔曲阳；甲辰，又拔秦墟，魏守将多弃城走	定远将军曹世宗攻取了曲阳；甲辰，又攻下了秦墟，北魏的守将大多数弃城逃跑
魏广阳王深上言：今六镇尽叛，高车二部亦与之同，以此疲兵击之，必无胜理	北魏广阳王元深上书说：如今六镇全都反叛了，高车二部的情况也与六镇相同，以这样的疲劳之兵攻打他们，必定没有取胜的道理
不若选练精兵守恒州诸要，更为后图	所以，不如挑选演练精兵把守恒州的各个要冲之地，再作以后的打算
遂与李崇引兵还平城	于是便与李崇领兵回到了平城
崇谓诸将曰：云中者，白道之冲，贼之咽喉，若此地不全，则并、肆危矣	李崇对众将说：云中是白道的要冲，叛贼的咽喉要害，如果此地保不住，那么并州和肆州就危险了
当留一人镇之，谁可者	所以，应当留下一个人镇守，谁来承当呢
众举费穆，崇乃请穆为朔州刺史	众人推举费穆，李崇便奏请任命费穆为朔州刺史
贺拔度拔父子及武川宇文肱纠合乡里豪杰，共袭卫可孤，杀之；度拔寻与铁勒战死	贺拔度拔父子以及武川人宇文肱纠集乡里的豪杰，一同袭击卫可孤，杀了卫可孤；贺拔度拔不久又与敕勒交战而身亡
肱，逸豆归之玄孙也	宇文肱是宇文逸豆归的玄孙
莫折天生进攻魏岐州，十一月，戊申，陷之，执都督元志及刺史裴芬之，送莫折念生杀之	莫折天生进攻北魏岐州，十一月戊申，攻陷了该城，抓获都督元志以及刺史裴芬之，把他们送给莫折念生，莫折念生杀了他们
念生又使卜胡等寇泾州，败光禄大夫薛峦于平凉东	莫折念生又派卜胡等人入侵泾州，在平凉东边打败了光禄大夫薛峦
峦，安都之孙也	薛峦是薛安都的孙子
丙辰，彭宝孙拔魏东莞	丙辰，彭宝孙攻取了北魏的东莞
壬戌，裴邃攻寿阳之安城，丙寅，马头、安城皆降	壬戌，马头和安城两处都投降了
高平人攻杀卜胡，共迎胡琛	高平人攻打并杀死了卜胡，一起迎接胡琛前来
十二月，戊寅，魏荆山降	十二月戊寅，北魏的荆山城投降
壬辰，魏以京兆王继为太师、大将军，都督西道诸军以讨莫折念生	壬辰，北魏任命京兆王元继为太师、大将军，令他统率西路诸军讨伐莫折念生
魏汾州诸胡反；以章武王融为大都督，将兵讨之	北魏汾州的各部胡人反叛；朝廷委任章武王元融为大都督，率兵去讨伐
魏魏子建招谕南秦诸氐，稍稍降附，遂复六郡十二戍，斩韩祖香	北魏魏子建宣谕招降南秦州各氐族部落，氐人稍微有所归附，于是便恢复了六郡十二戍，斩了韩祖香
魏以子建兼尚书，为行台，刺史如故，梁、巴、二益、二秦诸州皆受节度	北魏任命魏子建兼尚书，担任行台，刺史职务不变，梁、巴、二益、二秦各州都接受他的指挥调遣
莫折念生遣兵攻凉州，城民赵天安复执刺史以应之	莫折念生派兵攻打凉州，凉州城的百姓赵天安再次抓住了州刺史响应莫折念生
是岁，侍中、太子詹事周舍坐事免，散骑常侍钱唐朱异代掌机密，军旅谋议，方镇改易，朝议诏敕皆典之	这一年，梁朝侍中、太子詹事周舍因事获罪而被免职，散骑常侍钱唐人朱异代替了周舍掌管朝廷机密大事，军事方面的出谋划策，以及各州文武长官的任免和朝廷礼仪、诏令等事情也都由他掌管
异好文义，多艺能，精力敏赡，上以是任之	朱异喜好文章、义理，多才多艺，思想敏捷而周密，梁武帝因此而信任他
	六年
春，正月，丙午，雍州刺史晋安王纲遣安北长史柳浑破魏南乡郡；司马董当门破魏晋城，庚戌，又破马圈、阳二城	春季，正月丙午，又攻陷了马圈、阳二城
辛亥，上祀南郊，大赦	辛亥，梁武帝在南郊祭天，大赦天下
魏徐州刺史元法僧，素附元义，见义骄恣，恐祸及己，遂谋反	北魏徐州刺史元法僧，向来依附于元义，他见元义骄横纵恣，害怕祸及己身，于是便谋反
魏遣中书舍人张文伯至彭城，法僧谓曰：吾欲与汝去危就安，能从我乎	北魏派遣中书舍人张文伯到达彭城，元法僧对张文伯说：我想与你去危就安，你能从我吗
文伯曰：我宁死见文陵松柏，安能去忠义而从叛逆乎	张文伯回答说：我宁可死了去见孝文帝，怎么能离弃忠义而跟你一块叛逆呢
法僧杀之	元法僧便杀了他
庚申，法僧杀行台高谅，称帝，改元天启，立诸子为王	庚申，元法僧杀了行台高谅，自己称帝，改年号为天启，立几个儿子为王
魏发兵击之，法僧乃遣其子景仲来降	北魏发兵讨伐，元法僧便派他的儿子元景仲来梁朝投降
魏以京兆王继为太尉	北魏任命京兆王元继为太尉
初，魏刘腾既卒，胡太后及魏主左右防卫微缓	早先之时，北魏的刘腾死了之后，胡太后以及北魏孝明帝身边的监视稍微有所松缓
元义亦自宽，时出游于外，留连不返，其所亲谏，义不纳；太后察知之	元义也觉得宽心了不少，便时常出外游玩，留连而不返，他的亲信多次劝谏，但他根本不听；胡太后察知了这一情况
去秋，太后对帝谓群臣曰：今隔绝我母子，不听往来，复何用我为	去年秋天，胡太后当着孝明帝问众臣子们说：现在把我们母子隔绝开来，不允许我们互相往来，那么我还有什么用处呢
我当出家，修道于嵩山闲居寺耳	我应当去出家，去嵩山闲居寺修行当尼姑
因自欲下发；帝及群臣叩头泣涕，殷勤苦请，太后声色愈厉	因此自己便要剃发，孝明帝以及群臣们磕头流泪，哀哀苦求，胡太后言语表情却更加严厉了，执意要出家做尼姑，不肯改变主意
帝乃宿于嘉福殿，积数日，遂与太后密谋黜义	于是孝明帝便住在了嘉福殿，一连住了好几天，同胡太后一起密谋要贬黜元义
然帝深匿形迹，太后有忿恚，欲得往来显阳之言，皆以告义；又对义流涕，叙太后欲出家，忧怖之心日有数四	然而，孝明帝故深匿形迹，没有行动，胡太后也做出特别忿恨的样子，孝明帝便把胡太后想常来显阳殿见自己的话全告诉了元义；孝明帝还流着泪水对元议讲叙了胡太后想出家当尼姑一事，并特意表现出担忧害怕的样子，一天之内便讲了四次
义殊不以为疑，乃劝帝从太后所欲	元义对此毫无所疑，便劝孝明帝顺从胡太后的要求
于是太后数御显阳殿，二宫无复禁碍	于是胡太后数次住宿于显阳殿，两宫之间不再有什么禁限了
义举元法僧为徐州，法僧反，太后数以为言，义深愧悔	元义推荐元法僧出任徐州刺史，元法僧反叛，胡太后数次提到此事，元义因此而深自愧悔
戊戌，魏大赦	戊戌，北魏大赦天下
壬辰，莫折念生遣都督杨等攻仇池郡，行台魏子建击破之	壬辰，莫折念生派遣都督杨等人去攻打仇池郡，行台魏子建击败了他
三月，己酉，上幸白下城，履行六军顿所	三月己酉，梁武帝临幸白下城，步行视察了六军的驻守之地
乙丑，命豫章王综权顿彭城，总督众军，并摄徐州府事	乙丑，梁武帝命令豫章王萧综临时驻扎彭城，总督各路军队，并且兼管徐州府事
己巳，以元法僧之子景隆为衡州刺史，景仲为广州刺史	己巳，梁朝任命元法僧的儿子元景隆为衡州刺史，元景仲为广州策史
上召法僧及元略还建康，法僧驱彭城吏民万余人南渡	梁武帝召元法僧及元略回建康，元法僧驱赶彭城的官员和百姓一万多人南渡
法僧至建康，上宠待甚厚；元略恶其为人，与之言，未尝笑	元法僧到了建康，梁武帝特别宠待他；元略厌恶元法僧的为人，与他说话时，从来没有笑过
魏诏京兆王继班师	北魏诏令京兆王元继班师回朝
北凉州刺史锡休儒等自魏兴侵魏梁州，攻直城	北凉州刺史锡休儒等人从魏兴出发入侵北魏梁州，攻打直城
魏梁州刺史傅竖眼遣其子敬绍击之，休儒等败还	北魏梁州刺史傅竖眼派自己的儿子傅敬绍攻击他们，锡休儒等人败回
柔然王阿那为魏讨破六韩拔陵，魏遣牒云具仁赍杂物劳赐之	柔然国王阿那替北魏征讨破六韩拔陵，北魏派遣牒云具仁送去各种物品慰劳赏赐他们
阿那勒众十万，自武川西向沃野，屡破拔陵兵	阿那率众十万，从武川出发，西进沃野，多次打败破六韩拔陵的军队
夏，四月，魏主复遣中书舍人冯俊劳赐阿那	夏季，四月，北魏孝明帝又派遣中书舍人冯俊去慰劳赏赐阿那
阿那部落浸强，自称敕连头兵豆伐可汗	阿那的部落渐渐强大了起来，便自称为敕连头兵豆伐可汗
胡琛据高平，遣其大将万俟奴、宿勤明达等寇魏泾州，将军卢祖迁、伊瓮生讨之，不克	胡琛占据高平，派遣他的大将万俟奴、宿勤明达等人入侵北魏的泾州，将军卢祖迁、伊瓮生率兵讨伐万俟奴和宿勤明达，未能取胜
萧宝寅、崔延伯既破莫折天生，引兵会祖迁等于安定，甲卒十二万，铁马八千，军威甚盛	萧宝寅、崔延伯击败莫折天生之后，便领兵在安定同卢祖迁会合，会合之后共有兵卒十二万，甲马八千匹，军威甚壮
奴军于安定西北七里，时以轻骑挑战，大兵未交，辄委走	万俟奴驻扎在安定西北七里之处，不时地派轻骑挑战，大部队还没有交锋，便退逃
延伯恃其勇，且新有功，遂唱议先驱击之	崔延伯依恃自己勇武，而且新近有功，于是便提议要担任先锋去进攻万俟丑奴
别造大盾，内为锁柱，使壮士负以趋，谓之排城，置辎重于中，战士在外，自安定北缘原北上	崔延伯又另外造了大盾，里面置有锁柱，让壮士们抬着前进，叫做排城，辎重放在里面，战十们在外面，从安定北边沿塬北上
将战，有贼数百骑诈持文书，云是降簿，且乞缓师	将要开战之时，有数百名敌人的骑兵持着诈称为投降名册的信件来到近前，并且乞求崔延伯暂缓进攻
宝寅、延伯未及阅视，宿勤明达引兵自东北至，降贼自西竞下，覆背击之，延伯上马奋击，逐北径抵其营	萧宝寅、崔延伯还没有来得及阅看，宿勤明达便带兵从东北方向到了，而那些诈降的骑兵却从西边争相冲下来，由背后发起了进攻，崔延伯跃身上马奋力拼杀，一直追击到敌人的营盘之下
贼皆轻骑，延伯军杂步卒，战久疲乏，贼乘间得入排城；延伯遂大败，死伤近二万人，宝寅收众，退保安定	敌人全是骑兵，而崔延伯的军队中却杂有不少步兵，作战时间长了人员疲乏，敌人便乘机进入了排城；于是崔延伯一败涂地，死伤了近两万人，萧宝寅收拢残部，退守安定
延伯自耻其败，乃缮甲兵，募骁勇，复自安定西进，去贼七里结营	崔延伯因失败而感到耻辱，便修缮兵器，招募骁勇之士，再从安定向西进发，在离敌营七里远近的地方安营扎寨
壬辰，不告宝寅，独出袭贼，大破之，俄顷，平其数栅	壬辰，崔延伯没有报告萧宝寅，便独自出发袭击敌营，大败敌人，转眼之间，敌人的数座栅垒便被夷平
贼见军士采掠散乱，复还击之，魏兵大败，延伯中流矢卒，士卒死者万余人	敌人见崔延伯的将士们抢掠财物乱作一团，便又回过头来还击，北魏军队大败，崔延伯中了流箭而身亡，兵卒死者达一万多人
时大寇未平，复失骁将，朝野为之忧恐	其时，强寇未平反而却失去了一员骁将，北魏朝野因此而忧恐不安
于是贼势愈盛，而群臣自外来者，太后问之，皆言贼弱，以求悦媚，由是将帅求益兵者往往不与	于是敌人的凶焰更加炽盛了，然而回到朝廷中的臣子们，每当胡太后问到讨征情况时，他们都说贼兵力量微弱，不足为虑，以此而讨好、取悦于胡太后，因此将帅们向朝廷请求增兵，往往不给
魏魏昌武康伯李崇卒	北魏魏昌武康伯李崇去世
癸未，魏大赦，改元孝昌	癸未，北魏大赦天下，改年号为孝昌
冬，十月，吐谷浑遣兵击赵天安，天安降，凉州复为魏	冬季，十月，吐谷浑派兵攻打赵天安，赵天安投降，凉州复为北魏所有
春季，正月辛丑朔，梁朝大赦天下	壬子，魏以汝南王悦领太尉
夏季，四月乙酉，梁朝临川靖惠王萧宏去世	魏大赦
戊申，北魏燕州刺史崔秉率领众人弃城投奔定州	乙丑，魏以安西将军宗正珍孙为都督，讨汾州反胡
杜洛周派遣都督曹纥真等人率兵掠夺蓟南，秋季，七月丙午，行台常景派遣都督于荣等人在栗园攻击曹纥真等人，大败敌人，斩了曹纥真以及将卒三千多名	魏仆射元纂以行台镇恒州
杜洛周率众南去范阳，常景同于荣等人又击败了杜洛周	鲜于阿胡拥朔州流民寇恒州，戊申，陷平城，纂奔冀州
梁武帝得知淮河堰堤水很大，寿阳城差不多淹没了，便再次派遣郢州刺史元树等人从北道攻打黎浆，派豫州刺史夏侯等人从南道攻打寿阳	八月，癸巳，贼帅元洪业斩鲜于礼，请降于魏；贼党葛荣复杀洪业自立
八月癸巳，强盗首领元洪业斩了鲜于礼，请求投降北魏	魏安北将军、都督恒・朔讨虏诸军事尔朱荣过肆州，肆州刺史尉庆宾忌之，据城不出
强盗同伙葛荣又杀了元洪业而自任头领	荣怒，举兵袭肆州，执庆宾，还秀容，暑其从叔羽生为刺史，魏朝不能制
甲申，北魏行台常景击败了杜洛周，斩杀杜洛周手下的武川王贺拔文兴等人，捕获了四百人	就德兴陷魏平州，杀刺史王买奴
杜洛周围攻范阳，戊戌，范阳百姓抓住了北魏幽州刺史王延年、行台常景，把他们送给杜洛周，杜洛周开门接纳了他们	魏齐州平原民刘树等反，攻陷郡县，频败州军，刺史元欣以平原房士达为将，讨平之
春季，正月，乙丑，梁朝任命尚书左仆射徐勉为仆射	辛未，上祀南郊
辛未，梁武帝在南郊祭天	甲戌，魏以司空皇甫度为司徒，仪同三司萧宝寅为司空
戊子，北魏任命皇甫度为太尉	己丑，魏主以四方未平，诏内外戒严，将亲出讨，竟亦不行
梁朝谯州刺史湛僧智围攻北魏东豫州，将军彭群、王辩围攻琅邪，北魏朝廷命令青、南青两州援救琅邪	魏东清河郡山贼群起，诏以齐州长史房景伯为东清河太守
司州刺史夏侯夔率领壮武将军裴之礼等人出义阳道，攻打北魏的平静、穆陵、阴山三关，都攻下来了	郡民刘简虎尝无礼于景伯，举家亡去，景伯穷捕，禽之，置其子为西曹掾，令谕山贼
夏侯夔是夏候的弟弟；裴之礼是裴邃的儿子	贼以景伯不念旧恶，皆相帅出降
二月，秦地的贼寇占据了北魏潼关	庚申，魏东郡民赵显德反，杀太守裴烟，自号都督
北魏齐州广川的平民刘钧聚众造反，自任大行台；清河的百姓房项自任大都督，占据了昌固城	夏，四月，魏将元斌之讨东郡，斩赵显德
元显伯在夜间逃遁，梁军追击他，斩俘人数以万计数	领军曹仲宗、东宫直陈庆之攻魏涡阳，诏寻阳太守韦放将兵会之
梁武帝诏令任命湛僧智兼任东豫州刺史，镇守广陵	魏散骑常侍费穆引兵奄至，放营垒未立，麾下止有二百余人，放免胄下马，据胡床处分，士皆殊死战，莫不一当百，魏兵遂退
夏侯夔领兵屯驻安阳，派别将攻破了楚城并屠杀了全城军民，从此义阳北道便从北魏分割出来了	放，睿之子也
领军曹仲宗、东宫直陈广之攻打北魏涡阳，梁武帝诏令寻阳太守韦放率兵去与曹仲宗等会合	萧宝寅之败于泾州也，或劝之归罪洛阳，或曰：不若留关中立功自效
北魏散骑常侍费穆带兵突然来到，韦放的营垒还没有建好，麾下只有二百余人，韦放脱掉盔甲而下马，坐在胡床上安排布置，兵士们都殊死奋战，人人以一当百，北魏来兵便撤退了	行台都令史河间冯景曰：拥兵不还，此罪将大
韦放是韦睿的儿子	宝寅不从，自念出师累年，糜费不赀，一旦覆败，内不自安；魏朝亦疑之
秦州百姓骆超杀了杜粲，请求投降北魏	春，正月，癸亥，魏以北海王颢为骠骑大将军、开府仪同三司、相州刺史
三月癸未，葛荣攻陷北魏的沧州，抓获了刺史薛庆之，平民被杀的占十之八九	乙酉，魏葬孝明皇帝于定陵，庙号肃宗
庚戌，北魏孝庄帝赐封尔朱荣的儿子尔朱义罗为梁郡王	柔然头兵可汗数入贡于魏，魏诏头兵赞拜不名，上书不称臣
秋季，七月乙丑，北魏加封尔朱荣为柱国大将军、录尚书事	壬子，魏光州民刘举聚众反于濮阳，自称皇武大将军
北魏派遣征虏将军韩子熙招降邢杲，邢杲诈降，随后便又反叛了	魏费穆奄至荆州
李叔仁在惟水攻击邢杲，结果未能成功，只好退回	曹义宗军败，为魏所擒，荆州之围始解
戊寅，北魏任命上党王元天穆为大将军、开府仪同三司，世袭并州刺史	十二月，庚子，魏诏于晖还师讨邢杲
春季，正月甲寅，北魏于晖的部下、都督彭乐率二千余骑兵反叛，投奔了韩楼，于晖只好回师	辛酉，上祀南郊，大赦
辛酉，梁武帝在南郊祭天，大赦天下	甲子，魏汝南王悦求还国，许之
甲子，原北魏汝南王元悦请求梁武帝允许他回到北魏，梁武帝答应了他的请求	辛巳，上祀明堂
辛丑，北魏上党王元天穆和尔朱兆在济南打败了邢杲，邢杲投降，被押送至洛阳，斩了首	五月，丁巳，魏以东南道大都督杨昱镇荥阳，尚书仆射尔朱世隆镇虎牢，侍中尔朱世承镇
尔朱兆是尔朱荣的侄子	乙丑，内外戒严
辛亥，北魏淮阴太守晋鸿献出湖阳城投降梁朝	闰月，己未，南康简王绩卒
北魏任命原先的司空萧赞为司徒	十一月，己卯，就德兴请降于魏，营州平
十一月，己卯，就德兴向北魏请降，营州平定	丙午，魏以城阳王徽为太保，丹杨王萧赞为太尉，雍州刺史长孙稚为司徒
丙午，北魏任命城阳王元徽为太保，丹扬王萧赞为太尉，雍州刺史长孙稚为司徒	十二月，辛亥，兖州刺史张景邕、荆州刺史李灵起、雄信将军萧进明叛，降魏
北魏委任岐州刺史王罴代理南秦州的军政事务，王罴诱捕南秦州境内的群盗，全部杀掉了他们	春，正月，己丑，魏益州刺史长孙寿、梁州刺史元俊等遣将击严始欣，斩之，萧玩等亦败死，失亡万余人
春季，正月，己丑，北魏益州刺史长孙寿、梁州刺史元俊等派将领攻打严始欣，将其斩首，萧玩等也战败而死，逃失走散一万余人	辛亥，魏东徐州城民吕文欣等杀刺史元大宾，据城反，魏遣都官尚书平城樊子鹄讨之；二月，甲寅，斩文欣
六月，丁巳，梁武帝又加封原北魏汝南王元悦为魏王	戊寅，魏诏胡氏亲属受爵于朝者皆黜为民
戊寅，北魏孝庄帝下诏，凡胡氏家族的亲属在朝廷受过爵位的一律罢黜为平民	庚申，以魏降将范遵为安北将军、司州牧，从魏王悦北还
北魏荆州刺史李琰之，是李韶的族弟	魏王悦改元更兴，闻尔朱兆已入洛，自知不及事，遂南还
南阳太守赵延，因李琰之是孝庄帝的外戚，于是便诬称李琰之想投奔梁朝，发兵袭击荆州，抓获了李琰之，赵延自己掌管州政事务	斛斯椿复弃悦奔魏
癸丑，北魏任命高欢为大都督、东道大行台、冀州刺史，又任命安定王尔朱智虎为肆州刺史	魏尔朱天光出夏州，遣将讨宿勤明达，癸亥，擒明达，送洛阳，斩之
北魏尔朱天光出兵夏州，调兵遣将征讨宿勤明达，癸亥，擒获了宿勤明达，将他送到洛阳后处斩	丙寅，魏以侍中、骠骑大将军尔朱彦伯为司徒
丙寅，北魏任命侍中、骠骑大将军尔朱彦伯为司徒	魏诏有司不得复称伪梁
北魏下诏命令有关部门不得再称梁为伪梁	五月，丙子，魏荆州城民斩赵延，复推李琰之行州事
五月，丙子，北魏荆州城百姓斩杀了赵延，又推举李琰之代行州政	魏尔朱仲远使都督魏僧勖等讨崔祖螭于东阳，斩之
癸巳，北魏国主元恭追尊其父广陵惠王元羽为先帝，追尊其母王氏为先太妃，加封弟弟元永业为高密王，儿子元恕为勃海王	冬，十月，己酉，上幸同泰寺，升法坐，讲《涅经》，七日而罢
十一月，乙未，梁武帝临幸同泰寺，向僧众宣讲《般若经》，持续了七天才结束	庚辰，魏高欢引兵攻邺，相州刺史刘诞婴城固守
梁武帝任命太子右卫率薛法护为司州牧，派他护送魏王元悦到洛阳	庚午，立太子纲之长子大器为宣城王
乙巳，梁朝任命司空袁昂兼任尚书令	冬，十一月，丁酉，日南至，魏主祀圜丘
冬季，十一月，丁酉，这天是冬至，北魏孝武帝在圜丘祭天	甲辰，魏杀安定王朗、东海王晔
甲辰，北魏杀安定王元朗和东海王元晔	己酉，以汝南王悦为侍中、大司马
己酉，北魏朝廷任命汝南王元悦为侍中、大司马	魏葬灵太后胡氏
北魏为灵太后胡氏举行葬礼	上闻魏室已定，十二月，庚辰，复以太尉元法僧为郢州刺史
梁武帝听说北魏朝廷已经安定，十二月，庚辰，再次任命太尉元法僧为郢州刺史	魏主以汝南王悦属近地尊，丁亥，杀之
北魏孝武帝因汝南王元悦与自己亲属关系近而且地位又高，丁亥，杀了元悦	魏大赦，改元永兴，以与太宗同号，复改永熙
北魏罢免了各位行台	辛亥，上祀明堂
辛亥，梁武帝在明堂举行祭祀典礼	丁巳，魏主追尊其父为武穆帝，太妃冯氏为武穆后，母李氏为皇太妃
丁巳，北魏国主孝武帝分别追认他的父亲为武穆帝，太妃冯氏为武穆后，母亲李氏为皇太妃	劳州刺史曹凤、东荆州刺史雷能胜等举城降魏
北魏的太师鲁郡王元肃去世	丙辰，南平元襄王伟卒
丙辰，梁朝的南平元襄王萧伟去世	丁巳，魏以赵郡王谌为太尉，南阳王宝炬为太保
九月，癸酉，北魏的丞相高欢上书请求让掉自己的王爵，孝武帝没有允许；高欢又请求将自己封地里的十万户人家作为奖赏，分赏给从信都跟他起义讨伐尔朱氏有功勋的人，孝武帝答应了	冬，十月，庚申，以尚书右仆射何敬容为左仆射，吏部尚书谢举为右仆射
冬季，十月，庚申，梁武帝任命尚书右仆射何敬容为左仆射，吏部尚书谢举为右仆射	十一月，癸巳，魏以殷州刺史中山邸珍为徐州大都督、东道行台、仆射，以讨下邳
十一月，癸巳，北魏任命殷州刺史中山人邸珍为徐州大都督、东道行台、仆射，派他来讨伐下邳	十二月，丁巳，魏主狩于嵩高，己巳，幸温汤，丁丑，还宫
春季，正月壬辰，北魏的丞相高欢在五原河西部地区袭击了纥豆陵伊利，抓住了他，并且将他的部落迁移到五原河以东地区	魏东梁州民夷作乱，二月，诏以行东雍州事丰阳泉企讨平之
北魏孝武帝责难高欢说道：纥豆陵伊利既没有入侵，也没有叛变，是我们魏国忠贞的臣子，您突然讨伐他，难道有一个使者事先来请示过吗	企世为商、洛豪族，魏世祖以其曾祖景言为本县令，封丹水侯，使其子孙袭之
壬戌，北魏大赦天下	癸亥，上耕藉田；大赦
癸亥，梁武帝在籍田耕作，同时大赦天下	魏永宁浮图灾，观者皆哭，声振城阙
十二月，西魏丞相宇文泰派遣仪同李虎、李弼、赵贵在灵州袭击了曹泥	闰月，元庆和克濑乡而据之
春季，正月，戊申朔，梁武帝下令大赦天下，改年号为大同	是日，魏文帝即位于城西，大赦，改元大统，追尊父京兆王为文景皇帝，妣杨氏为皇后
己酉，西魏提升丞相略阳公宇文泰为都督中外诸军、录尚书事、大行台，还封他为安定王	乙卯，魏主立妃乙弗氏为皇后，子钦为皇太子
宇文泰坚决推辞掉王爵与录尚书的职务，西魏文帝就封他为安定公，还任命斛斯椿为太保、广平王元赞为司徒	后仁恕节俭，不妒忌，帝甚重之
乙卯，西魏文帝把他的妃子乙弗氏立为皇后，儿子元钦立为皇太子	稽胡刘蠡升，自孝昌以来，自称天子，改元神嘉，居云阳谷；魏之边境常被其患，谓之胡荒
皇后仁爱宽厚，勤俭节约，从不妒忌，文帝非常敬重她	壬戌，东魏丞相欢袭击，大破之
甲子，西魏任命广陵王元欣为太傅，仪同三司万俟寿洛干为司空	己巳，东魏以丞相欢为相国，假黄铖，殊礼；固辞
二月，辛巳，梁武帝在明堂举行祭祀典礼	壬午，东魏以咸阳王坦为太傅，西河王为太尉
壬午，东魏任命咸阳王元坦为太傅，西河王元为太尉	东魏使尚书右仆射高隆之发十万夫撤洛阳宫殿，运其材入邺
东魏指派尚书右仆射高隆之征调十万民工拆除洛阳的宫殿，将拆下的材料运到邺城	丁亥，上耕藉田
戊戌，梁朝司州刺史陈庆之讨伐东魏，与东魏豫州刺史尧雄交战，失利后返回	三月，辛酉，东魏以高盛为太尉，高敖曹为司徒，济阴王晖业为司空
梁朝的元庆和攻打东魏的城父城，东魏丞相高欢派遣高敖曹统率三万人马赶往项县，窦泰统率三万人赶往城父城，侯景统率三万人马赶往彭城，又任命任祥为东南道行台仆射，统一指挥管辖这几支军队	五月，魏加丞相泰柱国
东魏派遣行台元晏袭击梁朝的元庆和	或告东魏司空济阴王晖业与七兵尚书薛贰于魏，八月，辛卯，执送晋阳，皆免官
九月，丁巳，东魏任命开府仪同三司襄城王元旭为司空	冬，十月，魏太师上党文宣王长孙稚卒
冬季，十月，西魏的太师上党文宣王长孙稚去世	魏秦州刺史王超世，丞相泰之内兄也，骄而黩货，泰奏请加法，诏赐死
十二月，甲午，东魏根据文武百官承担事务的轻重，给予相应的俸禄	魏以念贤为太傅，河州刺史梁景睿为太尉
春季，正月辛亥，西魏文帝在南郊祭天，改以神元皇帝配享	甲子，东魏丞相欢自将万骑袭魏夏州，身不火食，四日而至，缚为梯，夜入其城，擒刺史斛拔俄弥突，因而用之，留都督张琼将兵镇守，迁其部落五千户以归
甲寅，东魏任命华山王元鸷为大司马	魏以凉州刺史李叔仁为司徒，万俟洛为太宰
西魏任命凉州史李叔仁为司徒，万俟洛为太宰	夏，四月，乙未，以骠骑大将军、开府同三司之仪元法僧为太尉
戊辰，东魏的高盛去世	魏越勒肱卒
西魏的越勒肱去世	魏秦州刺史万俟普与其子太宰洛、豳州刺史叱干宝乐、右卫将军破六韩常及督将三百人奔东魏，丞相泰轻骑追之，至河北千余里，不及而还
西魏的秦州刺史万俟普与他担任太宰的儿子万俟洛、豳州的刺史叱干宝乐、右卫将军破六韩常以及他们所督率的将领三百人一起投奔了东魏，丞相宇文泰带着轻装的骑兵追赶，一直追到黄河以北一千多里的地方，但是没有追上，只好返回	秋七月，庚子，东魏大赦
九月，壬寅，东魏任命定州刺史侯景兼任尚书右仆射、南道行台，督率各位将领侵犯梁朝	魏以扶风王孚为司徒，斛斯椿为太傅
西魏又重新改为尊始祖神元皇帝为太祖，道武皇帝为烈祖	十二月，东魏以并州刺史尉景为太保
十二月，东魏任命并州刺史尉景为太保	壬申，东魏遣使请和，上许之
壬申，东魏派遣使者去梁朝求和，梁武帝答应了	东魏清河文宣王卒
东魏的清河文宣王元去世	丁丑，东魏丞相欢督诸军伐魏，遣司徒高敖曹趣上洛，大都督窦泰趣潼关
丁丑，东魏的丞相高欢督率各路军队讨伐西魏，派遣司徒高敖曹前往上洛，大都督窦泰前往潼关	癸未，东魏以咸阳王坦为太师
癸未，东魏任命咸阳王元坦为太师	是岁，魏关中大饥，人相食，死者什七八
这一年，西魏的关中地区发生了大饥荒，出现了人吃人的现象，每十人之中就七八个死去	春，正月，上祀南郊，大赦
二月，丁亥，梁武帝在藉田耕作	己丑，以尚书左仆射何敬容为中权将军，护军将军萧渊藻为左仆射，右仆射谢举为右光禄大夫
己丑，梁武帝任命尚书左仆射何敬容为中权将军，护军将军萧渊藻为左仆射，右仆射谢举为右光禄大夫	魏槐里获神玺，大赦
西魏的槐里县得到一块神玺，文帝下令大赦天下	三月，辛未，东魏迁七帝神主入新庙，大赦
三月，辛未，东魏将七位已故皇帝的灵位移进了新庙，大赦天下	魏斛斯椿卒
西魏的斛斯椿去世	夏，五月，魏以广陵王欣为太宰，贺拔胜为太师
夏季，五月，西魏任命广陵王元欣为太宰，贺拔胜为太师	六月，魏以扶风王孚为太保，梁景睿为太傅，广平王赞为太尉，开府仪同三司武川王盟为司空
东魏的丞相高欢游玩汾阳的天池时，得到了一块奇异的石头，隐隐约约形成文字六王三川	东魏遣兼散骑常侍李谐来聘，以吏部郎卢元明、通直侍郎李业兴副之
他向行台郎中阳休之询问其意，阳休之回答说：六是指大王您的表字；王的意思是应该统治天下	谐，平之孙；元明，旭之子也
河、洛、伊是三条河流，泾、渭、洛也是三条河流	秋，七月，谐等至建康，上引见，与语，应对如流
大王您要是接受上天赋予你的使命，终究应该拥有关、洛的大片土地	谐等出，上目送之，谓左右曰：朕今日遇敌
高欢听后说道：世上的人们在没事的时候，都常常说我要谋反，何况听了这番话之后	卿辈尝言北间全无人物，此等何自而来
请你慎重些，不要胡说	是时邺下言风流者，以谐及陇西李神俊、范阳卢元明、北海王元景、弘农杨遵彦、清河崔赡为首
阳休之是阳固之子	神俊名挺，宝之孙；元景名昕，宪之曾孙也；皆以字行
行台郎中中山人杜弼乘机劝说高欢接受禅让，高欢举起棒子打跑了他	赡，之子也
西魏的宇文深劝说丞相宇文泰夺取恒农，八月，丁丑，宇文泰统率李弼等十二位将领讨伐东魏，任命北雍州刺史丁谨担任先锋，攻打并占领了盘豆	上修长干寺阿育王塔，出佛爪发舍利
戊子，攻下了该城，捉住了东魏的陕州刺史李徽伯，俘虏了他的八千名士兵	辛卯，上幸寺，设无碍食，大赦
丙子，东魏任命骠骑大将军、仪同三司万俟普为太尉	司农张乐皋等聘于东魏
梁朝司农张乐皋等人到东魏聘问	十二月，魏行台杨白驹与东魏阳州刺史段粲战于蓼坞，魏师败绩
东魏大都督善无人贺拔仁攻打西魏南汾州，南汾州刺史韦子粲向贺拔仁投降，西魏丞相宇文泰听到这一消息后，屠杀了韦子粲的全部家族	初，柔然头兵可汗始得返国，事魏尽礼
东魏大行台侯景等人在虎牢整顿部队，准备收复黄河以南的各州，看到势头不对，西魏的梁迥、韦孝宽、赵继宗都放弃他们所守的城跑回西部地区	及永安以后，雄据北方，礼渐骄倨，虽信使不绝，不复称臣
侯景攻打广州，没有取得成功，他听说西魏的救兵将要赶到，就召集全体将领一道商议对策	头兵尝至洛阳，心慕中国，乃置侍中、黄门等官；后得魏汝阳王典签淳于覃，亲宠任事，以为秘书监，使典文翰
兼管洛州事务的卢勇请求去前方观察形势，在征得侯景同意后，他便带领一百名骑兵来到大隗山，在这里，他们遇上了西魏的部队	及两魏分裂，头兵转不逊，数为边患
当时已是黄昏时刻，卢勇叫人在树木的顶端插上许多旗帜，表示兵力很多，等到夜里，他把手下的骑兵分成十队，大家吹着号角直向前冲去，抓获了西魏的仪同三司程华，杀死了仪同三司王征蛮，然后返回	魏丞相泰以新都关中，方有事山东，欲结婚以抚之，以舍人元翌女为化政公主，妻头兵弟塔寒
广州的守将骆超于是打开城门向东魏投降，东魏的丞相高欢下令让卢勇再兼管广州的事务	又言于魏主，请废乙弗后，纳头兵之女
卢勇是卢辩的堂弟	甲辰，以乙弗后为尼，使扶风王孚迎头兵女为后
从此，南汾、颖、豫、广这四个州重新划入东魏的版图	头兵遂留东魏使者元整，不报其使
五月，甲戌，东魏派遣兼散骑常侍郑伯猷到梁朝聘问	秋，七月，东魏荆州刺史王则寇淮南
秋季，七月，东魏荆州刺史王则侵犯淮河以南地区	癸亥，诏以东冶徒李胤之得如来舍利，大赦
东魏的大都督贺拔仁袭击并消灭了邢磨纳、卢仲礼等人的兵马	冬，十月，魏归高敖曹、窦泰、莫多娄贷文之首于东魏
冬季，十月，西魏将高敖曹、窦泰、莫多娄贷文的头颅归还给东魏	散骑常侍刘孝仪等聘于东魏
东魏以高澄摄吏部尚书，始改崔亮年劳之制，铨擢贤能；又沙汰尚书郎，妙选人地以充之	东魏委任高澄代理吏部尚书的职务，他开始改变崔亮制定的按待选年限提拔官员的制度，根据品德与才能提拔官职，又淘汰原有的尚书郎，精选出门第才能合适的人来充当
凡才名之士，虽未荐擢，皆引致门下，与之游宴、讲论、赋诗，士大夫以是称之	凡是有才能与声望的人士，即使没有推荐提拔，他也都把他们招致到自己的门下，与他们一道游处饮酒，说古道今，写诗作赋Ｊ孔骞僭币虼硕汲圃匏
丁巳，御史中丞参礼仪事贺琛奏：南、北二郊及藉田，往还并宜御辇，不复乘辂	丁巳，梁朝御史中丞参礼仪事贺琛向梁武帝递上奏折，建议：皇上往返都城南郊、北郊以及去藉田举行耕种仪式时，应该都乘坐辇而不应乘坐马车
诏从之，祀宗庙仍乘玉辇	梁武帝同意了，去祭祀宗庙时仍旧乘坐玉辇
琛，之弟子也	贺琛是贺的侄子
辛酉，东魏以尚书令孙腾为司徒	辛酉，东魏任命尚书令孙腾为司徒
辛未，上祀南郊	辛未，梁武帝在南郊祭天
魏丞相泰于行台置学，取丞郎、府佐德行明敏者充学生，悉令旦治公务，晚就讲习	西魏丞相宇文泰在行台设置了学堂，选拔丞郎、府佐中品德出众、思想灵敏的人充当学生，命令他们全都在白天处理公务，晚上去学堂听讲习
东魏丞相欢，以徐州刺史房谟、广平太守羊敦、广宗太守窦瑗、平原太守许有政绩清能，与诸刺史书，褒称谟等以劝之	东魏丞相高欢认为徐州刺史房谟、广平太守羊敦、广宗太守窦瑗、平原太守许政绩显著，廉洁而有能力，特地向各州刺史去信，信中表扬了房谟等人，以便对他们进行鼓励
夏，五月，甲戌，东魏立丞相欢女为皇后；乙亥，大赦	夏季，五月，甲戌，大赦天下
魏以开府仪同三司李弼为司空	西魏任用仪同三司李弼为司空
秋，七月，以扶风王孚为太尉	秋季，七月，又任用扶风王元孚为太尉
九月，甲子，东魏发畿内十万人城邺，四十日罢	九月，甲子，东魏征调了京畿内十万人修筑邺城，四十天完工
冬，十月，癸亥，以新宫成，大赦，改元兴和	冬季，十月癸亥，由于新的宫殿建成，孝静帝下令大赦天下，并改年号为兴和
魏置纸笔于阳武门外以求得失	西魏在阳武门外放置了纸与笔，让人们评论朝廷政治的得失
十一月，乙亥，东魏使散骑常侍王元景、魏收来聘	十一月，乙亥，东魏派遣散骑常侍王元景、魏收出使梁朝
散骑常侍朱异奏：顷来置州稍广，而小大不伦，请分为五品，其位秩高卑，参僚多少，皆以是为差	梁朝散骑常侍朱异向梁武帝呈上奏折，说道：近来，州的建置稍微多了一些，而且还不分大小，现在请求皇上把各州分为五个等级，州长官地位俸禄的高低，参佐幕僚人数的多少，都根据各州的等级形成差别
诏从之	梁武帝颁下诏书，表示同意
于是上品二十州，次品十州，次品八州，次品二十三州，下品二十一州	于是全国的各个州区分成：第一等级二十个，第二等级十个，第三等级八个，第四等级二十三个，第五等级二十一个
时上方事征伐，恢拓境宇，北逾淮、、汝，东距彭城，西开柯，南平俚洞，纷纶甚众，故异请分之	此时，梁武帝正在进行征战讨伐，收复失土，拓展国境，在北方越过了淮、汝地区，在东方到达彭城，在西方开发了柯，在南方平定了俚洞，情况比较混乱无章，所以朱异请求区分各州的等级
其下品皆异国之人，徒有州名而无土地，或因荒徼之民所居村落置州及郡县，刺史守令皆用彼人为之，尚书不能悉领，山川险远，职贡罕通	第五等州的居民都不是汉人，所以空有州名而没有土地，也有的在僻远蛮荒之地根据百姓所居住的村落设置州以及郡、县，刺史、郡守、县令都让当地的土人担任，尚书无法统管起来，由于山川险峻遥远，赋税贡品很难送到朝廷
五品之外，又有二十馀州不知处所	在五个等级以外，还有二十个州不知道设在什么地方
凡一百七州	梁朝共有一百零七个州
又以边境镇戍，虽领民不多，欲重其将帅，皆建为郡，或一人领二三郡太守，州郡虽多而户口日耗矣	又因为在边境地区驻兵守卫，虽然管理的百姓数量不多，但是为了显示对这些地方的的将帅的重视，就把不该建立郡的地方都建成郡，官员中有的一个人就担任两三个郡的太守，州郡虽然多，可是百姓的户口却日益减少了
魏自西迁以来，礼乐散逸，丞相泰命左仆射周惠达、吏部郎中北海唐瑾损益旧章，至是稍备	魏国自从迁到西边成为西魏以来，礼乐制度散失废弃，丞相宇文泰便命令左仆射周惠达、吏部郎中北海人唐瑾对旧的章程进行增减加工，到这时稍为具备
春，正月，壬申，东魏以广平公库狄干为太保	春季，正月，壬申，东魏任命广平公库狄干为太保
丁丑，东魏主入新宫，大赦	丁丑，东魏孝静帝迁入新的皇宫，大赦天下
魏扶风王孚卒	西魏扶风王元孚去世
二月，己亥，上耕藉田	二月，己亥，梁武帝来到藉田举行耕种仪式
魏铸五铢钱	西魏铸造五铢钱
东魏大行台侯景出三鸦，将复荆州；魏丞相泰遣李弼、独孤信各将五千骑出武关，景乃还	东魏大行台侯景从三鸦出发，准备收复荆州；西魏丞相宇文泰派遣李弼、独孤信各自率领五千名骑兵驰出武关增援，侯景这才返回
五月，乙酉，魏行台宫延和、陕州刺史宫延庆降于东魏，东魏以河北马场为义州以处之	五月，乙酉，西魏行台宫延河、陕州刺史宫延庆向东魏投降，东魏在黄河之北的马场建立了义州，派他们二人掌管
东魏阳州武公高永乐卒	东魏的阳州武公高永乐去世
闰月，丁丑朔，日有食之	闰月，丁丑朔，发生日食
己丑，东魏封皇兄景植为宜阳王，皇弟威为清河王，谦为颍川王	己丑，东魏的孝静帝封他的哥哥元景植为宜阳王，弟弟元威为清河王，元谦为颍川王
六月，壬子，东魏华山王鸷卒	六月，壬子，东魏的华山王元鸷去世
秋，七月，丁亥，东魏使兼散骑常侍李象等来聘	秋季，七月，丁亥，东魏派遣兼散骑常侍李象等人到梁朝聘问
八月，戊午，大赦	八月，戊午，梁朝大赦天下
冬，十一月，魏太师念贤卒	冬季，十一月，西魏的太师念贤去世
春，正月，辛巳，上祀南郊，大赦	春季，正月，辛巳，梁武帝在南郊举行祭天典礼，大赦天下
辛丑，祀明堂	辛丑，在明堂举行祭祀典礼
宕昌王梁定为其下所杀，弟弥定立	梁朝的宕昌王梁定被他的下属杀死，他的弟弟梁弥定继承了他的位置
二月，乙巳，以弥定为河・梁二州刺史、宕昌王	二月，乙巳，梁武帝任命梁弥定为河、梁二州刺史，并封他为宕昌王
辛亥，上耕藉田	辛亥，梁武帝来到藉田耕作
魏幽州刺史顺阳王仲景坐事赐死	西魏的幽州刺史顺阳王元仲景犯罪被文帝命令自杀
三月，魏夏州刺史刘平伏据上郡反，大都督于谨讨禽之	三月，西魏的夏州刺史刘平伏占据了上郡，在那里发动叛乱，大都督于谨前去讨伐，捉住了他
夏，五月，遣兼散骑常侍明少遐等聘于东魏	夏季，五月，梁武帝派遣兼散骑常侍明少遐等人到东魏聘问
秋，七月，己卯，东魏宜阳王景植卒	秋季，七月，己卯，东魏的宜阳王元景植去世
魏以侍中宇文测为大都督、行汾州事	西魏委派侍中宇文测出任大都督，兼管汾州的事务
测，深之兄也，为政简惠，得士民心	宇文测是宇文深的兄长，他处理政务时讲究效率、仁慈，受到士人与普通百姓的拥戴
地接东魏，东魏人数来寇抄，测擒获之，命解缚，引与相见，为设酒淆，待以客礼，并给粮饩，卫送出境	他管辖的地域与东魏相连接，东魏人多次前来掠夺，宇文测抓住了他们之后，叫人给他们松绑，带他们来和自己见面，专门安排了美酒佳肴，象招待客人一样招待他们，还给他们粮食，派人护送他们出境
东魏人大惭，不复为寇，汾、晋之间遂通庆吊，时论称之	东魏人觉得非常惭愧，不再与宇文测为敌，汾州与晋州两方居民如果遇上喜事或丧事时，还相互前去祝贺或吊丧，当时的舆论给予了好评
或告测交通境外者，丞相泰怒曰：测为我安边，我知其志，何得间我骨肉	有人控告宇文测交结联系国境以外的人，西魏丞相宇文泰听了愤怒地说：宇文测替我安定边境地区，我了解他的心意，你怎么能够离间我们骨肉兄弟
命斩之	他下令杀掉了控告者
乙巳，东魏发夫五万筑漳滨堰，三十五日罢	乙巳，东魏征调五万名民工修筑漳滨堰，三十五天完工
十二月，东魏遣兼散骑常侍李骞来聘	十二月，东魏派遣兼散骑常侍李骞到梁朝聘问
是岁，魏又益新制十二条	这一年，西魏又增加了十二条新的制度
东魏丞相欢以诸州调绢不依旧式，民甚苦之，奏令悉以四十尺为匹	东魏丞相高欢发现各个州征调绢帛时，都不按照原来的规定办事，老百姓为此吃了许多苦头，就上书请求孝静帝颁布命令，规定一律以四十尺为一匹
安成望族刘敬躬以妖术惑众，人多信之	安成的名门望族的刘敬躬用妖术迷惑众人，许多人都相信他
春，正月，敬躬据郡反，改元永汉，署官属，进攻庐陵，逼豫章	春季，正月，刘敬躬占据了安成郡发动叛乱，将年号改为永汉，任命了大小官员，又带兵攻打庐陵，随后逼近豫章
南方久不习兵，人情扰骇，豫章内史张绾募兵以拒之	南方地区已经很长时间没有战争，人心惶惶，无法安宁，豫章内史张绾招募士兵进行抵抗
绾，缵之弟也	张绾是张缵的弟弟
二月，戊戌，江州刺史湘东王绎遣司马王僧辩、中兵曹子郢讨敬躬，受绾节度	二月，戊戌，江州刺史、湘东王萧绎派遣司马王僧辩、中兵曹子郢讨伐刘敬躬，接受张绾的指挥
二月，戊辰，擒敬躬，送建康，斩之	二月，戊辰，他们活捉了刘敬躬，把他押送到建康处死了
僧辩，神念之子也，该博辩捷，器宇肃然，虽射不穿札，而志气高远	王僧辩是神念的儿子，他学问渊博，辩才敏捷，气度肃然，虽然射箭不能穿透皮甲，但是志气高远，超群出众
魏初置六军	西魏开始设置六军
夏，四月，丙寅，东魏使兼散骑常侍李绘来聘	夏季，四月，丙寅，东魏派遣兼散骑常侍李绘到梁朝聘问
绘，元忠之从子也	李绘是李元忠的侄子
八月，庚戌，东魏以开府仪同三司、吏部尚书侯景为兼尚书仆射、河南道大行台，随机防讨	八月，庚戌，东魏任命开府仪同三司、吏部尚书侯景为尚书侯景为尚仆射、河南道大行台，授权让他根据情况自行决定防守或讨伐
魏以王盟为太保	西魏任命王盟为太保
十二月，魏主狩于华阴，大享将士，丞相泰帅诸将朝之	十二月，西魏的文帝在华阴狩猎，安排盛大的酒宴招待将士，丞相宇文泰率领各位将领向文帝朝拜
起万寿殿于沙苑北	在沙苑北部盖起了一座万寿殿
辛亥，东魏遣兼散骑常侍杨斐来聘	辛亥，东魏派遣兼散骑常侍杨斐到梁朝聘问
孙、卢子雄讨李贲，以春瘴方起，请待至秋；广州刺史新渝侯映不许，武林侯谘又趣之	梁朝的孙、卢子雄讨伐李贲，由于时值春天，瘴气正在弥漫，所以他们请求等到秋季再进军；广州刺史、新渝侯萧映不予同意，武林侯谘又催促出征
等至合浦，死者什六七，众溃而归	孙等人到达合蒲时，因为瘴气的侵害，十个人中有六七个死去，部队溃散，只好返回
映，之子也	萧映是萧的儿子
武林侯谘奏及子雄与贼交通，逗留不进，敕于广州赐死	武林侯萧谘上书梁武帝，说孙与卢子雄跟反贼勾结，逗留在原地不进军，梁武帝下令叫孙、卢子雄在广州自杀
子雄弟子略、子烈、主帅广陵杜天合及弟僧明、新安周文育等帅子雄之众攻广州，欲杀映、谘，为子雄复冤	卢子雄的弟弟卢子略、卢子烈，主帅广陵杜天合以及他的弟弟杜僧明，还有周文育新安人等人率领卢子雄的兵马攻打广州，想杀死萧映、萧谘，为卢子雄报仇
西江督护、高要太守吴兴陈霸先帅精甲三千救之，大破子略等，杀天合，擒僧明、文育	西江督护、高要太守吴兴人陈霸先率领三千精锐士兵前来营救，大败卢子略等人，杀掉了杜天合，活捉了杜僧明、周文育
霸先以僧明、文育骁勇过人，释之，以为主帅	陈霸先因为杜僧明、周文育骁勇过人，就释放了他们，让他们担任主帅
诏以霸先为直将军	梁武帝颂下诏书，任命陈霸先为直将军
魏丞相泰妻冯翊公主生子觉	西魏丞相宇文泰的妻子冯翊公主生下了儿子宇文觉
东魏以光州刺史李元忠为侍中	东魏任命光州刺史李元忠为侍中
元忠虽处要任，不以物务干怀，唯饮酒自娱	李元忠虽然担任着显要的官职，但是并不让各类事务干扰自己的心怀，成天以喝酒自娱
丞相欢欲用为仆射，世子澄言其放达常醉，不可委以台阁	丞相高欢想任用李元忠为仆射，他的嫡长子高澄说李元忠行为放纵，常常喝得酩酊大醉，不可以让他入尚书台辅佐皇帝
其子搔闻之，请节酒，元忠曰：我言作仆射不胜饮酒乐，尔爱仆射，宜勿饮酒	李元忠的儿子李搔听到这句话以后，请求父亲节制喝酒的嗜好，李元忠回答说：对我来说，当一个仆射可没有喝酒的快活，你喜欢仆射这种职位的话，就应该不喝酒
春，正月，壬戌，东魏大赦，改元武定	春季，正月，壬戌，东魏大赦天下，改年号为武定
以太子詹事谢举为尚书仆射	梁朝任命太子詹事谢举为尚书仆射
夏，四月，林邑王攻李贲，贲将范破林邑于九德	夏季，四月，梁朝的林邑王攻打李贲，李贲的部将范在九德击败了林邑王
泰使谍潜入虎牢，令守将魏光固守，侯景获之，改其书云：宜速去	宇文泰派遣间谍潜入虎牢，命令守城的将领魏光坚决防守，侯景捉住了这个间谍，把宇文泰的信改成这样：应该尽快离开
纵谍入城，光宵遁	然后将间谍放进城去，魏光看到信以后连夜逃跑了
景获高仲密妻子送邺，北豫、洛二州复入于东魏	侯景俘虏了高仲密的妻子、儿子，将他们送到邺城，北豫、洛这两个州又重为东魏所有
五月，壬辰，东魏以克复虎牢，降死罪已下囚，唯不赦高仲密家	五月，壬辰，东魏由于收复了虎牢，对那些已判为死罪的囚犯作了宽大处理，唯独不赦免高仲密的家人
丞相欢以高乾有义勋，高昂死王事，季式先自告，皆为之请，免其从坐	丞相高欢考虑到当年高乾在信都起义拥戴自己，高阳战死在河阳，高季式先从永安戍跑来将情况告诉自己，就在孝静帝面前一一替他们说情，没让他们的家人连坐
仲密妻李氏当死，高澄盛服见之曰：今日何如	高仲密的妻子李氏本来应当被处死，高澄衣冠楚楚地接见她，问道：今日怎么样
李氏默然，遂纳之	李氏默默无语，于是高澄将她收纳为妾
乙未，以侯景为司空	乙未，东魏任命侯景为司空
八月，乙丑，东魏以汾州刺史斛律金为大司马	八月，乙丑，东魏任命汾州刺史斛律金为大司马
东魏遣兼散骑常侍李浑等来聘	东魏派遣兼散常侍李浑等人出使梁朝
冬，十一月，甲午，东魏主狩于西山；乙巳，还宫	冬季，十一月，甲午，返回皇宫
高澄启解侍中，东魏主以其弟并州刺史太原公洋代之	高澄上书孝静帝，请求解除自己的侍中职务，孝静帝让高澄的弟弟并州刺史、太原公高洋代替他
丞相欢筑长城于肆州北山，西自马陵，东至土，四十日罢	丞相高欢下令在肆州的北山修建长城，这条长城西面从马陵开始，东面一直到达土，四十天完工
春，正月，李贲自称越帝，置百官，改元大德	春季，正月，李贲自封为越帝，设置了文武百官，将年号改为大德
三月，癸巳，东魏丞相欢巡行冀、定二州，校河北户口损益，因朝于邺	三月癸巳，东魏的丞相高欢巡视冀州、定州，查点河北地区的户口是增加还是减少了，因而来到邺城朝拜孝静帝
甲午，上幸兰陵，谒建宁陵，使太子入守京城；辛丑，谒陵	甲午，又拜谒了陵
丙午，东魏以开府仪同三司孙腾为太保	丙午，东魏任命开府仪同三司孙腾为太保
己酉，上幸京口城北固楼，更名北顾；庚戌，幸回宾亭，宴乡里故老及所经近县迎候者，少长数千人，各赉钱二千	己酉，又来到回宾亭，宴请家乡的父老乡亲以及所经过的附近县里前来迎接的人，男女老少达几千人，梁武帝赏给每个人两千铜钱
壬子，东魏以高澄为大将军、领中书监，元弼为录尚书事，左仆射司马子如为尚书令，侍中高洋为左仆射	壬子，东魏任命高澄为大将军、领中书监，元弼为录尚书事，左仆射司马子如为尚书令，侍中高洋为左仆射
夏，四月，乙卯，上还自兰陵	夏季，四月，乙卯，梁武帝从兰陵返回都城
五月，甲申朔，魏丞相泰朝于长安	五月，甲申朔，西魏丞相宇文泰在长安朝拜文帝
甲午，东魏遣散骑常侍魏季景来聘	甲午，东魏派遣散骑常侍魏季景来梁朝聘问
季景，收之族叔也	魏季景是魏收的同族叔叔
尚书令何敬容妾弟盗官米，以书属领军河东王誉，丁酉，敬容坐免官	梁朝尚书令何敬容小妾的弟弟盗窃了官家的大米，何敬容写信给领军河东王萧誉说情；丁酉，何敬容受到牵连被免去官职
东魏广阳王湛卒	东魏广阳王元湛去世
魏琅琊贞献公贺拔胜诸子在东者，丞相欢尽杀之，胜愤恨发疾而卒	西魏琅琊贞献公贺拔胜留在东魏的几个儿子，都被丞相高欢杀掉了，贺拔胜愤怒不已，发病而死
丞相泰常谓人曰：诸将对敌神色皆动，唯贺拔公临陈如平时，真大勇也	西魏丞相宇文泰常常对人说：各位将领面对敌人的时候，神色都会有所变化，唯独贺拔胜上战场时就跟平时一样，真可算是大勇啊
秋，七月，魏更权衡度量，命尚书苏绰损益三十六条之制，总为五卷，颁行之	秋季，七月，西魏的改革度量衡制度，尚书苏绰受命酌定在原来的二十四条制度的基础上，增补而成的三十六条制度，定为五卷，在全国颁布实行
搜简贤才为牧守令长，皆依新制而遣焉	同时寻求挑选贤能的人才担任牧、守、令、长等地方官，都是按照新的制度被派遣的
数年之间，百姓便之	几年之中，百姓都从中得到了好处
己丑，大赦	己丑，梁朝大赦天下
庚子，东魏主祀圆丘	庚子，东魏孝静帝在圜丘祭天
东魏丞相欢袭击山胡，破之，俘万馀户，分配诸州	东魏丞相高欢派兵袭击山胡，并打败了他们，俘虏了一万多户人家，将他们分配到了各个州
是岁，东魏以散骑常侍魏收兼中书侍郎，修国史	这一年，东魏让散骑常侍魏收兼任中书侍郎，编修国史
自梁、魏通好，魏书每云：想彼境内宁静，此率土安和	自从梁、魏两国相互往来友好之后，魏国的国书上总是写道：料想彼境内安宁平静，此间平安祥和
上复书，去彼字而已	梁武帝复信时，仅仅去掉了一个彼字而已
收始定书云：想境内清晏，今万里安和	魏收起草国书才确定了这样的用语：料想境内清明平静，如今天下平安祥和
上亦效之	梁武帝在撰写国书时也仿效这句话
春，正月，丙申，东魏遣兼散骑常侍李奖来骋	春季，正月，丙申，东魏派兼任散骑常侍的李奖到梁朝聘问
夏，五月，甲辰，东魏大赦	夏季，五月，甲辰，东魏大赦天下
魏王盟卒	西魏的王盟去世
晋氏以来，文章竞为浮华，魏丞相泰欲革其弊	从晋朝以来，天下文章竞相以词藻繁富相夸，西魏丞相宇文泰想革除这一不良风气
六月，丁巳，魏主飨太庙	六月，丁巳，西魏文帝到太庙祭祖
泰命大行台度支尚书、领著作苏绰作《大诰》，宣示群臣，戒以政事；仍命自今文章皆依此体	宇文泰命令大行台度支尚书、领著作苏绰写了一篇《大诰》，宣读给文武大臣们听，劝诫大臣们勤于政事，西魏还下命令：从今以后，文章都要按照这种方式来写
冬，十月，乙未，诏有罪者复听入赎	冬季，十月，乙未，梁朝颁下诏书：重新允许有罪的人交钱赎罪
东魏遣中书舍人尉瑾来聘	东魏派中书舍人尉瑾来梁朝聘问
乙未，东魏丞相欢请释邙山俘囚桎梏，配以民间寡妇	乙未，东魏丞相高欢请求释放邙山的战俘，把民间的寡妇许配给他们
十二月，东魏以侯景为司徒，中书令韩轨为司空；戊子，以孙腾录尚书事	十二月，东魏任命侯景为司徒，任命中书令韩轨为司空，戊子，任命孙腾为录尚书事
魏筑圜丘于城南	西魏在长安城南面建造了一个祭天的圆丘
春，正月，癸丑，杨等克嘉宁城，李贲奔新昌獠中，诸军顿于江口	春季，正月，癸丑，杨等人攻克了嘉宁城，李贲逃奔新昌的獠人地区，各路人马便停留在江口
三月，乙巳，大赦	三月，乙己，梁朝大赦天下
庚戌，上幸同泰寺，遂停寺省，讲《三慧经》	庚戌，梁武帝临幸同泰寺，就住在寺里的临时官署中，讲读《三慧经》
夏，四月，丙戌，解讲，大赦，改元	夏季，四月，丙戌，梁武帝讲经结束，实行大赦，改换年号
是夜，同泰寺浮图灾，上曰：此魔也，宜广为法事	这天夜里，同泰寺的塔起火，梁武帝说：这是魔鬼造成的，应该大规模地做一些佛事活动
群臣皆称善	文武大臣们都说好
乃下诏曰：道高魔盛，行善鄣生，当穷兹土木，倍增往日	于是，梁武帝下诏说：道高魔盛，行善发生障碍，应该大兴土木，建造规模要超过以往
遂起十二层浮图；将成，值侯景乱而止	于是便开始起造一座高十二层的佛塔；将要建成之时，正赶上侯景叛乱，便中止修建了
六月，庚子，东魏以司徒侯景为河南大将军、大行台	六月，庚子，东魏任命司徒侯景为河南大将军和大行台
秋，七月，壬寅，东魏遣散骑常侍元廓来聘	秋季，七月，壬寅，东魏派散骑常侍元廓来到梁朝聘问
甲子，诏：犯罪非大逆，父母、祖父母不坐	甲子，梁武帝颁布诏书：罪犯如果不犯有大逆不道的罪行，他的父母以及祖父母不被连坐
上年高，诸子心不相下，邵陵王纶为丹杨尹，湘东王绎在江州，武陵王纪在益州，皆权侔人主；太子纲恶之，常选精兵以卫东宫	梁武帝年事已高，他的儿子们彼此互不相服，邵陵王萧纶任丹杨尹，湘东王萧绎任江州刺史，武陵王萧纪任益州刺史，他们的权力都跟皇帝一般；太子萧纲很忌恨他们，常常挑选一些精锐军队来保卫东宫
八月，以纶为南徐州刺史	八月，梁武帝任命萧纶担任南徐州刺史
东魏丞相欢如邺	东魏丞相高欢前往邺城
高澄迁洛阳《石经》五十二碑于邺	他的儿子高澄将洛阳五十二块刻有《石经》的石碑迁到了邺城
冬，十月，乙亥，以前东扬州刺史岳阳王为雍州刺史	冬季，十月，己亥，梁朝任命前东扬州刺史岳阳王萧为雍州刺史
上舍兄弟而立太子纲，内尝愧之，宠亚诸子	梁武帝没有选择萧他们几个兄弟，而立太子萧纲作为接班人，他在内心里觉得愧对萧，他对萧的宠爱仅次于对他的其他几个儿子
以会稽人物殷阜，故用兄弟迭为东扬州以慰其心	由于会稽这一地区人口稠密，物产丰富，所以梁武帝让萧他们几个兄弟轮流担任东阳州刺史，用此来安抚他们
兄弟亦内怀不平	萧几兄弟在心里也感到忿忿不平
以上衰老，朝多秕政，遂蓄聚货财，折节下士，招募勇敢，左右至数千人	萧认为，皇帝人已经衰老，朝廷的政治中有许多毛病，于是，他便开始储备物资和财产，屈己下人，礼贤下士，在天下招募勇敢善战的人，他身边的人已达到几千人
以襄阳形胜之地，梁业所基，遇乱可以图大功	因为襄阳的地理优势很大，它是梁朝大业的根基，梁武帝就是从襄阳起兵才夺取天下的，所以如果遇到天下大乱，就可以在此图谋大业
乃克己为政，抚循士民，数施恩惠，延纳规谏，所部称治	于是，萧便严格要求自己，抚慰、顺应百姓与官员们的心理，多次对他们实施恩惠，广泛听取大家的规劝和意见，他所管辖的地区被治理得井井有条
东魏司徒、河南大将军、大行台侯景，右足偏短，弓马非其长，而多谋算	东魏司徒、河南大将军、大行台侯景，右脚比左脚短，所以，骑马射箭对他来说并不擅长，但是他足智多谋
诸将高敖曹、彭乐等皆勇冠一时，景常轻之，曰：此属皆如豕突，势何所至	高敖曹、彭乐等将领都是当时最勇猛的，侯景常常很轻视他们，对人说：这些人就象受惊的猪一样横冲直撞，流窜侵扰，能撞到哪里去呢
景尝言于丞相欢：愿得兵三万，横行天下，要须济江缚取萧衍老公，以为太平寺主	侯景曾对丞相高欢说：我愿意率领三万人马，横扫天下，应当渡过长江把萧衍那老头子绑来，让他做太平寺的寺主
欢使将兵十万，专制河南，杖任若己之半体	高欢派他带领十万兵马，全权管理黄河以南地区，对他的依靠、任用，就好象他是自己的半个身体一样
春，正月朔，日有食之，不尽如钩	春季，正月朔，发生日偏食，未被遮尽的太阳象钩一样
丙午，东魏勃海献武王欢卒	丙午，东魏勃海献武王高欢去世
欢性深密，终日俨然，人不能测，机权之际，变化若神	高欢性格深沉谨细，一天到晚总是一副很庄严的样子，谁都不能猜测到他内心想些什么，在掌握机会和权变方面，他能千变万化，如有神助
制驭军旅，法令严肃	在治理、驾驭军队方面，又能做到法令严格
听断明察，不可欺犯	他听取和断决事情，能做到明察秋毫，谁也不敢冒犯、欺骗他
擢人受任，在于得才，苟其所堪，无问厮养，有虚声无实者，皆不任用	在选拔人才，提升任用官员时，只注重其才能，如果能担当此任，哪怕是仆人也不管；那些徒有虚名而无实际能力的，都不被任用
雅尚俭素，刀剑鞍勒无金玉之饰	高欢平时喜好节俭朴素，所用的刀、剑、马鞍以及缰绳都没用金银玉器装饰
少能剧饮，自当大任，不过三爵	他年轻时很能饮酒，自从担当大任之后，饮酒便不超过三杯
知人好士，全护勋旧；每获敌国尽节之臣，多不之罪	他了解下属，喜欢人才，对有功勋者和老部下都极力保护、成全；每次俘获到敌国的那些为本国尽忠尽节的大臣，大多不处罚他们
由是文武乐为之用	由于这样，文武百官都乐意被他使用
世子澄秘不发丧，唯行台左丞陈元康知之	长子高澄封锁了高欢去世的消息，秘而不宣，只有行台左丞陈元康知道
辛酉，上祀南郊，大赦；甲子，祀明堂	辛酉，在明堂祭祀
三月，魏诏：自今应宫刑者，直没官，勿刑	三月，西魏朝廷诏令：从今开始，凡是应该受到宫刑处罚的人，只把犯罪者没收入官为奴，不再用刑
魏以开府仪同三司若干惠为司空，侯景为太傅、河南道行台、上谷公	西魏任命开府仪同三司若干惠为司空，侯景为太傅、河南道行台、上谷公
丁亥，上耕藉田	丁亥，梁武帝耕种藉田
三月，庚子，上幸同泰寺，舍身如大通故事	三月，庚子，梁武帝临幸同泰寺，举行舍身仪式，和大通元年那次一样
甲辰，遣司州刺史羊鸦仁督兖州刺史桓和、仁州刺史湛海珍等，将兵三万趣悬瓠，运粮食应接侯景	甲辰，梁武帝派司州刺史羊鸦仁督率兖州刺史桓和、仁州刺史湛海珍等人，带领三万人马向悬瓠方向靠近，运送粮食以接应侯景
魏大赦	西魏大赦天下
东魏高澄虑诸州有变，乃自出巡抚	东魏高澄担心各州会出现变故，便亲自外出巡视各地，安抚下属
留段韶守晋阳，委以军事；以丞相功曹赵彦深为大行台都官郎中	他让段韶留下守卫晋阳，并委以军事重任；又让丞相功曹赵彦深担任了大行台都官郎中
使陈元康豫作丞相欢条教数十纸付韶及彦深，在后以次行之	并让陈元康把事先写在几十张纸上，以丞相高欢的名义发布的命令，交给段韶和赵彦深，让他们在高澄走后按顺次去执行
临发，握彦深手泣曰：以母、弟相托，幸明此心	临出发之前，高澄握住赵彦深的手，哭着对他说：我把自己的母亲、弟弟托付给你了，希望你明白我的心意
夏，四月，壬申，澄入朝于邺	夏季，四月，壬申，高澄到邺城去朝见
东魏主与之宴，澄起舞，识者知其不终	东魏孝静帝设宴招待他，席间，高澄起身舞蹈，有识之士认为高澄父亲刚死就乐而忘哀，不会有好下场
丙子，群臣奉赎	丙子，梁朝文武百官给佛门捐钱为梁武帝赎身
丁亥，上还宫，大赦，改元，如大通故事	丁亥，梁武帝回到了皇宫，大赦天下，改换年号为太清，就象大通年间那次一样
五月，丁酉朔，东魏大赦	五月，丁酉朔，东魏大赦天下
戊戌，东魏以襄城王旭为太尉	戊戌，东魏任命襄城王元旭为太尉
甲辰，东魏以开府仪同三司库狄干为太师，录尚书事孙腾为太傅，汾州刺史贺拔仁为太保，司徒高隆之录尚书事，司空韩轨为司徒，青州刺史尉景为大司马，领军将军可朱浑道元为司空，仆射高洋为尚书令、领中书监，徐州刺史慕容绍宗为尚书左仆射，高阳王斌为右仆射	甲辰，东魏任命开府仪同三司库狄干为太师，录尚书事孙腾为太傅，汾州刺史贺拔仁为太保，司徒高隆之为录尚书事，司空韩轨为司徒，青州刺史尉景为大司马，领军将军可朱浑道元为司空，仆射高洋为尚书令、领中书监，徐州刺史慕容绍宗为尚书左仆射，高阳王元斌为右仆射
戊午，尉景卒	戊午，尉景去世
韩轨等围侯景于颍川	韩轨等人率军把侯景包围在颍川
景惧，割东荆、北兖州、鲁阳、长社四城赂魏以求救	侯景见这种状况，害怕了，便把东荆、北兖州、鲁阳、长社四座城割让给了西魏，用此来贿赂西魏，以便取得其援救
尚书左仆射于谨曰：景少习兵，奸诈难测，不如厚其爵位以观其变，未可遣兵也	西魏尚书左仆射于谨说：侯景在少年时就习武练兵，为人奸诈，难以揣测，所以不如封以他高官厚禄，看看他的变化再说，先不要派兵去援救他
荆州刺史王思政以为：若不因机进取，后悔无及	荆州刺史王思政却认为：如果不抓住时机进取，后悔就来不及了
即以荆州步骑万馀从鲁阳关向阳翟	于是便派荆州的一万多名步兵和骑兵经鲁阳关向阳翟进发
丞相泰闻之，加景大将军兼尚书令，遣太尉李弼、仪同三司赵贵将兵一万赴颍川	西魏丞相宇文泰知道情况之后便封侯景为大将军兼尚书令，并派遣太尉李弼、仪同三司赵贵率领一万人马赶赴颍川去为侯景解围
魏以开府仪同三司独孤信为大司马	西魏任命开府仪同三司独孤信为大司马
六月，戊辰，以鄱阳王范为征北将军，总督汉北征讨诸军事，击穰城	六月，戊辰，西魏委任鄱阳王元范为征北将军，令他总督汉北征讨诸军事，去进攻穰城
东魏韩轨等围颍川，闻魏李弼、赵贵等将至，乙巳，引兵还邺	东魏的韩轨等人包围了颍川，得知西魏的李弼、赵贵等人将要领兵到来，乙巳，带领军队撤回了邺城
侯景欲因会执弼与贵，夺其军；贵疑之，不往	侯景想趁机抓获李弼和赵贵二人，夺取他们的军队；赵贵对侯景产生了怀疑，不去颍川与侯景相会
贵欲诱景入营而执之，弼止之	赵贵想把侯景诱入军营而趁机拘捕他，李弼制止了赵贵这一做法
羊鸦仁遣长史邓鸿将兵至汝水，弼引兵还长安	这时，羊鸦仁派长史邓鸿率领军队到了汝水，李弼便率领军队回到了长安
王思政入据颍川	王思政带兵占据了颍川
景阳称略地，引兵出屯悬瓠	侯景假称要攻取州郡，带领军队出颍川城，驻扎于悬瓠
高澄将如晋阳，以弟洋为京畿大都督，留守于邺，使黄门侍郎高德政佐之	高澄将要去晋阳，便任命他的弟弟高洋为京畿大都督，让他留守邺城，并让黄门侍郎高德政来辅佐他
德政，颢之子也	高德政是高颢的儿子
丁丑，澄还晋阳，始发丧	丁丑，高澄回到了晋阳，方才开始为高欢发丧
秋，七月，魏长乐武烈公若干惠卒	秋季，七月，西魏长乐武烈公若干惠去世
庚申，羊鸦仁入悬瓠城	庚申，羊鸦仁进入了悬瓠城
甲子，诏更以悬瓠为豫州，寿春为南豫州，改合肥为合州	甲子，梁武帝诏令改悬瓠为豫州，改寿春为南豫州，改合肥为合州
以鸦仁为司、豫二州刺史，镇悬瓠；西阳太守羊思达为殷州刺史，镇项城	任命羊鸦仁为司、豫两州刺史，镇守悬瓠；任命西阳太守羊思达为殷州刺史，镇守项城
八月，乙丑，下诏大举伐东魏	八月，乙丑，梁武帝诏令派大量军队去讨伐东魏
遣南豫州刺史贞阳侯渊明、南兖州刺史南康王会理分督诸将	他派遣南豫州刺史贞阳侯萧渊明、南兖州刺史南康王萧会理分别督率各位将领进攻东魏
渊明，懿之子；会理，续之子也	萧渊明是萧懿的儿子，萧会理是萧续的儿子
始，上欲以鄱阳王范为元帅；朱异取急在外，闻之，遽入曰：鄱阳雄豪盖世，得人死力，然所至残暴，非吊民之材	开始，梁武帝想让鄱阳王萧范担任元帅；朱异正在外面休假，听说梁武帝要让萧范担任元帅，急忙进朝对梁武帝说：鄱阳王虽然是英雄豪杰，盖世无双，许多人为他竭尽全力地效劳
且陛下昔登北顾亭以望，谓江右有反气，骨肉为戎首，今日之事，尤宜详择	但他所到之处非常残忍凶暴，不是个能爱惜百姓的人
上默然，曰：会理何如	况且陛下您往日登上北顾亭眺望远方时曾说长江西边的地区有反叛之气，骨肉之亲常常是战争的祸首，所以由谁挂帅尤其应该仔细选择
对曰：陛下得之矣	梁武帝点头称是，又问：萧会理如何呢
会理懦而无谋，所乘襻舆，施板屋，冠以牛皮	朱异回答说：陛下选对人了
上闻，不悦	萧会理怯懦而又少谋，他所乘坐的抬轿，用木板屋子的形状，外面蒙着牛皮，梁武帝知道之后，很不高兴
贞阳侯渊明时镇寿阳，屡请行，上许之	贞阳侯萧渊明此时正镇守寿阳，他多次向梁武帝请求去带兵打仗，梁武帝允许了
会理自以皇孙，复为都督，自渊明已下，殆不对接	而萧会理自恃是皇帝的孙子，又担任了都督，便不把众人放在眼里，自萧渊明以下的人，一概不予理睬
渊明与诸将密告朱异，追会理还，遂以渊明为都督	萧渊明便和诸位将领一起把这件事秘密通报给了朱异，朱异派人把萧会理追了回来，就让萧渊明担任了都督
辛未，高澄入朝于邺，固辞大丞相，诏为大将军如故，馀如前命	辛未，东魏高澄来到邺城朝拜孝静帝，坚决辞去大丞相的职务；东魏孝静帝诏令他仍然担任大将军，其它职务还同以前任命的那样
戊子，武州刺史萧弄璋攻东魏碛泉、吕梁二戍，拔之	戊子，梁朝武州刺史萧弄璋带兵去攻打东魏的碛泉、吕梁二座城堡，并占领了它们
或告东魏大将军澄云：侯景有北归之志	有人告诉东魏大将军高澄：侯景有北归之意
会景将蔡道遵北归，言景颇知悔过	这时正好侯景的将领蔡道遵回到了东魏，讲道：侯景有所悔过
景母及妻子皆在邺，澄乃以书谕之，语以阖门无恙，若还，许以豫州刺史终其身，还其宏妻、爱子，所部文武，更不追摄	侯景的母亲和妻子儿女都住在邺城，高澄便写信告诉侯景，说他的全家人都安然无恙，如果他肯回到东魏，便许诺让他终身担任豫州刺史，并还他宠妻爱子，对于他手下的文武官员，更是既往不咎
景使王伟复书曰：今已引二邦，扬旌北讨，熊豹齐奋；克复中原，幸自取之，何劳恩赐	侯景指使手下人王伟给高澄回信说：现在，我已经带领梁和西魏的军队，举旗北伐，兵卒们士气高涨；恢复中原地区，我希望能自己攻取，怎么能有劳您来恩赐给我呢
昔王陵附汉，母在不归，太上囚楚，乞羹自若，矧伊妻子，而可介意	从前王陵归附了刘邦，母亲被项羽抓去他仍不肯回去；刘邦的父亲被项羽囚禁了，项羽威胁要杀掉其父，刘邦却坦然地向项羽讨要煮他父亲的肉汤喝，父母尚且如此，何况是妻子儿女，那就更不介意了
脱谓诛之有益，欲止不能，杀之无损，徒复坑戮，家累在君，何关仆也	如果说杀掉我的妻子和孩子对你有利的话，我想阻止你也是阻止不了的，如果杀掉他们对我毫无损害，那么您杀戮了他们也是徒然，反正我的家室全在您手中，如何处置，与我有什么相关啊
东魏静帝，美容仪，旅力过人，能挟石师子逾宫墙，射无不中；好文学，从容沈雅	东魏孝静帝容貌、仪表俊美，臂力过人，能把石狮子夹在胳膊下面飞身跳过宫墙，射箭百发百中；他还喜好文学，行止丛容沉稳，性情高雅
时人以为有孝文风烈，大将军澄深忌之	当时的人都认为他有北魏孝文帝的风范，因此大将军高澄特别防范他
冬，十一月，魏丞相泰从魏主狩于岐阳	冬季，十一月，西魏丞相宇文泰跟随西魏文帝到岐阳打猎
东魏大将军澄使大都督高岳救彭城，欲以金门郡公潘乐为副	东魏大将军高澄派遣大都督高岳去援救彭城，并想让金门郡公潘乐担任高岳的副手
陈元康曰：乐缓于机变，不如慕容绍宗；且先王之命也	陈元康对高澄说：潘乐反应比较迟缓，不能随机应变，不如慕容绍宗；何况让慕容绍宗去对付侯景也是先王高欢的命令
公但推赤心于斯人，景不足忧也	您只要赤诚对待慕容绍宗，侯景是不足为虑的
时绍宗在外，澄欲召见之，恐其惊叛；元康曰：绍宗知元康特蒙顾待，新使人来饷金；元康欲安其意，受之而厚答其书，保无异也	当时慕容绍宗正在外地，高澄想召见他，但又怕他受惊起疑心而反叛；陈元康对高澄说：慕容绍宗知道我陈元康特别受您的照顾和优待，最近他又派人来馈赠我黄金；我为了让他放心，便接受了这些黄金，并在给他的回信中厚谢了他，所以可以保证他不会有别的的想法
乙酉，以绍宗为东南道行台，与岳、乐偕行	乙酉，东魏让慕容绍宗担任了东南道行台，使他与高岳、潘乐一起去援救彭城
初，景闻韩轨来，曰：啖猪肠儿何能为	当初，侯景听说韩轨要来，便说：这个吃猪肠子的小子能干些什么
闻高岳来，曰：兵精人凡	当侯景听说高岳要来，又说：兵士倒是很精锐，但领兵的人很一般
诸将无不为所轻者	各位将领没有不被侯景轻视的
及闻绍宗来，叩鞍有惧色，曰：谁教鲜卑儿解遣绍宗来	但是，当侯景听说慕容绍宗要来时，便敲打着马鞍，脸上露出恐惧的神色，说：谁使高澄这个鲜卑小子懂得派遣慕容绍宗来呢
若然，高王定未死邪	如果这样，高王就一定没有死去
魏岐州久经丧乱，刺史郑穆初到，有户三千，穆抚循安集，数年之间，至四万余户，考绩为诸州之最；丞相泰擢穆为京兆尹	西魏岐州长期经受战乱，刺史郑穆初到任时，只有三千户人家，郑穆安抚百姓，让他们休养生息，并让他们聚集而居，几年之间，岐州便有了四万多户人家，朝廷考绩时在所有州刺史中他的政绩最好；丞相宇文泰提拔郑穆为京兆尹
侯景与东魏慕容绍宗相持数月，景食尽，司马世云降于绍宗	侯景与东魏的慕容绍宗相持了几个月，侯景的粮食吃完了，司马世云投降了慕容绍宗
辛丑，以尚书仆射谢举为尚书令，守吏部尚书王克为仆射	辛丑，梁武帝任命尚书仆射谢举为尚书令，守吏部尚书王克为仆射
己未，东魏大将军澄朝于邺	己未，东魏大将军高澄来到邺城朝拜国主
魏以开府仪同三司赵贵为司空	西魏任命开府仪同三司赵贵为司空
魏皇孙生，大赦	西魏文帝的孙子降生，大赦天下
三月，癸巳，东魏以太尉襄城王旭为大司马，开计仪同三司高岳为太尉	三月，癸巳，东魏任命太尉襄城王旭为大司马，任命开府仪同三司高岳为太尉
辛亥，大将军澄南临黎阳，自虎牢济河至洛阳	辛亥，大将军高澄南巡至黎阳，从虎牢渡过黄河到达了洛阳
魏同轨防长史裴宽与东魏将彭乐等战，为乐所擒，澄礼遇甚厚，宽得间逃归	西魏同轨防长史裴宽与东魏乐等人交战，被彭乐抓获，高澄以礼相待，待他很优厚，裴宽找了个机会逃回了西魏
澄由太行返晋阳	高澄由太行出发，返回了晋阳
屈獠同斩李贲，传首建康	在屈獠洞有人将李贲斩杀了，他的首级被送到建康城
贲兄天宝遁入九真，收余兵二万围爱州，交州司马陈霸先帅众讨平之	李贲的哥哥李天宝逃到了九真郡，收聚剩余的二万人马包围了爱州，交州司马陈霸先率领军队讨伐并扫平了李天宝
诏以霸先为西江督护、高要太守、督七郡诸军事	梁武帝下诏任命陈霸先为西江督护、高要太守、督七郡诸军事
夏，四月，甲子，东魏吏部令史张永和等伪假人官，事觉，纠检、首者六万馀人	夏季，四月，甲子，东魏吏部令史张永和等人伪造任官文书授人官职，事情败露之后，由别人纠查、检举出的人以及自首的人达六万多
六月，东魏大将军澄巡北边	六月，东魏大将军高澄到北部边境地区巡视
秋，七月，庚寅朔，日有食之	秋季，七月，庚寅朔，这一天有日食现象
乙卯，东魏大将军洽朝于邺	乙卯，东魏大将军高澄到邺城上朝
以道士多伪滥，始罢南郊道坛	因为道士中有许多是假冒的，东魏便将南郊的道坛废除了
八月，庚寅，澄还晋阳，遣尚书辛术帅诸将略江、淮之北，凡获二十三州	八月，庚寅，高澄返回晋阳，他派尚书辛术统率诸将夺取长江、淮河以北的地区，一共占领了二十三个州
九月，东魏濮阳武公娄昭卒	九月，东魏濮阳武公娄昭去世
戊辰，封山侯正表以北徐州降东魏，东魏徐州刺史高归彦遣兵赴之	戊辰，梁朝封山侯萧正表带领北徐州军民投降了东魏，东魏徐州刺史高归彦派遗部队赶到北徐州
归彦，欢之族弟也	高归彦是高欢的同族弟弟
己巳，太子迁居永福省	己巳，梁朝的皇太子搬到永福省居住
高州刺史李迁仕、天门太守樊文皎将援兵万馀人至城下	高州刺史李迁仕、天门太守樊文皎率领一万多名援兵赶到城下
台城与援军信命久绝，有羊车儿献策，作纸鸱，系以长绳，写敕于内，放以从风，冀达众军，题云：得鸱送援军，赏银百两	朝廷与援军之间的书信往来已经中断很久，有一位叫羊车儿的人出了一个主意，按照这一主意做了一只纸鸢，在上面系上长绳，将敕令写在里头，顺风放出去，希望它能到达援军中的任何一支部队里
太子自出太极殿前乘西北风纵之，贼怪之，以为厌胜，射而下之	为了保证成功，纸鸢上还题上这样几个字：如果得到纸鸢后把它送给援军，将赏一百两银子
援军募人能入城送启者，鄱阳世子嗣左右李朗请先受鞭，诈为得罪，叛投贼，因得入城，城中方知援兵四集，举成鼓噪	皇太子亲自走到太极殿的前面，乘着西北风放出纸鸢，贼兵见了觉得奇怪，以为这是一种能以诅咒制服人的巫术用品，就把它射了下来，援军那一边也在招募能进入都城呈送文书的人，鄱阳王嫡长子萧嗣身边的下属李朗主动请求先打自己一顿鞭子，然后假装得罪了上司，叛逃到贼兵那里，因此得到机会进入城中，城中的军民这才知道援军已经聚集在周围，全城上下高兴得又是擂鼓又是呐喊
上以朗为直将军，赐金遣之	梁武帝任命李朗为直将军，赏赐他金银后又派他出城
朗缘钟山之后，宵行昼伏，积日乃达	李朗沿着钟山的后面，晚上行走白天潜伏，几天之后才到达援军的营垒
王显贵以寿阳降东魏	王显贵率领寿阳军民投降了东魏
东魏河内民四千馀家，以魏北徐州刺史司马裔，其乡里也，相帅归之	东魏河内地区有四千多家百姓，因为西魏的北徐州刺史司马裔是他们的同乡，所以都相互领着归附了他
丞相泰欲封裔，裔固辞曰：士大夫远归皇化，裔岂能帅之	丞相宇文泰想要授司马裔爵位，司马裔坚决推辞，说：读书人远道而来归附到皇上的政令、教化所能达到的地方，我司马裔哪里能够率领他们
卖义士以求荣，非所愿也	出卖忠义之士以追求荣华富贵，不是我愿意做的事情
初，上以河东王誉为湘州刺史，徙湘州刺史张缵为雍州刺史，代岳阳王	当初，梁武帝任河东王萧誉为湘州刺史，调湘州刺史张缵任雍州刺史，取代岳阳王萧
缵恃其才望，轻誉少年，迎候有阙	张缵依仗自己有一定的才能与名望，轻视萧誉年轻，在迎候对方时缺少应有的礼节
誉至，检括州府付度事，留缵不遣；闻侯景作乱，颇陵蹙缵	萧誉在到任之后，检查州府的交接事宜，留下了张缵没有让他走；他听到侯景犯上作乱的消息后，便常欺侮逼迫张缵
缵恐为所害，轻舟夜遁，将之雍部，复虑拒之	张缵害怕自己被萧誉害死，于是乘上轻捷的小船趁着夜色逃跑了，将要到达雍州时，他又担心萧会拒绝接受他
缵与湘东王绎有旧，欲因之以杀誉兄弟，乃如江陵	张缵与湘东王萧绎过去有交情，便想通过他来杀掉萧誉兄弟，于是来到了江陵
及台城陷，诸王各还州镇，誉自湖口归湘州	等到台城陷落后，藩王们都回到各自镇守的州郡，萧誉也从湖口返回了湘州
桂阳王以荆州督府留军江陵，欲待绎至拜谒，乃还信州	桂阳王萧因为荆州都督府的部队留在江陵，准备等萧绎来了之后，拜见了他，再回到信州
缵遗绎书曰：河东戴樯上水，欲袭江陵，岳阳在雍，共谋不逞	张缵送了一封书信给萧绎，说：河东王和部队乘着挂帆的船只向上游开来，准备袭击江陵，岳阳王在岳州，他们两人一同密谋起事
江陵游军主朱荣亦遣使告绎云：桂阳留此，欲应誉、	江陵的机动部队将领朱荣也派人告诉萧绎说：桂阳王留在这里，是准备响应萧誉、萧
绎惧，凿船，沉米，斩缆，自蛮中步道驰归江陵，囚，杀之	萧绎很害怕，下令凿沉船只，将大米沉到江底，又砍断了缆绳，从蛮人地区的陆路上骑马赶回江陵，把萧囚禁起来，接着又杀掉了他
湘潭侯退与北兖州刺史定襄侯祗出奔东魏	湘潭侯萧退与北兖州刺史、定襄侯萧祗逃出来投奔了东魏
侯景以萧弄璋为北兖州刺史，州民发兵拒之；景遣真阁将军羊海将兵助之，海以其众降东魏，东魏遂据淮阴	侯景任命萧弄璋为北兖州刺史，该州的百姓组成队伍将他挡在城外；侯景派遣直阁将军羊海统率部队前来相助，羊海却带领自己的人马投降了东魏，东魏于是占据了淮阴
祗，伟之子也	萧祗是萧伟的儿子
癸未，侯景遣于子悦等将羸兵数百东略吴郡	癸未，侯景派遣于子悦等人率领几百名疲弱的士兵去东方强夺吴郡
新城戍主戴僧逖有精甲五千，说太守袁君正曰：贼今乏食，台中所得，不支一旬，若闭关拒守，立可饿死	新城县的戍卒主将戴僧逖拥有五千名精锐士兵，他劝太守袁君正道：贼兵现在缺乏粮食，他们从台中所得到的不够支持十天，如果我们闭关防守，抗拒他们，他们马上就会饿死
土豪陆映公恐不能胜而资产被掠，皆劝君正迎之	当地豪强陆映公害怕不能取得胜利，自己的资产遭到掠夺，便和其他人一道劝说袁君正去迎候于子悦
君正素怯，载米及牛酒郊迎	袁君正一向怯懦无能，于是就载着米、牛、酒到郊外迎接
子悦执君正，掠夺财物、子女，东人皆立堡拒之	于子悦扣押了袁君正，大肆掠夺该城百姓的财产、子女，东部的人都建起城堡抵抗他
景又以任约为南道行台，镇姑孰	侯景又任命任约为南道行台，镇守姑孰
夏，四月，湘东世子方等至江陵，湘东王绎始知台城不守，命于江陵四旁七里树木为栅，掘堑三重而守之	夏季，四月，湘东王的嫡长子萧方等来到江陵，湘东王萧绎这才知道城已经陷落，就下令砍伐江陵周围七里之内的树木设立栅栏，又挖掘三道壕沟进行防守
甲辰，东魏进大将军勃海王澄位相国，封齐王，加殊礼	甲辰，东魏晋升大将军、勃海王高澄为相国，并加封他为齐王，给予他特殊的礼遇
丁未，澄入朝于邺，固辞；不许	丁未，高澄来到邺城朝拜孝静帝，坚决推辞，但是孝静帝没有同意
澄召将佐密议之，皆劝澄宜膺朝命；独散骑常侍陈元康以为未可，澄由是嫌之，崔暹乃荐陆无规为大行台郎以分元康之权	商澄召集手下的将领及其他辅佐官员秘密商议此事，大家都劝高澄应该接受朝廷的任命；唯独散骑常侍陈元康认为不可以这么做，高澄从此开始嫌恶他，崔暹就推荐陆元规出任大行台郎，以分陈元康之权
荆州长史王冲等上笺于湘东王绎，请以太尉、都督中外诸军事承制主盟；绎不许	荆州长史王冲等人向湘东王萧绎呈上书信，请他以太尉、都督中外诸军事的身份，秉承皇帝的意志，出任由各位藩王组成的联盟的盟主，萧绎没有答应
丙辰，又请以司空主盟；亦不许	丙辰，他们又请他以司空的身份出任盟主，萧绎也没有同意
东魏高岳既失慕容绍宗等，志气沮丧，不敢复逼长社城	东魏的高岳失去了慕容绍宗等人以后，变得沮丧失去斗志，不敢再进攻长社城
陈元康言于大将军澄曰：王自辅政以来，未有殊功，虽破侯景，本非外贼	陈元康对大将军高澄说道：大王您自从辅佐皇上执政以来，还没有建立突出的功勋，虽然曾经打败过侯景，但是他本来就不是外贼
今颖川垂陷，愿王自以为功	现在颖川快要陷落，希望大王您亲自去建立这一功业
澄从之	高澄采纳了这一建议
戊寅，自将步骑十万攻长社，亲临作堰，堰三决，澄怒，推负土者及囊并塞之	戊寅，高澄自己率领步兵与骑兵共十万人攻打长社城，还亲自督造拦河堰，拦河堰三次决口，高澄大为恼怒，把背土的人以及袋子一齐推下去堵塞缺口
壬午，梁简文帝颁下诏书，指明凡是在南朝当奴婢的北方人，都免去他们的奴隶身份，被免的人数以万计；侯景对他们中的有些人还大提拔，希望能笼络他们	魏诏：太和中代人改姓者皆复其旧
西魏文帝颁下诏书：太和年间代郡人改姓的都恢复的姓氏	六月，丙戌，以南康王会理为侍中、司空
六月，丙戍，梁朝任命南康王萧会理为侍中、司空	丁亥，立宣城王大器为皇太子
侯景任命赵威方为豫章太守，江州刺史寻阳王萧大心派部队进行抵抗，活捉了赵威方，把他关在该州的监狱里，后来赵威方又逃回了建康	湘东世子方等军至麻溪，河东王誉将七千人击之，方等军败，溺死
湘东王的嫡长子萧方等的部队到达麻溪时，河东王萧誉率领七千人马攻击他，萧方等的部队遭到了失败，他本人淹死	西江督护陈霸先欲起兵讨侯景，景使人诱广州刺史元景仲，许奉以为主，景仲由是附景，阴图霸先
安南侯萧方矩收拾剩余的人马返回江陵，湘东王萧绎没有任何悲戚的表情	霸先知之，与成州刺史王怀明等集兵南海，驰檄以讨景仲曰：元景仲与贼合从，朝廷遣曲阳侯勃为刺史，军已顿朝亭
萧绎宠爱的姬妾王氏，生下了儿子萧方诸	景仲所部闻之，皆弃景仲而散
王氏去世，萧绎疑心是徐妃下毒杀害的，逼迫徐妃自杀，徐妃就投井而死	秋，七月，甲寅，景仲缢于下
萧绎用对庶人的礼仪埋葬了徐妃，不让儿子们为她穿丧服	霸先迎定州刺史萧勃镇广州
陆缉等人竞相掠夺，制造暴行，吴郡一带的百姓都不归附他们，宋子仙从钱塘率领部队调头对他们发起了攻击	庚午，以南康王会理兼尚书令
壬戌，陆缉放弃郡城逃到海盐，	
侯景任命宋子仙为司徒，郭子建为尚书左仆射，与领军任约等四十个人一起任开府仪同三司，还下达诏书：从今以后开府仪同不必再增加将军名号	鄱阳王范自枞阳遣信告江州刺史寻阳王大心，大心遣信邀之
此后开府仪同多得数不胜数	范引兵诣江州，大心以湓城处之
吴兴兵员少力量弱，张嵊是一介书生，不熟习军中事务；有人劝张嵊仿效袁君正，也率领全郡军民迎接侯子鉴	河东王誉告急于岳阳王，留谘议参军济阳蔡大宝守襄阳，帅众二万、骑二千伐江陵以救湘州
张嵊叹道：袁家世世代代都以忠贞著称，没想到这名声被袁君正毁于一旦	湘东王绎大惧，遣左右就狱中问计于王僧辩，僧辩具陈方略，绎乃赦之，以为城中都督
我难道不知道吴郡陷落之后，吴兴也就势必难以长久保全的道理吗	乙卯，至江陵，作十三营以攻之；会大雨，平地水深四尺，军气沮
只是我既然已经把一切都献给了国家，那么我就只能选择这么一条死路罢了	绎与新兴太守杜有旧，密邀之
九月，癸丑朔，侯子鉴的部队到达吴兴，张嵊迎战失败，返回府中，空戴整齐然后安然坐着，侯子鉴将他捉信，押送到建康	乙丑，与兄岌、岸、弟幼安、兄子龛各帅所部降于绎
侯景赞许张嵊能够守节，想保全他的性命	岸请以五百骑袭襄阳，昼夜兼行；去襄阳三十里，城中觉之，蔡大宝奉察母龚保林登城拒战
张嵊却说道：我有愧于担任吴兴郡守，在朝廷危亡之际，不能进行挽救，使之转危为安，今天我只求马上死，也算是一件幸事	闻之，夜遁，弃粮食、金帛、铠仗于水，不可胜纪
侯景还想留下他的一个儿子，张嵊说道：我们一家人都已经上了鬼藉，我才不会向你胡虏乞求恩惠呢	张缵病足，载以随军；及败走，守者恐为追兵所及，杀之，弃尸而去
侯景听了大为恼怒，杀光了他全家老小，并且还杀掉了沈浚	至襄阳，岸奔广平，依春兄南阳太守
十一月，乙卯，梁武帝被安葬在陵，庙号高祖	百济遣使人贡，见城关荒圮，异于来，哭于端门；侯景怒，录送庄严寺，不听出
百济派遣使者来到建康进贡，使者看到城关已经荒废毁坏，同以前大不一样，就在端门前哭了起来；侯景闻讯后大怒，扣留了使者，把他押送到庄严寺，不让他出城	壬戌，宋子仙急攻钱塘，戴僧逖降之
宋子仙乘胜渡过浙江，到达会稽	魏杨忠将至义阳，太守马伯符以下城降之，忠以伯符为乡导
邵陵王萧纶听说钱塘的部队已经失败，就出逃至鄱阳，鄱阳内史、开建侯萧蕃带兵拒绝萧纶入城，萧纶进军攻击萧蕃，打败了对方	伯符，岫之子也
乙酉，东魏任命并州刺史彭乐为司徒	邵陵王纶进至九江，寻阳王大心以江州让之，纶不受，引兵西上
戊辰，东魏晋升太原公高洋为丞相、都督中外诸军、录尚书事、大行台、齐郡王	庚午，邵陵王纶至江夏，郢州刺史南康王恪郊迎，以州让之，纶不受；乃推纶为假黄钺铖，都督中外诸军事，承制置百官
二月，西魏杨忠乘胜率兵抵达石城，意欲进逼江陵	宕昌王梁弥定为其宗人獠甘所袭，弥定奔魏，獠甘自立
湘东王萧绎派舍人庾恪去劝说杨忠，说：萧目无尊长，竟然进攻叔父，而魏国帮助他，这怎么能使天下归心	羌酋傍乞铁匆据渠株川，与渭州民郑五h合诸羌以叛魏
杨忠听了，就停兵于3379北	丞相泰使大将军宇文贵、凉州刺史史宁讨之，擒斩铁匆、五h
萧绎派舍人王孝祀送儿子萧方略为人质以求和，西魏人答应了	宁别击獠甘，破之，獠甘将百骑奔生羌巩廉玉
萧绎与杨忠订立盟约，约定魏国以石城为封疆，梁国以安陆为国界，请求按照附庸关系，互送儿子为人质，发展贸易以通有无，永远作为邻邦和睦相处	宁复纳弥定于宕昌，置岷州于渠株川，进击巩廉玉，斩獠甘，虏廉玉送长安
丙戌，侯景任命安陆王侯大春为东扬州刺史，裁省吴州	乙巳，以尚书仆射王克为左仆身
乙巳，侯景任命尚书仆射王克为左仆射	庚寅，东魏以尚书令高隆之为太保
庚寅，东魏任命尚书令高隆之为太保	宣城内史杨白华进据安吴，侯景遣于子悦帅众攻之，不克
侯景娶简文帝的女儿溧阳公主，非常喜爱她	庚申，东魏进丞相洋爵为齐王
三月，甲申，	
西魏封皇子元儒为燕王，元公为吴王	侯景召宋子仙还京口
丙辰，侯景任命元思虔为东道大行台，镇守钱唐	东魏齐王洋之为开府也，勃海高德政为管记，由是亲昵，言无不尽，金紫光禄大夫丹杨徐之才、北平太守广宗宋景业，皆善图谶，以为太岁在午，当有革命，因德政以白洋，劝之受禅
丁巳，任命侯子鉴为南兖州刺史	洋以告娄太妃，太妃曰：汝父如龙，兄如虎，犹以天位不可妄据，终身北面，汝独何人，欲行舜、禹之事乎
	洋以告之才，之才曰：正为不及
六月，辛巳，梁朝任命南郡王萧大连掌管扬州政事	江夏王大款、山阳王大成、宜都王大封自信安间道奔江陵
江夏王萧大款、山阳王萧大成、宜都王萧大封从信安抄小路投奔江陵	齐主封宗室高岳等十人、功臣库狄干等七人皆为王
	癸未，封弟浚
鄱阳王萧范死了以后，侯去依附庄铁，庄铁对他心怀猜忌，侯心里不安稳，丙戌，假称约庄铁一块商量事情，乘机杀害了他，自己占据了豫章	寻阳王大心遣徐嗣徽夜袭湓城，安南侯恬、裴之横等击走之
侯景任命羊鸦仁为五兵尚书	魏人欲令岳阳王发哀嗣位，辞，不受
庚子，羊鸦仁出奔到江西，将奔赴江陵，走到东莞时，强盗怀疑他带着重金，拦击把他杀死	丞相泰使荣权册命为梁王，始建台，置百官
湘东王萧绎把宜都改为宜州，派王琳当刺史	是月，以南郡王大连为江州刺史
西魏丞相宇文泰因为北齐国主高洋称帝，就率各路人马去征讨他	益州沙门孙天英帅徒数千人夜攻州城，武陵王纪与战，斩之
西魏命令齐王元廓镇守陇右，征召秦州刺史宇文导为大	
王僧辩的部队抵达鹦鹉洲，郢州司马刘龙虎等偷偷地送人质到王僧辩那儿以表示友好，邵陵王萧纶听到此事，派他的儿子威正侯萧3390率兵去攻打他们，刘龙虎兵败，逃到王僧辩那儿	湘东王绎改封皇子大款为临川王，大成为桂阳王，大封为汝南王
萧纶写信责备王僧辩，信里说：将军前年杀了人家的侄儿萧誉，今后又讨伐人家的兄长，这样去邀功求荣，恐怕天下之	
湘东王萧绎改封皇子萧大款为临川王，萧大成为桂阳王，萧大封为汝南王	癸亥，魏军至潼关
癸亥，西魏军队进至潼关	庚午，齐主如晋阳，命太子殷居凉风堂监国
裴之高率领子弟部属一千余人行进到夏首，湘东王萧绎如见他，任命他为新兴，永宁二郡太守	初，邵陵王纶以衡阳王献为齐州刺史，镇齐昌，任约击擒之，送建康，杀之
又任命南平王萧恪为武州刺史，镇守武陵	献，畅之孙也
乙亥，晋升侯景位居相国，封二十郡，为汉王，给以特殊礼遇	岳阳王还襄阳
武陵王萧纪派潼州刺史杨乾运、南梁州刺史谯淹两人合兵二万去讨伐杨法琛，杨法琛派兵占据剑阁以抵抗他们	侯景还建康
北齐国主高洋命令散骑侍郎宋景业制定《天保历》，并颁布实行	春，正月，新吴余孝顷举兵拒侯景，景遣于庆攻之，不克
庚戌，湘东王萧绎派护军将军尹悦、安东将军杜幼安、巴州刺史王率兵二万从江夏急行军去武昌，接受徐文盛指挥	杨乾运攻拔剑阁，杨法昌退保石门，乾运据南阴平
杨乾运攻下了剑阁，杨法琛退却守卫石门，杨乾运进据南阴平	辛亥，齐主祀圜丘
张彪派他的部将赵棱包围钱塘，孙凤包围富春，侯景派仪同三司田迁、赵伯超去救援，赵棱、孙凤兵败逃跑	癸亥，齐主耕藉田
赵棱，是赵伯超哥哥的儿子	乙丑，享太庙
癸亥，北齐国主高洋去藉田举行耕种仪式	魏杨忠围汝南，李素战死
乙丑，祭祀太庙	二月，乙亥，城陷，执邵陵携王纶，杀之，投尸江岸；岳阳王取而葬之
三月，丙午，齐国襄城王萧去世	庚戌，魏文帝殂，太子钦立
庚戌，西魏文帝元宝炬去世，太子元钦立为皇帝	乙卯，徐文盛等克武昌，进军芦洲
乙卯，徐文盛等攻克武昌，进军芦州	己未，齐以湘东王绎为梁相国，建梁台，总百揆，承制
己未，北齐任命湘东王萧绎为梁国的相国，设置梁国台省，总领百官，秉承皇帝的命令办事	齐司空司马子如自求封王，齐主怒，庚子，免子如官
九月，癸巳，北齐国主高洋到赵州、定州去巡视，接着又到晋阳去巡视	己亥，湘东王绎以尚书令王僧辩为江州刺史，江州刺史陈霸先为东扬州刺史
侯景的军队逼近江陵的时候，湘东王萧绎向西魏求援，命令梁、秦二州刺史宜丰侯萧循把南郑城割让给西魏，把萧循召回江陵	司空、东道行台刘神茂闻侯景自巴丘败还，阴谋叛景，吴中士大夫咸劝之；乃与仪同三司尹思合、刘归义、王晔、云麾将军元等据东阳以应江陵，遣及别将李占下据建德江口
萧循因为无缘无故献出城池，不符合忠臣的节义，就向上报告说：请让我等待一下，我要求修改成命	张彪攻永嘉，克之
西魏太师宇文泰派遣大将军达奚武率领三万军队去打汉中，又派大将军王雄兵发子午谷攻打上津	新安民程灵洗起兵据郡以应神茂
萧循派记室参军沛人刘向武陵王萧纪求援，萧纪派潼州刺史杨乾运去救援他	于是浙江以东皆附江陵
萧循是萧恢的儿子	湘东王绎以灵洗为谯州刺史，领新安太守
壬辰，湘东王任命长沙王萧韶为郢州刺史	益州长史刘孝胜等劝武陵王纪称帝，纪虽未许，而大造乘舆车服
益州长史刘孝胜等劝武陵王萧纪称帝，萧纪虽然口头上还未允许，但却开始大举制造御用的乘舆车服等	十二月，丁未，谢答仁、李庆绪攻建德，擒元、李占送建康，景截其手足以徇，经日乃死
丙申，北齐国主高洋讨伐库莫奚，大获全胜，俘虏了四千人，缴获各种牲畜十几万头	魏将王雄取上津、魏兴，东梁州刺史安康李迁哲军败，降之
夏季，四月，北齐国主高洋派大都督潘乐与郭元建带兵五万人攻打阳平，并加以占领	王僧辩启陈霸先镇京口
五月庚午，司空南平王萧恪等人又劝萧绎即帝位，湘东王萧绎还是不接受，派侍中丰城侯萧泰去拜谒祖先陵墓，重新修复宗庙神社	丙戌，齐合州刺史斛斯昭攻历阳，拔之
丙戌，北齐的合州刺吏斛斯昭攻打历阳，攻克了它	丁亥，下令，以王伟等既死，自馀衣冠旧贵，被逼偷生，猛士勋豪，和光苟免者，皆不问
庚寅，萧绎立安南侯萧方矩为王太子	齐遣散骑常侍谢季卿来贺平侯景
北齐派散骑常侍谢季卿来祝贺平定侯景之乱的胜利	衡州刺史王怀明作乱，广州刺史萧勃讨平之
梁元帝任命吏部尚书王褒为左仆射	己丑，齐改铸钱，文曰常平五铢
六月，壬辰，武陵王萧纪修筑互相连接的城垒，攻断了拦江的铁锁，陆法和连连向江陵告急	甲辰，齐章武景王库狄干卒
元帝又把	
契丹族在北齐边境虏掠	齐主使郭元建治水军二万余人于合肥，将袭建康，纳湘潭侯退，又遣将军邢景远、步大汗萨帅众继之
壬午，北齐国主高洋到北方巡视冀州、定州、幽州、安州，于是决定讨伐契丹	陈霸先在建康闻之，白上；上诏王僧辩镇姑孰以御之
十一月，戊戌，元帝任命尚书右仆射王褒为左仆射，湘东太守张绾为右仆射	己未，突厥复攻柔然，柔然举国奔齐
三月丁亥，长沙王萧韶攻取了巴郡	甲辰，以王僧辩为太尉、车骑大将军
甲辰，元帝任命王僧辩为太尉、车骑大将军	丁未，齐将王球攻宿预，杜僧明出击，大破之，球归彭城
己酉，西魏派侍中宇文仁恕出使梁朝	柔然可汗庵罗辰叛齐，齐主自将出击，大破之，庵罗辰父子北走
刚好北齐的使者也到了江陵，元帝对宇文仁恕的接待不如对北齐使者那样隆重，宇文仁恕回国后，把这事告诉了太师宇文泰	太保安定王贺拔仁献马不甚骏，齐主拔其发，免为庶人，输晋阳负炭
元帝又要求按过去的版图来划定边境	
丙寅，元帝派散骑常侍庚信等到西魏聘问	癸酉，以陈霸先为司空
癸酉，梁朝任命陈霸先为司空	丁未，齐主复自击柔然，大破之
丁未，北齐国主高洋又一次亲自进攻柔然，大获全胜	庚戌，魏太师泰鸩杀废帝
邓至羌人檐失去政权，投奔西魏，太师宇文泰派秦州刺史宇文导带兵接纳了他	齐段韶还至宿预，使辩士说东方白额，白额开门请盟，因执而斩之
秋季，七月，庚戌，北齐国主高洋回到邺城	魏太师泰西巡，至原州
西魏太师宇文泰到西边巡视，到达原州	八月，壬辰，齐以司州牧清河王岳为太保，司空尉粲为司徒，太子太师侯莫陈相为司空，尚书令平阳王淹录尚书事，常山王演为尚书令，中书令上党王涣为左仆射
西魏宇文泰命令侍中崔猷开山填谷，修通通往汉中的车路	帝好玄谈，辛卯，于龙光殿讲《老子》
梁元帝萧绎喜好玄谈，辛卯，在龙光殿开设讲座，讲论《老子》	曲江侯勃迁居始兴，王琳使副将孙先行据番禺
西魏任命右仆射申徽为襄州刺史	侯平攻后梁巴、武二州，故刘主帅赵朗杀宋文彻，以邵陵归于王琳
丙申，北齐国主高洋回到邺城，封文襄帝的两个儿子高孝珩为广宁王，高延宗为安德王	孙闻江陵陷，弃广州还，曲江侯勃复据有之
十二月，癸丑，侯安都袭击秦郡，攻破徐嗣徽的营栅，俘获了好几百人	交州刺史刘元偃帅其属数千人归王琳
又抄了他的家产，搜得他用的琵琶和养的鹰，派人送给徐嗣徽，并说	
交州刺史刘元偃率领部属几千人去投奔王琳	魏以侍中李远为尚书左仆射
春季，正月，丁丑，西魏开始建立实行文官之制，任命宇文泰为太师、大冢宰，柱国李弼为太傅、大司徒，赵贵为太保、大宗伯，独孤信为大司马，于谨为大司寇，侯莫陈崇为大司空	戊寅，大赦，其与任约、徐嗣徽同谋者，一无所问
其余百官的设置任命，都模仿《周礼》	癸未，陈霸先使从事中郎江旰说徐嗣徽使南归，嗣徽执旰送齐
乙丑，北齐仪同三司娄讨伐鲁阳蛮，打败了他们	侯安都轻兵袭齐行台司马恭于历阳，大破之，俘获万计
己亥，北齐大赦天下	魏太师泰遣安州长史钳耳康买使于王琳，琳遣长史席豁报之，且请归世祖及愍怀太子之柩；泰许之
西魏太师宇文泰派安州长史钳耳康买为使者去王琳那儿出使，王琳派长史席豁到西魏回访，而且恳求西魏把梁元帝萧绎和愍怀太子萧元良的灵柩送回南方	八月，己酉，鄱阳王循卒于江夏，弟丰城侯泰监郢州事
宇文泰答应了这一恳求	王琳使兖州刺史吴藏攻江夏，不克而死
西魏太师宇文泰北渡黄河	魏以王琳为大将军、长沙郡公
北齐下诏划分江西四郡为一个州，即高州，任命明威将军黄法氍为刺史，镇守巴山	十二月，壬申，以曲江侯勃为太保
北齐从西河总秦戍一带开始修筑长城，向东一直延伸到大海边，前前后后修筑的长城东西总共有三千多里长，大抵十里就设立一个戍卫点，凡是军事上的险要之地就建立州镇，总共有二十五处	魏宇文护以周公幼弱，欲早使正位以定人心，庚子，以魏恭帝诏禅位于周，使大宗伯赵贵持节奉册，济北公迪致皇帝玺绂；恭帝出居大司马府
甲午，北周任命于谨为太傅，大宗伯侯莫陈崇为太保，晋公宇文护为大冢宰，柱国武川人贺兰祥为大司马，高阳公达奚武为大司寇	周人杀魏恭帝
北周晋公宇文护因为赵景公独孤信名望很大，不愿公开杀他，己酉，逼迫他自杀	甲辰，以司空王琳为湘、郢二州刺史
夏季，四月，己卯，梁朝铸造四柱钱，一枚当细钱二十枚	齐遣使请和
北齐派使者来梁朝请求和好	壬午，周王谒成陵；乙酉，还宫
壬午，周王拜谒成陵	齐以太师斛律金为右丞相，前大将军可朱浑道元为太傅，开府仪同三司贺拔仁为太保，尚书令常山王演为司空，录尚书事长广王湛为尚书令，右仆射杨为左仆射，仍加开府仪同三司
乙酉，回到宫中	并省尚书右仆射崔暹为左仆射，上党王涣录尚书事
北齐任命太师斛律金为右丞相，前大将军可朱浑道元为太傅，开府仪同三司贺拔仁为太保，尚书令常山王高演为司空，录尚书事长广王高湛为尚书令，右仆射杨为左仆射，仍加开府仪同三司，并州行台尚书右仆射崔暹为左仆射，上党王高涣为录尚书事	丁亥，周王享太庙
丁亥，周王祭拜太庙	壬辰，改四柱钱一当十；丙申，复闭细钱
五月，戊辰，余孝顷派使者到丞相府乞求投降	王琳既不就征，大治舟舰，将攻陈霸先；六月，戊寅，霸先以开府仪同三司侯安都为西道都督，周文育为南道都督，将舟师二万会武昌以击之
八月，丁卯，北周把梁元帝的灵柩和诸将家属一千多人送还给王琳	戊辰，周王祭太社
丙子，陈武帝驾临钟山，祭祀蒋帝庙	辛巳，追尊皇考文赞为景皇帝，庙号太祖，皇妣董氏曰安皇后，追立前夫人钱氏为昭皇后，世子克为孝怀太子，立夫人章氏为皇后
庚辰，武帝从杜姥宅请出佛牙，设无遮大会，举办佛事，武帝亲自出来到宫阙前顶礼膜拜	章后，乌程人也
陈朝设置删定郎，负责修订法律条令	乙酉，周王祀圜丘；丙戌，祀方丘；甲午，祭太社
乙酉，在太社祭祀土神和谷神	戌子，太祖神主太庙，七庙始共用一太牢，始祖荐首，余皆骨体
十一月丙申，陈武帝立其兄的儿子陈为临川王，陈顼为始兴王，其弟的儿子陈昙朗已经死去，但武帝还不知道，立他为康王	庚子，周王享太庙；丁未，祀圜丘；十二月，庚午，谒成陵；癸酉，还宫
陈朝任命开府仪同三司侯为司空；衡州刺史欧阳为都督交、广等十九州诸军事，广州刺史	周以晋公护为太师
北周任命晋公宇文护为太师	辛丑，上祀南郊，大赦；乙巳，祀北郊
辛亥，周王去藉田，举行耕种仪式	癸丑，周立王后独孤氏
癸丑，北周册立独孤氏为王后	戊午，上祀明堂
戊午，陈武帝祭祀明堂	二月，壬申，南豫州刺史沈泰奔齐
夏季，四月，甲子，陈武帝向太庙供献祭品	乙丑，上使人害梁敬帝，立梁武林侯谘之子季卿为江阴王
乙丑，陈武帝派人杀害了梁敬帝，立梁朝武林侯萧谘的儿子萧季卿为江阴王	己巳，周以太师护为雍州牧
己巳，北周任命太师宇文护为雍州牧	甲戌，周王后独孤氏殂
甲戌，周王王后独孤氏去世	辛巳，齐大赦
辛巳，北齐大赦天下	齐主以旱祈雨于西门豹祠，不应，毁之，并掘其冢
北周任命大司空侯莫陈崇为大宗伯	癸丑，齐广陵南城主张显和、长史张僧那各帅所部来降
辛酉，陈武帝驾临大庄严寺向佛祖舍身	六月，乙丑，齐主北巡，以太子殷监国，因立大都督府与尚书省分理众务，仍开府置佐
壬戌，群臣上表请皇上回宫	齐主特崇其选，以赵郡王睿为侍中、摄大都督府长史
己巳，陈武帝下诏命令司空侯与领军将军徐度率领水师为前头部队去讨伐王琳	齐主至祁连池；戊寅，还晋阳
八月，甲子，北周大赦天下	乙丑，齐主还邺
乙丑，北齐文宣帝回到邺城	辛未，诏临川王西讨，以舟师五万发建康，上幸冶城寺送之
辛未，陈武帝下诏派临川王陈出兵向西讨伐，共有水军五万人从建康出发，陈武帝亲临冶城寺为陈送行	甲戌，齐主如晋阳
北齐文宣帝去晋阳	王琳在白水浦，周文育、侯安都、徐敬成许王子晋以厚赂，子晋乃伪以小船依而钓，夜，载之上岸，入深草中，步投陈军，还建康自劾；上引见，并宥之，戊寅，复其本官
九月，甲申，北周封少师元罗为韩国公以继承西魏的香火	丁未，周王如同州；冬，十月，辛酉，还长安
十二月，戊寅，北齐任命可朱浑道元为太师，尉粲为太尉冀州刺史段韶为司空，常山王高演为大司马，长广王高湛为司徒	壬午，周大赦
壬午，北周大赦天下	齐主如北城，因视永安简平王浚、上党刚肃王涣于地牢
	帝
春季，正月，己酉，北周太师宇文护上表表示把政权归还周王，周王开始亲理万机；但军事方面的事务，宇文护还是总揽着	王琳召桂州刺史淳于量
开始把都督州军事这一官职改称总管	量虽与琳合而潜通于陈；二月，辛酉，以量为开府仪同三司
三月，戊戌，北齐任命待中高德政为尚书右仆射	吐谷浑寇周边，庚戌，周遣大司马贺兰祥击之
闰四月，戊子，北周命令有关部门重新修订新历法	丁酉，遣镇北将军徐度将兵城南皖口
北齐文宣帝封儿子高绍廉为长乐王	辛亥，周以侯莫陈崇为大司徒，达奚武为大宗伯，武阳公豆卢宁为大司寇，柱国辅城公邕为大司空
辛亥，北周任命侯莫陈崇为大司徒，达奚武为大宗伯，武阳公豆卢宁为大司寇，柱国辅城公宇文邕为大司空	乙卯，周诏：有司无得纠赦前事；唯厩库仓廪与海内所共，若有侵盗，虽经赦宥免其罪，征备如法
乙卯，北周下诏，规定：有关部门不能再检举大赦以前的事；只有国家的车马库、粮仓、货栈是海内所共有的财产，如果有侵吞盗窃的人，虽然经过赦免宽大免去罪行，但必须让他依照规定缴纳钱粮作为赔偿	周驾兰祥与吐谷浑战，破之，拔其洮阳、洪和二城，以其地为洮州
北周贺兰祥与吐谷浑开战，打败了吐谷浑，攻取了其所属的洮阳、洪和两城，把这两个城的地方合并为洮州	五月，丙辰朔，日有食之
八月，甲申，陈朝葬陈武帝于万安陵，庙号为高祖	戊戌，齐封皇子绍义为广阳王；以尚书右仆射河间王孝琬为左仆射，都官尚书崔昂为右仆射
辛酉，陈朝立皇子陈伯宗为太子	己巳，齐主如晋阳
己巳，北齐国主去晋阳	辛未，周主封其弟辅城公邕为鲁公，安成公宪为齐公，纯为陈公，盛为越公，达为代公，通为冀公，为滕公
辛未，北周国主封他的弟弟辅城公宇文邕为鲁公，安成公宇文宪为齐公，宇文纯为陈公，宇文盛为越公，宇文达为代公，宇文通为冀公，宇文为滕公	乙亥，立太子母吴兴沈妃为皇后
乙亥，陈朝立太子陈伯宗的母亲吴兴人沈妃为皇后	周少保怀宁庄公蔡卒
北齐任命右丞相斛律金为丞相，常山王高演为太傅，长广王高湛为太尉，段韶为司徒，平原王高淹为司空，高阳王高为尚书左仆射，河间王高孝琬为司州牧，侍中燕子献为右仆射	辛未，齐显祖之丧至邺
辛未，北齐文宣帝的灵柩由晋阳移到邺城	十二月，戊戌，齐徙上党王绍仁为渔阳王，广阳王绍义为范阳王，长乐王绍广为陇西王
十二月，戊戌，北齐改封上党王高绍仁为渔阳王，广阳王高绍义为范阳王，长乐王高绍广为陇西王	春，正月，癸丑朔，大赦，改元
春季，正月，癸丑朔，陈朝大赦天下，改换年号为天嘉	齐大赦，改元乾明
北齐大赦天下，改换年号为乾明	辛酉，上祀南郊
辛未，陈文帝在北郊祭地	齐主自晋阳还至邺
北齐国主高殷从晋阳回到邺城	二月，乙未，高州刺史纪机自军所逃还宣城，据郡应王琳，泾令贺当迁讨平之
二月，乙未，高州刺史纪机从侯的军队里逃回宣城，占据了郡城呼应王琳，泾县县令贺当迁率兵讨平了他	齐葬文宣皇帝于武宁陵，庙号高祖，后改曰显祖
北齐把文宣帝葬在武宁陵，庙号为高祖，后来又改称显祖	戊戌，诏：衣冠士族、将帅战兵陷在王琳党中者，皆赦之，随材铨叙
戊戌，陈文帝下诏，说：不论是有身份的士族文官，还是将帅士兵，凡是陷进王琳一党里的，回来了都赦免其罪，按照他们的才能予以选拔任命	已亥，齐以常山王演为太师、录尚书事，以长广王湛为大司马、并省录尚书事，以尚书左仆射平秦王归彦为司空，赵郡王睿为尚书左仆射
已亥，北齐任命常山王高演为太师、录尚书事，任命长广王高湛为大司马、并省录尚书事，任命尚书左仆射平秦王高归彦为司空，赵郡王高睿为尚书左仆射	乙巳，以太尉侯都督湘、巴等五州诸军事，镇湓城
十一月，辛亥，北齐国主孝昭帝册立妃子元氏为皇后，世子高百年为太子	齐主自将击库莫奚，至天池，库莫奚出长城北遁
高百年这时才五岁	齐主分兵追击，获牛羊七万而还
孝昭帝自己带兵去进攻库莫奚，一直打到天池，库莫奚越过长城往北逃窜了，孝昭帝分兵几路，穷追猛打，缴获牛羊七万头，获胜归来	十二月，乙未，诏：自今孟春讫于夏首，大辟事已款者，宜且申停
庚戌，陈朝大赦天下	周主祀圜丘
北周国主在圜丘祭天	辛亥，齐主祀圜丘；壬子，于太庙
已巳，北周国主在太庙祭拜祖宗，按太祖所定的六官之法进行排列	辛未，周湘州城主殷亮降，湘州平
辛未，北周湘州城主殷亮投降陈国，湘州被平定	二月，甲午，周主朝日于东郊
二月，甲午，北周国主在东郊朝拜日神	周人以小司徒韦孝宽尝立勋于玉壁，乃置勋州于玉壁，以孝宽为刺史
北周因为小司徒韦孝宽曾在玉壁建立过功勋，于是就在玉壁设置勋州，任命韦孝宽为刺史	三月，乙卯，太尉零陵壮肃公侯卒
三月，乙卯，太尉零陵人壮肃公侯去世	丙寅，周改八丁兵为十二丁兵，率岁一月而役
丙寅，北周把境内原来分为八拨而轮番服役的民丁改分为十二拨，每拨每年服役一个月	夏，四月，丙子朔，日有食之
夏季，四月，丙子朔，发生日食	周以少傅尉迟纲为大司空
六月，乙酉，北周派御正殷不害来陈朝聘问	秋，七月，周更铸钱，文曰布泉，一当五，与五铢并行
秋季，七月，北周重新铸钱，钱币上的字是布泉，一枚当五枚小钱，与五铢钱一起流通	己酉，周追封皇伯父颢为邵国公，以晋公护之子会为嗣；颢弟连为杞国公，以章武公导之子亮为嗣；连弟洛生为莒国公，以护之子至为嗣；追封太祖之子武邑公震为宋公，以世宗之子实为嗣
冬季，十月，甲戌朔，发生日食	丙子，齐以彭城王为太保，长乐王尉粲为太尉
北周凉景公贺兰祥病逝	壬寅，周人凿河渠于蒲州，龙首渠于同州
壬寅，北周在蒲州开凿河渠，在同州开凿龙首渠	丁未，周以安成王顼为柱国大将军，遣杜杲送之南归
丁未，北周任命安成王陈顼为柱国大将军，派杜杲送他回南方	辛亥，上祀南郊，以胡公配天；二月，辛酉，祀北郊
梁朝末年政败国乱，铁钱不再流通	后梁主安于俭素，不好酒色，虽多猜忌，而抚将士有恩
民间私自流通着鹅眼钱	以封疆褊隘，邑居残毁，干戈日用，郁郁不得志，疽发背而殂；葬平陵，谥曰宣皇帝，庙号中宗
甲子，改铸五铢钱，一枚五铢钱可兑换十枚鹅眼钱	太子岿即皇帝位，改元天保；尊龚太后为太皇太后，王后曰皇太后，母曹贵嫔为皇太妃
三月，丙子，安成王陈顼到达建康，陈文帝下诏封他为中书监、中卫将军	丁丑，以安右将军吴明彻为江州刺史，督高州刺史黄法氍、豫章太守周敷共讨周迪
丁丑，陈朝任命安右将军吴明彻为江州刺史，指挥高州刺史黄法氍、豫章太守周敷一起去讨伐周迪	甲申，大赦
乙巳，北齐派使者到陈朝聘问	齐青州上言河水清，齐主遣使祭之，改元河清
五月，庚午，北周大赦天下	己丑，齐以右仆射斛律光为尚书令
癸亥，武成帝到了晋阳	上遣使聘齐
陈文帝派使者到齐国聘问	九月，戊辰朔，日有食之
陈朝任命侍中、都官尚书到仲举为尚书右仆射、丹杨尹	吴明彻至临川攻周迪，不能克
到仲举是到溉的弟弟的儿子	丁亥，诏安成王顼代之
十一月，丁卯，北周任命赵国公宇文招为益州总管	丁丑，齐遣兼散骑常侍封孝琰来聘
丁丑，北齐派兼散骑常侍封孝琰到陈朝聘问	十二月，丙辰，齐主还邺
北周武帝命令司宪大夫拓跋迪制定《大律》十五篇，规定对犯罪的惩罚：一是杖刑，杖十到五十下；二是鞭刑，鞭打六十到一百下；三是徒刑，刑期从一年到五年；四是流刑，流放二千五百里到四千五百里；五是死刑，分缢死、绞死、斩首、将首级悬挂示众、用车裂尸；一共分二十五等	庚戌，以司空南徐州刺史侯安都为江州刺史
三月，乙丑朔，出现日食	齐诏司空斛律光督步骑二万，筑勋掌城于轵关；仍筑长城二百里，置十二戍
北齐武成帝高湛诏令司空斛律光督带二万名步、骑兵，到轵关建造勋掌城，构筑了二百里的长城，设立十二个戌所	丙戌，齐以兼尚书右仆射赵彦深为左仆射
丙戌，北齐任命兼尚书右仆射赵彦深为左仆射	夏，四月，乙未，周以柱国达奚武为太保
秋季，七月，戊辰，北周武帝驾临原州	八月，辛丑，齐以三台宫为大兴圣寺
八月，辛丑，北齐把三台宫改为大兴圣寺	九月，壬戌，广州刺史阳山穆公欧阳卒，诏子纥袭父爵位
九月，壬戌，陈朝的广州刺史阳山穆公欧阳去世，下诏他的儿子欧阳纥承袭父亲的爵位	甲子，周主自原州登陇
甲子，北周武帝从原州登上陇坂	周迪复越东兴岭为寇，辛未，诏护军章昭达将兵讨之
陈朝因周迪又越过东兴岭侵犯，辛未，诏命护军章昭达率领军队去讨伐	丙戌，周主如同州
十二月，辛卯，北周武帝回长安	丙申，大赦
丙申，陈朝大赦全国	章昭达进军，度岭，趣建安，讨陈宝应，诏益州刺史余孝顷督会稽、东阳、临海、永嘉诸军自东道会之
陈朝的章昭达进军，经过东兴岭，向建安急进，讨伐陈宝应，文帝诏命益州刺史余孝顷督率会稽、东阳、临海、永嘉等地军队从东路来会合	是岁，初祭始兴昭烈王于建康，用天子礼
辛巳，陈文帝到南郊祭天	二月，庚寅朔，日有食之
夏季，四月，辛卯，北齐武成帝派兼散骑常侍皇甫亮来陈朝聘问	庚子，周主遣使来聘
壬辰，北齐武成帝去晋阳	周以太保达奚武为同州刺史
秋季，八月，丁亥朔，发生日食	周遣柱国杨忠会突厥伐齐，至北河而还
突厥从幽州返回，屯兵在塞北，进一步召集各部落的军队，派使者告诉北周，打算象以前所约定那样共同进攻北齐	周迪复出东兴，宣城太守钱肃镇东兴，以城降迪
闰月，乙巳，突厥入侵北齐幽州	吴州刺史陈详将兵击之，详兵大败，迪众复振
这一年，北齐的山东水灾，饿死的人数不胜数	宕昌王梁弥定屡寇周边，周大将军田弘讨灭之，以其地置宕州
宕昌王梁弥定屡次进犯北周的边界，北周的大将军田弘将他讨平，在那里设置宕州	春，正月，癸卯，齐以任城王为大司马
春季，正月，癸卯，北齐任命任城王高为大司马	齐主如晋阳
丙寅，北周任命柱国安武公李穆为大司空，绥德公陆通为大司寇	壬申，周主如岐州
壬申，北周国主去岐州	夏，四月，甲寅，以安成王顼为司空
夏季，四月，甲寅，陈朝任命安成王陈顼为司空	丙午，齐大将军东安王娄睿坐事免
五月，突厥派使者到北齐，开始和北齐联系	六月，乙巳，齐主使兼散骑常侍王季高来聘
六月，己巳，北齐国主派兼散骑常侍王季高来陈朝访问	秋，七月，辛巳朔，日有食之
庚寅，回长安	已卯，立皇子伯固为新安王，伯恭为晋安王，伯仁为庐陵王，伯义为江夏王
已卯，陈朝立皇子陈伯固为新安王，陈伯恭为晋安王，陈伯仁为庐陵王，陈伯义为江夏王	冬，十月，辛亥，周以函谷关城为通洛防，以金州刺史贺若敦为中州刺史，镇函谷
冬季，十月，辛亥，北周以函谷关的关城为通洛防，任命金州刺史贺若敦做中州刺史，镇守函谷	十一月，癸未，齐太上皇至邺
十二月，乙卯，陈朝封皇子陈伯礼为武陵王	壬戌，齐上皇如晋阳
壬戌，北齐太上皇武成帝去晋阳	庚午，齐改谥文宣皇帝为景烈皇帝，庙号威宗
春季，正月，已卯，出现日食	癸未，周大赦，改元天和
癸未，北周大赦全国，改年号为天和	辛卯，齐主祀圜丘；癸巳，袷太庙
辛卯，在太庙举行袷祀	丙申，齐以吏部尚书尉瑾为右仆射
丙申，北齐任命吏部尚书尉瑾为右仆射	已亥，周主耕藉田
已亥，北周国主在藉田举行耕种仪式	庚子，齐主如晋阳
庚子，北齐国主去晋阳	周遣小载师杜杲来聘
北周派小载师杜杲来陈朝聘问	二月，庚戌，齐上皇还邺
二月，庚戌，北齐太上皇武成帝回邺城	丙子，大赦，改元
丙子，陈朝大赦全国，改年号为天康	三月，已卯，以安成王顼为尚书令
癸酉，陈文帝去世	乙酉，齐以兼尚书左仆射武兴王普为尚书令
乙酉，北齐任命兼尚书左仆射武兴王高普为尚书令	吐谷浑龙涸王莫昌帅部落附于周，以其地为扶州
已亥，北齐立太上皇帝的儿子高弘为齐安王，高仁固为北平王，高仁英为高平王，高仁光为淮南王	六月，齐遣兼散骑常侍韦道儒来聘
六月，北齐派兼散骑常侍韦道儒来陈朝聘问	丙寅，葬文皇帝于永宁陵，庙号世祖
丙寅，陈朝把文帝葬在永宁陵，庙号世祖	秋，七月，戊寅，周筑武功等诸城以置军士
秋季，七月，戊寅，北周修筑武功等城池设置军队	丁酉，立妃王氏为皇后
丁酉，陈朝立妃子王氏为皇后	八月，齐上皇如晋阳
冬季，十月，北齐任命侯莫陈相为太傅，任城王高为太保，娄睿为大司马，冯翊王高润为太尉，开府仪同三司韩祖念为司徒	庚申，帝享太庙
庚申，陈废帝陈伯宗到太庙祭祀	十一月，乙亥，周遣使来吊
十一月，乙亥，北周派使者来陈朝吊丧	丙戌，周主行视武功等新城；十二月，庚申，还长安
这一年，北齐赐侍中、中书监元文遥姓高，不久，又升职为尚书左仆射	春，正月，癸酉朔，日有食之
春季，正月，癸酉朔，出现日食	尚书左仆射袁枢卒
陈朝尚书左仆射袁枢去世	乙亥，大赦，改元
乙亥，陈朝大赦天下，改年号为光大	辛卯，帝祀南郊
辛卯，陈废帝到南郊祭祀	壬辰，齐上皇还邺
壬辰，北齐太上皇回邺城	己亥，周主耕藉田
己亥，北周国主在藉田举行耕种仪式	二月，壬寅朔，齐主加元服，大赦
三月，甲午，陈朝任命尚书右仆射沈钦为侍中、左仆射	夏，四月，癸丑，齐遣散骑常侍司马幼之来聘
辛亥，北周国主向母亲叱奴氏上皇太后尊号	己未，齐封皇弟仁机为西河王，仁约为乐浪王，仁俭为颍川王，仁雅为安乐王，仁直为丹杨王，仁谦为乐海王
秋季，七月，戊申，陈朝立皇子陈至泽为太子	八月，齐以任城王为太师，冯翊王润为大司马，段韶为左丞相，贺拔仁为右丞相，侯莫陈相为太宰，娄睿为太傅，斛律光为太保，韩祖念为大将军，赵郡王睿为太尉，东平王俨为司徒
冬季，十月，甲申，陈废帝到太庙祭祀祖宗	十一月，戊戌朔，日有食之
十一月，戊戌朔，出现日食	丙午，齐大赦
丙午，北齐大赦全国	癸丑，周许穆公宇文贵自突厥还，卒于张掖
癸丑，北周许穆公宇文贵从突厥回朝，中途死在张掖	齐上皇还邺
北齐太上皇回邺城	十二月，周晋公护母卒，诏起，令视事
春季，正月，己亥，安成王陈顼进位太傅，领司徒，加特殊的礼遇	辛丑，周主祀南郊
辛丑，北周国主到南郊祭祀	癸亥，齐主使兼散骑常侍郑大护来聘
癸亥，北齐国主派兼散骑常侍郑大护来陈朝聘问	湘东忠肃公徐度卒
陈朝的湘东忠肃公徐度死	二月，丁卯，周主如武功
夏季，四月，辛巳，北周任命达奚武为太傅，尉迟迥为太保，齐公宇文宪为大司马	齐上皇如晋阳
庚戌，去醴泉宫	壬戌，齐上皇还邺
丙午，陈废帝到太庙祭祀行礼	戊午，周主还长安
戊午，北周国主回长安	壬戌，封皇弟伯智为永阳王，伯谋为桂阳王
壬戌，陈废帝封弟弟陈伯智为永阳王，陈伯谋为桂阳王	八月，齐请和于周，周遣军司马陆程聘于齐；九月，丙申，齐使侍中斛斯文略报之
八月，北齐向北周求和，北周派军司马陆程到北齐聘问；九月，丙申，北齐派侍中斛斯文略回聘	冬，十月，癸亥，周主享太庙
冬季，十月，癸亥，北周国主到太庙祭祀行礼	庚午，帝享太庙
庚午，陈废帝到太庙祭祀行礼	辛巳，齐以广宁王孝珩录尚书事，左仆射胡长仁为尚书令，右仆射和士开为左仆射，中书监唐邕为右仆射
辛巳，北齐任命广宁王高孝珩为录尚书事，左仆射胡长仁为尚书令，右仆射和士开为左仆射，中书监唐邕为右仆射	十一月，壬辰朔，日有食之
十一月，壬辰朔，发生日食	齐遣兼散骑常侍李谐来聘
北齐派兼散骑常侍李谐来陈朝聘问	甲辰，周主如岐阳
甲辰，北周国主去岐阳	周遣开府仪同三司崔彦等聘于齐
辛丑，陈宣帝到南郊祭天	壬寅，封皇子叔英为豫章王，叔坚为长沙王
壬寅，陈朝封皇子陈叔英为豫章王，陈叔坚为长沙王	戊午，上享太庙
二月，乙亥，陈宣帝到藉田举行耕种仪式	甲申，齐葬武成帝于永平陵，庙号世祖
甲申，北齐把武成帝葬在永平陵，庙号世祖	乙丑，齐徙东平王俨为琅邪王
己丑，北齐把东平王高俨迁移到琅邪郡为琅邪王	齐遣侍中叱列长叉聘于周
北齐派侍中叱列长叉到北周聘问	齐以司空徐显秀为太尉，并省尚书令娄定远为司空
五月，庚戌，北周国主去醴泉宫	丁巳，以吏部尚书徐陵为左仆射
丁巳，陈朝任命吏部尚书徐陵为左仆射	秋，七月，辛卯，皇太子纳妃沈氏，吏部尚书君理之女也
秋季，七月，辛卯，陈朝皇太子纳沈氏为妃，她是吏部尚书沈君理的女儿	辛亥，周主还长安
辛亥，北周国主回长安	八月，庚辰，盗杀周孔城防主，以其地入齐
壬午，陈宣帝到太庙祭祀	十一月，辛亥，周郐文公长孙俭卒
春季，正月，乙酉朔，北齐改年号为武平	齐东安王娄睿卒
北齐东安王娄睿去世	丙午，上享太庙
丙午，陈宣帝到太庙祭祀	戊申，齐使兼散骑常侍裴谳之来聘
三月，丙申，陈朝皇太后章氏去世	戊戌，齐安定武王贺拔仁卒
戊戌，北齐安定武王贺拔仁去世	丁未，大赦
丁未，陈朝大赦全国	夏，四月，甲寅，周以柱国宇文盛为大宗伯
夏季，四月，甲寅，北周任命柱国宇文盛为大宗伯	周主如醴泉宫
北周国主去醴泉宫	辛酉，齐以开府仪同三司徐之才为尚书左仆射
辛酉，北齐任命开府仪同三司徐之才为尚书左仆射	戊寅，葬武宣皇后于万安陵
戊寅，陈朝将武宣皇后葬在万安陵	闰月，戊申，上谒太庙
闰月，戊申，陈宣帝到太庙谒告行礼	五月，壬午，齐遣使来吊
五月，壬午，北齐派使者来陈朝吊唁武宣皇后	六月，乙酉，齐以广宁王孝珩为司空
乙卯，北周国主回长安	癸酉，齐以华山王凝为太傅
八月，辛卯，北齐国主去晋阳	九月，乙巳，齐立皇子恒为太子
九月，乙巳，北齐立皇子高恒为太子	冬，十月，辛巳朔，日有食之
乙酉，陈宣帝到太庙祭祀	己丑，齐复威宗谥曰文宣皇帝，庙号显祖
己丑，北齐恢复威宗的文宣皇帝谥号，庙号显祖	丁酉，周郑桓公达奚武卒
丁酉，北周的郑桓公达奚武去世	十二月，丁亥，齐主还邺
十二月，丁亥，北齐国主回邺城	周大将军郑恪将兵平越，置西宁州
春季，正月，乙丑，陈朝任命尚书右仆射徐陵为左仆射	丁巳，齐使兼散骑常侍刘环俊来聘
丁巳，北齐派兼散骑常侍刘环俊来陈朝聘问	辛酉，上祀南郊；辛未，祀北郊
二月，辛巳，到藉田举行耕种的仪式	壬寅，齐以兰陵王长恭为太尉，赵彦深为司空，和士开录尚书事，徐之才为尚书令，唐邕为左仆射，吏部尚书冯子琮为右仆射，仍摄选
壬寅，北齐任命兰陵王高长恭为太尉，赵彦深为司空，和士开为录尚书事，徐之才为尚书令，唐邕为左仆射，吏部尚书冯子琮为右仆射，仍旧执掌吏部对官吏的铨选	三月，丁丑，大赦
夏季，四月，戊寅朔，发生日食	壬午，齐以琅邪王俨为太保
壬午，北齐任命琅邪王高俨为太保	壬辰，齐遣使来聘
壬辰，北齐派使者来陈朝聘问	周陈公纯取齐宜阳等九城，齐斛律光将步骑五万赴之
北周陈公纯夺取北齐的宜阳等九座城池，北齐斛律光率领五万名步、骑兵赶到那里抵抗	五月，癸亥，周使纳言郑诩来聘
八月，己亥，北齐后主去晋阳	九月，辛亥，齐以任城王为太宰，冯翊王润为太师
壬午，北周冀公宇文通去世	甲申，上享太庙
甲申，陈宣帝到太庙祭祀祖先	乙未，周遣右武伯谷会琨等聘于齐
庚戌，北齐派侍中赫连子悦到北周聘问	十一月，丁巳，周主如散关
十二月，己丑，北周国主回长安	壬辰，邵陵公章昭达卒
春季，正月，丙午，陈朝任命尚书仆射徐陵为左仆射，中书监王劢为右仆射	己巳，齐主祀南郊
乙巳，北齐后主到南郊祭天	庚午，上享太庙
庚午，陈宣帝到太庙祭祀	辛未，齐主赠琅邪王俨为楚恭哀帝以慰太后心，又以俨妃李氏为楚帝后
二月，癸酉，北周派大将军昌城公宇文深到突厥访问，司宾李除、小宾部贺遂礼到北齐访问	己卯，齐以卫菩萨为太尉
宇文深是宇文护的儿子	辛巳，以并省吏部尚书高元海为尚书左仆射
夏季，四月，北周派工部成公建、小礼部辛彦之到北齐聘问	庚寅，周追尊略阳公为孝闵皇帝
庚寅，北周追尊略阳公宇文觉为孝闵皇帝	癸巳，周立皇子鲁公为太子，大赦
癸巳，北周立皇子鲁公宇文为太子，大赦全国	五月，癸卯，王劢卒
辛未，北周派司城中大夫杜杲来陈朝聘问	初，齐胡太后自愧失德，欲求悦于齐主，乃饰其兄长仁之女置宫中，令帝见之，帝果悦，纳为昭仪
宣帝对他说：如果要和我国联合起来谋取北齐，应该把樊、邓二州让给我们	及斛律后废，陆令萱欲立穆夫人；太后欲立胡昭仪，力不能遂，乃卑辞厚礼以求令萱，结为姊妹
使者回答说：联合起来谋取北齐，难道仅仅是敝国一国的利益	令萱亦以胡昭仪宠幸方隆，不得已，与祖白帝立之
贵国一定要城镇，应该从北齐那里去得到，先要索取汉南一带地方，我作为使臣不敢传达这个要求	戊子，立皇后胡氏
己丑，北齐任命北平王高仁坚为尚书令，特进许季良为左仆射，彭城王高宝德为右仆射	癸巳，齐主如晋阳
癸巳，北齐后主去晋阳	九月，庚子朔，日有食之
九月，庚子朔，发生日食	辛亥，大赦
辛亥，陈朝大赦全国	冬，十月，庚午，周诏：江陵所虏充官口者，悉免为民
冬季，十月，庚午，北周诏令：在江陵俘虏充当官府奴婢的，全部赦免为百姓	辛未，周遣小匠师杨勰等来聘
辛未，北周派小匠师杨勰等来陈朝聘问	周绥德公陆通卒
北周绥德公陆通去世	乙酉，上享太庙
庚寅，北周国主到道会苑游玩，因为上善殿壮丽，将它焚毁	十二月，辛巳，周主祀南郊
乙巳，北周任命柱国田弘为大司空	乙卯，周主享太庙
春季，正月，癸酉，陈朝任命吏部尚书沈君理为右仆射	戊寅，齐以并省尚书令高阿那肱录尚书事，总知外兵及内省机密，与侍中城阳王穆提婆、领军大将军昌黎王韩长鸾共处横轴，号曰三贵，蠹国害民，日月滋甚
戊寅，北齐任命并省尚书令高阿那肱录尚书事，总管外兵和宫内的机密，和侍中城阳王穆提婆、领军大将军昌黎王韩长鸾一同担任朝廷中枢的要职，号称三贵，祸国殃民，一天比一天厉害	庚辰，齐遣崔象来聘
庚辰，北齐派崔象来陈朝聘问	辛巳，上祀南郊；甲午，享太庙；二月，辛丑，祀明堂
壬戌，北周派司会侯莫陈凯等人到北齐聘问	庚辰，齐主还邺
庚辰，北齐后主回邺城	三月，己卯，周太子于岐州获二白鹿以献，周主诏曰：在德不在瑞
夏季，四月，己亥，北周国主到太庙祭祀	癸卯，前巴州刺史鲁广达与齐师战于大岘，破之
癸卯，陈朝的前巴州刺史鲁广达和北齐军队在大岘交战，将北齐军队打败	戊申，齐以兰陵王长恭为太保，南阳王绰为大司马，安德王延宗为太尉，武兴王普为司徒，开府仪同三司宜阳王赵彦深为司空
北齐后主到南苑游玩，对六十个随从官员赐死	癸丑，程文季攻齐泾州，拔之
任命高阿那肱为司徒	乙卯，宣毅司马湛陀克新蔡城
癸巳，北周国主召集群臣和僧人、道士，自己登上高坐，辩论三教次序的先后，以儒教为第一，道教其次，佛教最后	乙未，谯城降
乙未，谯城投降	乙巳，立皇子叔明为宜都王，叔献为河东王
乙巳，陈朝立皇子陈叔明为宜都王，陈叔献为河东王	壬午，任忠克霍州
壬午，陈朝的任忠攻克霍州	是岁，突厥求婚于齐
这一年，突厥派人到北齐求婚	春，正月，壬戌朔，周齐公宪等七人进爵为王
六年	
春季，正月，壬戌朔，北周齐公宇文宪等七人进爵为王	己巳，周主享太庙；乙亥，耕藉田
己巳，到藉田举行耕种仪式	壬子，上享太庙
壬午，陈宣帝到太庙祭祀	甲申，广陵金城降
甲申，广陵城牙城中的将士向陈朝投降	二月，壬午朔，日有食之
二月，壬辰朔，有日食	乙未，齐主还邺
乙未，北齐后主回邺城	丁酉，周纪国公贤等六人进爵为王
丁酉，北周纪国公宇文贤等六人进爵为王	辛亥，上耕藉田
乙卯，北周国主去云阳宫	丙辰，周大赦
庚午，北齐大赦全国	齐人恐陈师渡淮，使皮景和屯西兖州以备之
六月，壬辰，陈朝的周弘正去世	壬子，周更铸五行大布钱，一当十，与布泉并行
壬子，北周改铸五行大布钱，以一当十，和布泉一同流通	戊午，周立通道观以壹圣贤之教
戊午，北周建立通道观以统一圣贤的政教	秋，七月，庚申，周主如云阳，以右宫正尉迟运兼司武，与薛公长孙览辅太子守长安
春季，正月，辛未，陈宣帝到南郊祭天	癸酉，周主如同州
癸酉，北周国主去同州	乙亥，左卫将军樊毅克潼州
乙亥，陈朝左卫将军樊毅攻克潼州	齐主还邺
北齐后主回邺城	辛巳，上祀北郊
辛巳，陈宣帝到北郊祭地	二月，丙戌朔，日有食之
二月，丙戌朔，出现日食	戊申，樊毅克下邳、高栅等六城
丙寅，北周国主回长安	夏，四月，甲午，上享太庙
庚子，北齐任命中书监阳休之为尚书右仆射	六月，壬辰，以尚书右仆射王为左仆射
六月，壬辰，陈朝任命尚书右仆射王为左仆射	甲戌，齐主如晋阳
甲戌，北齐后主去晋阳	秋，七月，丙戌，周主如云阳宫
秋季，七月，丙戌，北周国主去云阳宫	八月，癸卯，周遣使来聘
庚辰，北齐任命赵彦深为司徒，斛阿列罗为司空	闰月，车骑大将军吴明彻将兵击齐彭城；壬辰，败齐兵数万于吕梁
闰月，陈朝车骑大将军吴明彻率军攻打北齐彭城；壬辰，在吕梁打败几万齐兵	甲午，周主如同州
甲午，北周国主去同州	冬，十月，己巳，立皇子叔齐为新蔡王，叔文为晋熙王
冬季，十月，己巳，陈朝立皇子陈叔齐为新蔡王，陈叔文为晋熙王	十二月，辛亥朔，日有食之
十二月，辛亥朔，出现日食	壬戌，以王为尚书左仆射，太子詹事吴郡陆缮为右仆射
壬戌，陈朝任命王为尚书左仆射，太子詹事吴郡陆缮为右仆射	庚午，周主还长安
庚午，北周国主回长安	春，正月，癸未，周主如同州；辛卯，如河东涑川；甲午，复还同州
八年	
春季，正月，癸未，再回同州	甲寅，齐大赦
甲寅，北齐大赦全国	乙卯，齐主还邺
北齐搜求因犯罪没官当奴婢的杂户中女子尚未出嫁的，全部集中起来，凡是把这种人隐藏起来的，家长处死	壬申，以开府仪同三司吴明彻为司空
壬申，陈朝任命开府仪同三司吴明彻为司空	三月，壬寅，周主还长安；夏，四月，乙卯，复如同州
三月，壬寅，又去同州	己未，上享太庙
己未，陈宣帝到太庙祭祀	尚书左仆射王卒
陈朝的尚书左仆射王死	五月，壬辰，周主还长安
五月，壬辰，北周国主回长安	六月，戊申朔，日有食之
六月，戊申朔，出现日食	辛亥，周主享太庙
秋季，八月，乙卯，北周国主回长安	周太子伐吐谷浑，至伏俟城而还
北周太子征讨吐谷浑，到达伏俟城以后就返回了	丁卯，以司空吴明彻为南兖州刺史
北周国主对群臣说：朕去年因为生病，所以没有能平定逃亡在外的盗贼	齐主命立重赏以募战士，而竟不出物
以前进入齐的国境，见到对方的所有情况，他们指挥军队，简直同小孩子玩游戏那样	广宁王孝珩请使任城王将幽州道兵入土门，扬声趣并州，独孤永业将洛州道兵入潼关，扬声趣长安，臣请将京畿兵出滏口，鼓行逆战
何况朝廷昏聩混乱，朝政被一帮小人操纵，老百姓都在哀号，朝不保夕	敌闻南北有兵，自然逃溃
上天赐给我们而不去谋取，恐怕会留下后悔	又请出宫人珍宝赏将士
去年进军河阴，只如同用手拍打对方的后背，没有扼住对方的喉咙	齐主不悦
晋州原先是高欢起兵发迹的地方，也是镇守统辖要害重地，现在我们去进攻晋州，对方一定要派兵来救援；我们的军队严阵以待，发起攻击后一定可以攻克	斛律孝卿请齐主亲劳将士，为之撰辞，且曰：宜慷慨流涕，以感激人心
然后借着破竹之势，大张旗鼓地向东进攻，足以捣平他们的巢穴，统一天下	齐主既出，临众，将令之，不复记所受言，遂大笑，左右亦笑
将领们都不愿意行动	将士怒曰：身尚如此，吾辈何急
武帝说：机不可失	皆无战心
凡阻滞我军事行动的人，一定按军法制裁	于是自大丞相已下，太宰、三师、大司马、大将军、三公等官，并增员而授，或三或四，不可胜数
二月，壬午，陈宣帝到藉田举行耕种的仪式	丙午，周主宴从官将士于齐太极殿，颁赏有差
丙午，北周国主在北齐的太极殿赐宴随从的官员将士，按等级给予赏赐	己巳，周主享太庙
六月，丁卯，北周国主到东部巡视	上闻周人灭齐，欲争徐、兖，诏南兖州刺史、司空吴明彻督诸军伐之，以其世子戎昭、将军惠觉摄行州事
秋季，七月，丙戌，驾临洛州	明彻军至吕梁，周徐州总管梁士彦帅众拒战，戊午，明彻击破之
八月，壬寅，议定度量衡制度，向四方颁布	士彦婴城自守，明彻围之
十一月，壬申，北周立皇子宇文充为道王，宇文兑为蔡王	癸酉，周遣上大将军王轨将兵救徐州
起初，北周在晋州打败北齐军队，乘胜追逐北上，北齐人所丢弃的盔甲兵器，来不及收罗集中；稽胡钻空子偷偷出动，将丢弃的东西全都盗走	周诏：自永熙三年以来，东土之民掠为奴婢，及克江陵之日，良人没为奴婢者，并放为良
仍旧立刘蠡升的孙子刘没铎为君主，称圣武皇帝，改年号为石平	又诏：后宫唯置妃二人，世妇三人，御妻三人，此外皆减之
己亥晦，出现日食	周初行《刑书要制》：群盗赃一匹，及正、长隐五丁、若地顷以上，皆死
北周开始实行《刑书要制》：凡盗窃一匹赃物，以及闾正、里正、族正、保长、党长隐满五个丁口、一百亩地以上的，都处死	十二月，戊申，新作东宫成，太子徙居之
庚申，北周国主去并州，将并州的四万户军民迁移到关中地区	高宝宁自黄龙上表劝进于高绍义，绍义遂称皇帝，改元武平，以宝宁为丞相
戊辰，废除并州的宫室和六府	突厥佗钵可汗举兵助之
高宝宁从黄龙上表劝高绍义当皇帝，高绍义于是做了皇帝，改年号为武平，任命高宝宁为丞相	春，正月，壬午，周主幸邺；辛卯，幸怀州；癸巳，幸洛州
突厥佗钵可汗举兵帮助高绍义	置怀州宫
二月，甲辰，北周谯孝王宇文俭去世	丁巳，周主还长安
三月，戊辰，北周在蒲州营建宫室，废除同州和长春二宫	甲戌，周主初服常冠，以皂纱全幅向后发，仍裁为四脚
甲戌，北周国主初次戴平日用的帽子，用整幅的黑纱从前向后包扎头发，并裁成四个帽翅	丙子，命中军大将军、开府仪同三司淳于量为大都督，总水陆诸军事，镇西将军孙都督荆、郢诸军，平北将军樊毅都督清口上至荆山缘淮诸军，宁远将军任忠都督寿阳、新蔡、霍州诸军，以备周
丙子，陈朝任命中军大将军、开府仪同三司淳于量为大都督，总管水路和陆路的军事，镇西将军孙都督荆州、郢州的军队，平北将军樊毅都督清口上到荆山沿淮河一带的军队，宁远将军任忠都督寿阳、新蔡、霍州的军队，以防备北周的军事行动	乙酉，大赦
乙酉，陈朝大赦全国	壬辰，周改元宣政
壬辰，北周改年号为宣政	夏，四月，庚申，突厥寇周幽州，杀掠吏民
五月，己丑，北周武帝率领军队征讨突厥，派柱国原公宇文姬愿、东平公宇文神举等领兵分五路并进	闰月，乙亥，周主立妃杨氏为皇后
闰月，乙亥，北周国主宣帝宇文立妃子杨氏为皇后	辛巳，周以赵王招为太师，陈王纯为太傅
庚戌，北周国主封弟弟宇文元为荆王	周主诏：诸应拜者，皆以三拜成礼
甲寅，陈宣帝驾临娄湖对众官盟誓	冬，周主还长安
乙卯，分派大使将盟誓对全国宣布，使上下互相告诫防备	以大司空王谊为襄州总管
戊子，陈朝任命尚书左仆射陆缮为尚书仆射	十一月，突厥寇周边，围酒泉，杀掠吏民
十一月，突厥入侵北周边境，包围酒泉，屠杀抢掠当地官吏百姓	十二月，甲子，周以毕王贤为大司空
十二月，甲子，北周任命毕王宇文贤为大司空	己丑，周以河阳总管滕王为行军元帅，帅从入寇
癸卯，北周立皇子宇文阐为鲁王	二月，癸亥，上耕藉田
北周停止南征的军事行动	突厥佗体可汗请和于周，周主以赵王招女为千金公主，妻之，且命执送高绍义；佗钵不从
秋季，七月，庚寅，北周任命杨坚为大前疑，柱国司马消难为大后承	辛卯，初用大货六诛钱
辛卯，陈朝开始使用六铢钱的大钱币	丙申，周纳司马消难女为正阳宫皇后
丁卯，陈朝宣帝在大壮观阅兵	壬申，周天元还长安
命令都督任忠率领十万步骑兵在玄武湖列阵，都督陈景统率五百艘楼船出瓜步江，整顿部队而返	甲戌，以陈山提、元晟并为上柱国
甲戌，陈朝任命尚书仆射陆缮为尚书左仆射	十一月，辛卯，大赦
乙未，北周天元皇帝去骊山的温泉	戊戌，周军进围寿阳
戊戌，北周军队进攻并包围寿阳	周天元如同州
北周天元皇帝去同州	诏开府仪同三司、南兖州刺史淳于量为上流水军都督，中领军樊毅都督北讨诸军事，左卫将军任忠都督北讨前军事，前丰州刺史皋文奏帅步骑三千趣阳平郡
陈宣帝诏令开府仪同三司、南兖州刺史淳于量为上流水军都督，中领军樊毅都督北讨诸军事，左卫将军任忠都督北讨前军事，前丰州刺史皋文奏率领三千步骑兵进取阳平郡	壬寅，周天元还长安
十二月，戊午，北周天元皇帝因为一再出现灾异现象，不用仪仗和护卫，去天兴宫斋戒	乙丑，南・北兖、晋三州及盱眙、山阳、阳平、马头、秦、历阳、沛、北谯、南梁等九郡民并自拔还江南
朝廷百官对他上表，劝他恢复睡觉用膳	周又取谯、北徐州
甲子，天元皇帝回宫，在正武殿召集百官、宫人、宫廷外臣以下的母亲、妻子，摆开了许多杂技歌舞，初次演出西域地方的乞寒戏	自是江北之地尽没于周
北周天元皇帝去洛阳，亲自驾驭驿马，一天走三百里，四位皇后以及文武侍卫几百人乘驿马在后面跟从	癸酉，遣平北将军沈恪、电威将军裴子烈镇涂州，开远将军徐道奴镇栅口，前信州刺史杨宝安镇白下
又命令四位皇后和自己并驾齐驱，走得有先后时，便加以斥责，弄得人困马乏跌倒在地，一路上接连不断出现	戊寅，以中领军樊毅都督荆、郢、巴、武四州水陆诸军事
春季，正月，癸巳，北周天元皇帝到太庙癸祀祖先	戊戌，以左卫将军任忠为南豫州刺史，督缘江军防事
戊戌，陈朝任命左卫将军任忠为南豫州刺史，负责沿江一带的军事防务	乙卯，周税入市者人一钱
乙卯，北周朝廷向出入集市的人每人征税一文钱	二月，丁巳，周天元幸露门学，释奠
二月，丁巳，北周天元皇帝驾幸露门学，陈设酒食祭祀孔子	戊午，突厥入贡于周，且迎千金公主
夏季，四月，癸亥，南陈尚书左仆射陆缮去世	己巳，周天元祠太庙；己卯，大雩；壬午，幸仲山祈雨，甲申，还宫，令京城士女于衢巷作乐迎候
癸丑，北周静帝封其弟宇文衍为叶王，宇文术为郢王	周豫、荆、襄三州蛮反，攻破郡县
北周益州总管王谦也不愿意依附杨坚，于是出动巴、蜀地区的军队攻打始州	戊辰，诏以司马消难为大都督水陆诸军事
新任益州总管梁睿到汉川以后，无法再继续前进，杨坚即任命梁睿为行军元帅讨伐王谦	庚午，通直散骑常侍淳于陵克临江郡
癸酉，陈朝智武将军鲁广达攻克北周郭默城	周以汉王赞为太师，申公李穆为太傅，宋王实为大前疑，秦王贽为大右弼，燕公于为大左辅
丙子，通直散骑常侍淳于陵攻克北周州城	，仲文之父也
乙卯，北周朝廷大赦天下	周王谊帅四总管至郧州，司马消难拥其众以鲁山、甑山二镇来降
北周行军元帅王谊统领四位总管进至郧州，司马消难率军献鲁山、甑山二镇归降南陈	周以神武公窦毅为大司马，齐公于智为大司空；九月，以小宗伯竟陵公杨惠为大宗伯
北周朝廷任命神武公窦毅为大司马，齐公于智为大司空；九月，又任命小宗伯竟陵公杨惠为大宗伯	丁亥，周将王延贵帅众援历阳；任忠击破之，生擒延贵
冬季，十月，甲寅，出现日食	周丞相坚杀陈惑王纯及其子
十二月，庚辰，南陈河东康简王陈叔献去世	癸亥，周诏诸改姓者，宜悉复旧
癸亥，北周静帝下诏令在西魏时改姓鲜卑姓氏的人，都应恢复原来的姓氏	甲子，周以大丞相坚为相国，总百揆，去都督中外、大冢宰之号，进爵为王，以安陆等二十郡为随国，赞拜不名，备九锡之礼；坚受王爵、十郡而已
乙亥，南陈宣帝亲自耕种藉田	隋主封其弟邵公慧为滕王，安公爽为卫王，子雁门公广为晋王，俊为秦王，秀为越王，谅为汉王
庚子，隋文帝颁下诏令，百官大臣凡在前代北周所受封的官品爵位，都仍旧不予降低	丁未，梁主遣其弟太宰岩入贺于隋
夏季，四月，辛巳，隋朝大赦天下罪人	散骑常侍韦鼎、兼通直散骑常侍王聘于周
戊戌，全部释放录属于太常寺演奏散乐的乐户为平民百姓，但仍然禁止演出杂戏	辛丑，至长安，隋已受禅，隋主致之介国
壬辰，隋文帝驾幸岐州	十一月，丁卯，隋遣兼散骑侍郎郑来聘
十一月，丁卯，隋文帝派遣兼散骑侍郎郑到陈朝聘问	十二月，庚子，隋主还长安，复郑译官爵
三月，己巳，陈朝任命尚书左仆射晋安王陈伯恭为湘州刺史，永阳王陈伯智为尚书仆射	夏，四月，庚寅，隋大将军韩僧寿破突厥于鸡头山，上柱国李充破突厥于河北山
壬戌，隋任穆公于翼卒	壬戌，隋朝任穆公于翼去世
甲子，隋更命传国玺曰：受命玺	甲子，隋朝改传国玺名为受命玺
六月，甲申，隋遣使来吊	六月，甲申，隋朝派遣使者到陈朝吊唁
乙酉，隋上柱国李光败突厥于马邑	乙酉，隋朝上柱国李光在马邑打败突厥军队
突厥又寇兰州，凉州总管贺娄子干败之于洛可	突厥军队又进犯兰州，被隋朝凉州总管贺娄子干在可洛打败
隋主嫌长安城制度狭小，又宫内多妖异	隋文帝嫌长安宫城的规模狭小，而且宫中经常出现妖妄怪异现象
纳言苏威劝帝迁都，帝以初受命，难之；夜，与威及高共议	纳言苏威劝文帝迁都，文帝因为受命登基不久，不宜轻动，因此感到很为难，于是就在夜里与苏威、尚书左仆射高一起商议
明旦，通直散骑庾秀才奏曰：臣仰观乾象，俯察图记，必有迁都之事	第二天早朝，通直散骑常侍庾季才上奏说：我在昨晚仰头观察天象，又俯身对照察看图记，发现一定要迁移都城
且汉营此城，将八百岁，水皆咸卤，不甚宜人	况且从汉朝初年营建此城，至今已八百多年，水质变咸，不再适合饮用
愿陛下协天人之心，为迁徙之计	希望陛下上应天意，下顺民心，制定出迁都的计划
帝愕然，谓、威曰：是何神也	隋文帝很吃惊，对高、苏威说：这多么灵验啊
太师李穆亦上表请迁都	太师李穆也上表请求迁都，文帝看了他的奏疏后说：天道明察，已经出现了迁都的征兆；太师是人望所归，又上表请求
帝省表曰：天道聪明，已有征应；太师人望，复抗此请；无不可矣	由此看来，没有什么不可以了
丙申，诏高等创造新都于龙首山	丙申，隋文帝下诏令高等人负责在龙首山一带建造新宫城
以太子左庶子宇文恺有巧思，领营新都副监	因为太子左庶子宇文恺在建筑方面有巧妙的构思，于是任命他担任营建新城的副监
恺，忻之弟也	宇文恺是宇文忻的弟弟
秋，七月，辛未，大赦	秋季，七月，辛未，陈朝大赦天下
丙午，以长沙王叔坚为司空，将军、刺史如故	丙午，陈朝任命长沙王陈叔坚为司空，他的骠骑将军、扬州刺史职务仍旧
冬，十月，癸酉，隋太子勇屯兵咸阳以备突厥	冬季，十月，癸酉，隋朝皇太了杨勇率军驻扎咸阳以防备突厥
十二月，丙子，隋命新都曰大兴城	十二月，丙子，隋朝命名新都为大兴城
乙酉，隋遣沁源公虞庆则屯弘化以备突厥	乙酉，隋朝派遣沁源公虞庆则率军驻扎弘化郡以防备突厥
隋主既立，待遇梁主，恩礼弥厚	隋文帝即位后，对待后梁孝明帝萧岿恩礼更加深厚
是岁，纳梁主女为晋王妃，又欲以其子尚兰陵公主	这一年，礼聘萧岿的女儿为晋王杨广的妃子，还打算让皇子杨娶兰陵公主为妻
由是罢江陵总管，梁主始得专制其国家	因此废掉监护后梁的江陵总管，萧岿才得以全权统治国家
春，正月，庚子，隋将入新都，大赦	春季，正月，庚子，隋朝将要迁入新都大兴城，大赦天下
壬寅，大赦，改元	壬寅，陈朝大赦天下，改年号为至德
初，上病创，不能视事，政无大小，皆决于长沙王叔坚，权倾朝廷	当初，陈后主由于受伤，不能处理政事，朝廷的大小政事都由长沙王陈叔坚裁决处理，陈叔坚因此权倾朝廷
叔坚颇骄纵，上由是忌之	陈叔坚十分骄横，因此受到陈后主的猜忌
都官尚书山阴孔范，中书舍人施文庆，皆恶叔坚而有宠于上，日夕求其短，构之于上	都官尚书山阴人孔范与中书舍人施文庆都厌恶陈叔坚，并且受到陈后主的宠信，所以他们朝夕寻找陈叔坚的过失，然后向陈后主进谗陷害他
上乃即叔坚骠骑将军本号，用三司之仪，出为江州刺史	于是陈后主就让陈叔坚以骠骑将军的称号，保留尚书、中书、门下三省长官的待遇，出任江州刺史
以祠部尚书江总为吏部尚书	又任命祠部尚书江总为吏部尚书
癸卯，立皇子深为始安王	癸卯，陈后主封皇子陈深为始安王
二月，己巳朔，日有食之	二月，己巳朔，出现日食
癸酉，遣兼散骑常侍贺彻等聘于隋	癸酉，陈朝派遣兼散骑常侍贺彻等人到隋朝聘问
突厥寇隋北边	突厥兴兵侵犯隋朝北部边境
癸巳，葬孝宣皇帝于显宁陵，庙号高宗	癸巳，陈朝葬孝宣皇帝于显宁陵，庙号为高宗
三月，丙辰，隋迁于新都	三月，丙奈，隋朝宫廷迁入新都
夏，四月，庚午，吐谷浑寇隋临洮	夏季，四月，庚午，吐谷浑兴兵侵犯隋朝临洮郡
洮州刺史皮子信出战，败死；汶州总管梁远击走之	洮州刺史皮子信率军出战，兵败身亡；汶州总管梁远率军击退了入侵敌军
又寇廓州，州兵击走之	吐谷浑又兴兵侵犯廓州，廓州兵击退了入侵敌军
壬申，隋以尚书左仆射赵兼内史令	壬申，隋朝任命尚书右仆射赵兼任内史令
己丑，郢州城主张子讥遣使请降于隋，隋主以和好，不纳	己丑，陈朝郢州守将张子讥派遣使节请求归降隋朝，隋文帝因为两国和好，不予接纳
辛卯，隋主遣兼散骑常侍薛舒、兼散骑常侍王劭来聘	辛卯，隋文帝派遣兼散骑常侍薛舒、王劭到陈朝聘问
劭，松年之子也	王劭是王松年的儿子
癸巳，隋主大雩	癸巳，隋文帝举行祈雨祭祀
甲子，突厥遣使入见于隋	甲子，突厥派遣使节出使隋朝
隋改度支尚书为民部，都官尚书为刑部	隋文帝改尚书省度支尚书为民部，都官尚书为刑部
命左仆射判吏、礼、兵三部事，右仆射判民、刑、工三部事	又令尚书左仆射负责掌管吏、礼、兵三部政务，尚书右仆射负责掌管民、刑、工三部政务
废光禄、卫尉、鸿胪寺及都水台	废除光禄、卫尉、鸿胪三寺和都水台
五月，癸卯，隋行军总管李晃破突厥于摩那度口	五月，癸卯，隋朝行军总管李晃在摩那度口打败突厥军队
乙巳，梁太子琮入朝于隋，贺迁都	乙巳，后梁太子萧琮入隋朝见，祝贺隋朝迁都
辛酉，隋主祀方泽	辛酉，隋文帝祭祀大泽
隋秦州总管窦荣定帅九总管步骑三万出凉州，与突厥阿波可汗相拒于高越原，阿波屡败	隋朝秦州总管窦荣定率领九总管步、骑兵三万人兵发凉州，与突厥阿波可汗在高越原相对峙，阿波可汗屡战屡败
荣定，炽之兄子也	窦荣定是太傅窦炽的侄子
六月，庚辰，隋行军总管梁远破吐谷浑于尔汗山	六月，庚辰，隋朝行军总管梁远在尔汗山打败吐谷浑军队
八月，丁卯朔，日有食之	八月，丁卯朔，出现日食
长沙王叔坚未之江州，复留为司空，实夺之权	陈朝长沙王陈叔坚还没有到江州赴任，陈后主又留他在京师担任司空，其实夺了他的实权
壬午，隋遣尚书左仆射高出宁州道，内史监虞庆则出原的州道，以击突厥	壬午，隋朝派遣尚书左仆射高出宁州道，内史监虞庆则出原州道，两路攻打突厥
九月，癸丑，隋大赦	九月，癸丑，隋朝大赦天下
冬，十月，甲戌，隋废河南道行台省，以秦王俊为秦州总管，陇右诸州尽隶焉	冬季，十月，甲戌，隋朝为除河南行台省，任命秦王杨俊为秦州总管，陇右地区各州全部归他统辖
丁酉，立皇弟叔平为湘东王，叔敖为临贺王，叔宣为阳山王，步穆为西阳王	丁酉，陈后主封皇弟陈叔平为湘东王，陈叔敖为临贺王，陈叔宣为阳山王，陈叔穆为西阳王
戊戌，侍中建昌侯徐陵卒	戊戌，陈朝侍中建昌侯徐陵去世
癸丑，立皇弟叔俭为安南王，叔澄为南郡王，叔兴为沅陵王，叔韶为岳山王，叔纯为新兴王	癸丑，陈后主封皇弟陈叔俭为安南王，陈叔澄为南郡王，陈叔兴为沅陵王，陈叔韶为岳山王，陈叔纯为新兴王
十一月，遣散骑常侍周坟、通直散骑常侍袁彦聘于隋	十一月，陈朝派遣散骑常侍周坟、通直散骑常侍袁彦到隋朝聘问
帝闻隋主状貌异人，使彦画像而归	陈后主听说隋文帝相貌奇异，与常人不同，就让袁彦画下文帝的像带回
帝见，大骇曰：吾不欲见此人	陈后主见像大吃一惊，说：我不想再看到这个人
亟命屏之	急忙下令去掉画像
隋既班律令，苏威屡欲更易事条，内史令李德林曰：修律令时，公何不言	隋朝颁布新律令以后，纳言苏威曾多次想修改某些条款，内史令李德林说：当初制定律令时，您为什么不说话
今始颁行，且宜专守，自非大为民害，不可数更	现在新律令既已颁行，就应该严格遵守，如果不是大害于民的条款，不能轻易更改
春季，正月，甲子，出现日食	己巳，隋主享太庙；辛未，祀南郊
癸巳，陈朝大赦天下	二月，乙巳，隋主饯梁主于灞上
二月，乙巳，隋文帝在灞上设宴为后梁国主饯行	突厥苏尼部男女万余口降隋
突厥苏尼部落男女一万多口归降隋朝	庚戌，隋主如陇州
庚戌，隋文帝驾幸陇州	突厥达头可汗请降于隋
突厥达头可汗请求降附隋朝	夏，四月，庚子，隋以吏部尚书虞庆则为右仆射
夏季，四月，庚子，隋朝任命吏部尚书虞庆则为尚书右仆射	隋上大将军贺娄子干发五州兵击吐谷浑，杀男女万余口，二旬而还
隋朝上大将军贺娄子干调发河西凉、甘、瓜、鄯、廓五州的军队攻打吐谷浑，斩杀吐谷浑部落男女一万多口，历时二十天才班师还军	五月，以吏部尚书江总为仆射
五月，南陈朝廷任命吏部尚书江总为尚书仆射	隋主以渭水多沙，深浅不常，漕者苦之，六月，壬子，诏太子左庶子宇文恺帅水工凿渠，引渭水，自大兴城东至潼关三百余里，名曰广通渠，漕运通利，关内赖之
秋季，七月，丙寅，陈朝派遣兼散骑常侍谢泉等人出使隋朝	八月，壬寅，隋邓恭公窦炽卒
八月，壬寅，隋朝邓恭公窦炽去世	乙卯，将军夏侯苗请降于隋，隋主以通和，不纳
乙卯，陈朝将军夏侯苗请求归降隋朝，隋文帝因为与陈朝交好，不予接纳	九月，甲戌，隋主以关中饥，行如洛阳
春季，正月，戊午朔，出现日食	隋主命礼部尚书牛弘修五礼，勒成百卷；戊辰，诏行新礼
隋文帝命令礼部尚书牛弘撰修吉、凶、军、宾、嘉五礼，编为百卷；戊辰，诏令颁行新礼	三月，戊午，隋以尚书左仆射高为左领军大将军
九月，陈朝将军湛文彻侵犯隋朝的和州，隋仪同三司费宝首率军打败陈朝军队，俘虏了湛文彻	丙子，隋使李若等来聘
丙子，隋朝派遣李若等人到陈朝聘问	冬，十月，壬辰，隋以上柱国杨素为信州总管
这一年，后梁大将军戚昕率水军攻打陈朝荆州治所公安城，没有攻克而退军	隋主使司农少卿崔仲方发丁三万，于朔方、灵武筑长城，东距河，西至绥州，绵历七百里，以遏胡寇
隋文帝又派遣司农少卿崔仲方征发壮丁三万人，在朔方、灵武一线修筑长城，东起黄河，西至绥州，绵延七百里，用来遏制北方胡人入侵	梁改元广运
四年	
后梁改年号广运	甲子，党项羌请降于隋
甲子，党项羌人请求降附隋朝	庚午，隋颁历于突厥
庚午，隋朝向突厥颁行新历	二月，隋始令刺史上佐每岁暮更入朝，上考课
二月，隋朝下令每年岁末各州刺史以及高级僚属轮流入朝，呈奏本州官吏的当年政绩，由朝廷进行考核升降	丁亥，隋复令崔仲方发丁十五万，于朔方以东，缘边险要，筑数十城
丁亥，隋文帝又命令崔仲方征发壮丁十五万人，在朔方以东，沿边境的险要地方修筑数十座城堡	丙申，立皇弟叔谟为巴东王，叔显为临江王，叔坦为新会王，叔隆为新宁王
丙申，陈朝立皇弟陈叔谟为巴东王，陈叔显为临江王，陈叔坦为新会王，陈叔隆为新宁王	庚子，隋大赦
夏季，四月，己亥，陈朝派遣周等人到隋朝聘问	五月，丁巳，立皇子庄为会稽王
五月，丁巳，陈朝立皇子陈庄为会稽王	秋，八月，隋遣散骑常侍裴豪等来聘
秋季，八月，隋朝派遣散骑常侍裴豪等人到陈朝聘问	戊申，隋申明公李穆卒，葬以殊礼
戊申，隋朝申明公太师李穆去世，用特别隆重的礼节安葬	闰月，丁卯，隋太子勇镇洛阳
癸亥，陈朝任命尚书仆射江总为尚书令，吏部尚书谢为尚书仆射	十一月，己卯，大赦
春季，正月，戊寅，陈朝大赦天下，改年号为祯明	癸巳，隋主享太庙
癸巳，隋文帝到太庙祭祀祖先	乙未，隋制诸州岁贡士三人
乙未，隋朝规定各州每年向朝廷推荐三位士人	二月，丁巳，隋主朝日于东郊
二月丁巳，隋文帝在东郊举行祭祀太阳的仪式	遣兼散骑常侍王亨等聘于隋
隋朝征发壮丁十万余人修筑长城，二十天而止	突厥沙钵略可汗遣其子入贡于隋，因请猎于恒、代之间，隋主许之，仍遣人赐以酒食
夏季，四月，隋朝在扬州开凿山阳渎以通漕运	沙钵略帅部落再拜受赐
甲戌，隋朝派遣兼散骑常侍杨同到陈朝聘问	五月，乙亥朔，日有食之
五月，乙亥朔，出现日食	秋，七月，己丑，隋卫昭王爽卒
甲午，陈朝大赦天下	冬，十月，隋主如同州；癸亥，如蒲州
冬季，十月，隋文帝巡幸同州；癸亥，又巡幸蒲州	十一月，丙子，以萧岩为开府仪同三司、东扬州刺史，萧谳为吴州刺史
丁亥，陈朝任命豫章王陈叔英兼任司徒	甲午，隋主如冯翊，亲祠故社；戊戌，还长安
春季，正月，辛巳，陈朝立皇子陈为东阳王，陈恬为钱塘王	遣散骑常侍袁雅等聘于隋；又遣散骑常侍九江周罗将兵屯峡口，侵隋峡州
冬季，十月，己亥，陈朝立皇子陈蕃为吴郡王	己未，隋置准南行省于寿春，以晋王广为尚书令
己未，隋朝于寿春设立淮南行台，任命晋王杨广为行台尚书令	丙子，立皇弟叔荣为新昌王，叔匡为太原王
丙子，陈朝立皇弟陈叔荣为新昌王，陈叔匡为太原王	隋主如河东；十二月，庚子，还长安
归附隋朝的吐谷浑河南王移兹裒去世，隋文帝诏令他的弟弟树归承袭王位，统领归附的吐谷浑部落	春，正月，乙丑朔，陈主朝会群臣，大雾四塞，入人鼻，皆辛酸，陈主昏睡，至晡时乃寤
隋帝王世系表帝王年号公元本书卷次文帝开皇(20)581──600义宁(2)617──618卷183──184	
陈朝吴州刺史萧甚得民心，陈朝灭亡后，吴地人民推举他为首领，割据自立，隋右卫大将军武川人宇文述统率行军总管元契、张默言等率军讨伐	乐安公元谐，性豪侠，有气调，少与上同学，甚相爱，及即位，累历显仕
隋落丛公燕荣率领水军从东海赶来参战，陈永新侯陈君范从晋陵投奔萧，合军抗拒宇文述的军队	谐好排诋，不能取媚左右
宇文述的军队快到时，萧在晋陵城东面建立栅栏，留下军队抗拒宇文述，并派遣部将王褒守吴州，自己则率领大军从义兴进入太湖，打算从背后袭击宇文述的军队	与上柱国王谊善，谊诛，上稍疏忌之
宇文述进兵攻破晋陵城东营栅，然后回兵攻打萧，大败萧的军队；又派遣军队从别道攻打吴州，王褒换上道士衣服弃城逃走	或告谐与从父弟上开府仪同三司滂、临泽侯田鸾、上仪同三司祈绪等谋反，下有司按验，奏谐谋令祈绪勒党项兵断巴、蜀
萧率领残余部队退保包山，又被燕荣打败	又，谐尝与滂同谒上，谐私谓滂曰：我是主人，殿上者贼也
萧带领左右数人藏匿百姓家中，被人抓获	因令滂望气，滂曰：彼云似蹲狗走鹿，不如我辈有福德云
宇文述率军进至奉公埭，陈朝东扬州刺史萧岩献上会稽城投降，后来与萧都被送往长安斩首	上大怒，谐、滂、鸾、绪并伏诛
朝野上下都请求隋文帝举行封禅大典，秋季，七月丙午，文帝下诏书说：怎么能够因为我们派遣一位将军灭掉了一个小国，引起了内外远近的注意，便说现在已经天下太平	左卫大将军广平王雄，贵宠特盛，与高、虞庆则、苏威称为四贵
以朕的薄德去封禅泰山，拿虚言狂语去祭告上天，这不是朕所愿意听到的建议	雄宽容下士，朝野倾属，上恶其得众，阴忌之，不欲其典兵马；八月，壬戌，以雄为司空，实夺之权
从今以后，禁止任何人再提及封禅之事	雄既无职务，乃杜门不通宾客
春季，正月乙未，隋朝册封皇孙杨昭为河南王，杨楷为华阳王	二月，上幸晋阳，命高居守
杨昭是晋王杨广的儿子	夏，四月，辛酉，至自晋阳
六月辛酉，隋朝规定百姓年满五十岁免除徭役，改为收庸代役	秋，七月，癸卯，以纳言杨素为内史令
秋季，七月癸卯，隋朝任命纳言杨素为内史令	冬，十一月，辛丑，上祀南郊
沛达公郑译去世	春，二月，己巳，以蜀王秀为内史令兼右领军大将军
己巳，隋文帝到太庙祭祀祖先	壬申晦，日有食之
壬申晦，出现日食	帝以天下用律者多驳，罪同论异，八月，甲戌，制：诸州死罪，不得辄决，悉移大理按覆，事尽，然后上省奏裁
春季，正月壬子，隋文帝祭祀感生帝	壬戌，行幸岐州
丁酉，隋文帝下制书说：民间私家不得收藏预卜吉凶的纬候、图谶之类的书籍	秋，七月，戊辰晦，日有食之
二月丙辰，隋文帝下令收缴天下兵器，民间敢有私自制造者问罪；关中和沿边地区不在此例	三月，己未，至自东巡
夏季，四月己丑朔，隋朝大赦天下	六月，戊子，诏凿底柱
六月戊子，隋文帝下诏令凿开黄河中的底柱山	庚寅，相州刺史豆卢通贡绫文布，命焚之于朝堂
十一月辛酉，隋文帝驾幸骊山温泉	十二月，戊子，敕：盗边粮一升已上，皆斩，仍藉没其家
十二月戊子，隋文帝下敕书说：凡是盗取边疆军粮一升以上，都要斩首，并且没收全部家产	己丑，诏文武官以四考受代
春季，正月丁亥，隋朝册封皇孙杨裕为平原王，杨筠为安城王，杨嶷为安平王，杨恪为襄城王，杨该为高阳王，杨韶为建安王，杨为颍川王，他们都是皇太子杨勇的儿子	夏，六月，甲午，初制工商不得仕进
夏季，六月甲午，隋朝首次下制令工商业者不得做官	秋，八月，丙戌，诏：决死罪者，三奏然后行刑
秋季，八月丙戌，隋文帝下诏书说：判决死刑的罪犯，必须呈奏三次，然后才能行刑	冬，十月，己丑，上幸长春宫；十一月，壬子，还长安
冬季，十月己丑，文帝回到长安	党项寇会州，诏发陇西兵讨降之
党项人侵犯会州，文帝下诏令调发陇西的军队讨伐并降附了党项族	党以光化公主妻吐谷浑可汗世伏；世伏上表请称公主为天后，上不许
六月丙寅，隋文帝下诏废黜高丽王高元的官爵	辛卯，上至自仁寿宫
汉王杨谅率军从临渝关出塞，正碰上连日大雨，后方粮草运不到，军中缺乏食粮，又	
辛卯，隋文帝从仁寿宫回到长安	冬，十一月，癸未，上祀南郊
冬季，十一月癸未，隋文帝在南郊举行祭天大典	十二月，自京师至仁寿宫，置行宫十有二所
春季，正月癸酉，隋朝大赦天下罪人	二月，甲寅，上幸仁寿宫
春，正月，乙酉朔，赦天下，改元	春季，正月，乙酉朔，大赦天下，改年号
以尚书右仆射杨素为左仆射，纳言苏威为右仆射	任命尚书右仆射杨素为左仆射，纳言苏威为右仆射
丁酉，徙河南王昭为晋王	丁酉，改封河南王杨昭为晋王
突厥步迦可汗犯塞，败代州总管韩弘于恒安	突厥的步迦可汗率兵侵犯边塞，在恒安击败代州总管韩弘
以晋王昭为内史令	任命晋王杨昭为内史令
二月，乙卯朔，日有食之	二月，乙卯朔，出现日食
夏，五月，己丑，突厥男女九万口来降	夏季，五月，己丑，有突厥男女九万人来归附
六月，乙卯，遣十六使巡省风俗	六月，乙卯，文帝派遣十六名使者到各地巡视风俗
乙丑，诏以天下学校生徒多而不精，唯简留国子学生七十人，太学、四门及州县学并废	乙丑，文帝颁诏，认为天下学校的学生多而不精，经过选拔，只留国子监的学生七十人，太学、四门及各州、县的学校一并停办
殿内将军河间刘炫上表切谏；不听	殿内将军河间人刘炫呈上奏表恳切劝说，文帝不听
秋，七月，改国子学为太学	秋季，七月，改国子学为太学
初，帝受周禅，恐民心未服，故多称符瑞以耀之，其伪造而献者，不可胜计	当初，文帝受北周的禅让，他怕民心不服，因此就用很多符瑞现象来表明自己受禅是符合天意的
冬，十一月，己丑，有事于南郊	伪造符瑞进献的人多得数不过来
如封禅礼，版文备述前后符瑞以报谢云	冬季，十一月，己丑，到京师南郊举行祭天典礼，所上版文详细叙述符瑞现象出现的前后情况以报谢上天
诏以杨素为云州道行军元帅，长孙晟为受降使者，挟启民可汗北击步迦	文帝下诏任命杨素为云州道行军元帅，长孙晟为受降使者，带领启民可汗向北进攻步迦可汗
春，三月，己亥，上幸仁寿宫	春季，三月，己亥，文帝驾临仁寿宫
益州总管蜀王秀，容貌伟，有胆气，好武艺	益州总管蜀王杨秀，容貌奇特雄伟，有胆量气魄，喜好武艺
帝每谓独孤后曰：秀必以恶终，我在当无虑，至兄弟，必反矣	文帝常对独孤皇后说：杨秀肯定会不得好死，我活着他还不会出什么问题，要是他兄弟当政，他一定会造反
大将军刘哙之讨西也，帝令上开府仪同三司杨武通将兵继进	大将军刘哙去讨伐西的时候，文帝命令上开府仪同三司杨武通率兵随后出发
秀以嬖人万智光为武通行军司马	杨秀任命一个受他宠信的叫万智光的人作杨武通的行军司马
帝以秀任非其人，谴责之，因谓群臣曰：坏我法者，子孙也	文帝认为杨秀任命的人不称职，就责备他，并对群臣说：破坏我的法度的是我的子孙
譬如猛虎，物不能害，反为毛间虫所损食耳	就好比猛虎，别的动物不能伤害它，它反而被毛间虫损害、蚕食一样
遂分秀所统	于是削减了杨秀统领的辖区
八月，甲子，皇后独孤氏崩	八月，甲子，皇后独孤氏去世
太子对上及宫人哀恸绝气，若不胜丧者；其处私室，饮食言笑如平常	太子杨广当着文帝和宫人的面悲痛欲绝，好象是不胜哀痛，而在自己府内饮食谈笑如同平常
又，每朝令进二溢米，而私令取肥肉脯，置竹桶中，以蜡闭口，衣袱裹而纳之	另外，杨广每天早上命令进米二溢，私下却命令取来肥肉、干肉、酿鱼肉，装在竹筒里以蜡封口，用衣帕包起来偷偷运入府内
九月，丙戌，上至自仁寿宫	九月，丙戌，文帝从仁寿宫回来
冬，十月，癸丑，以工部尚书杨达为纳言	冬季，十月，癸丑，任命工部尚书杨达为纳言
达，雄之弟也	杨达是杨雄的弟弟
闰月，甲申，诏杨素、苏威与吏部尚书牛弘等修定五礼	闰月，甲申，文帝下诏命杨素、苏威和吏部尚书牛弘等人修定五礼
蜀王秀至长安，上见之，不与语；明日，使使切让之	蜀王杨秀到了长安，文帝见到他，不和他说话
秀谢罪，太子诸王流涕庭谢	第二天，派一个使者严厉责备他
上曰：顷者秦王糜费财物，我以父道训之	杨秀谢罪，太子杨广和其他的几个王都流泪谢罪，文帝说：原先秦王杨俊浪费财物，我曾用父道来训斥他；现在杨秀残害百姓，我应该用为君之道来制裁他
今秀蠹害生民，当以君道绳之	于是就把杨秀交付执法官员
于是付执法者	开府仪同三司庆整劝文帝说：庶人杨勇已被废黜，秦王已经死了，陛下的儿子现在不多了，何必这样
开府仪同三司庆整谏曰：庶人勇既废，秦王已薨，陛下见子无多，何至如是	蜀王杨秀性格耿直独特，如今被重责，恐怕他难以保全
蜀王性甚耿介，今被重责，恐不自全	文帝勃然大怒，要割掉庆整的舌头
上大怒，欲断其舌，因谓群臣曰：当斩秀于市以谢百姓	接着他对群臣说：应该把杨秀在闹市斩首向百姓谢罪
乃令杨素等推治之	于是就命令杨素等人对杨秀追究治罪
秋，八月，壬申，赐幽州总管燕荣死	秋季，八月，壬申，文帝将幽州总管燕荣赐死
荣性严酷，鞭挞左右，动至千数	燕荣性情严酷，鞭笞身边的人往往到上千下
尝见道次丛荆，以为堪作杖，命取之，辄以试人	他曾经看到路旁长的一丛丛荆条，认为可以作杖，命人取来，立即就以人来试
人或自陈无罪，荣曰：后有罪，当免汝	有人说自己无罪，燕荣就说：以后你有罪再免掉你受杖刑
既而有犯，将杖之，人曰：前日被杖，使君许以有罪宥之	不久这人有了过失，燕荣又要鞭打他，被打的人说：上次被打，您答应以后有罪就宽恕我
荣曰：无罪尚尔，况有罪邪	燕荣说：无罪尚且要打，何况有罪呢
杖之自若	燕荣鞭打人却神情自若
九月，壬戍，置常平官	九月，壬戍，设置常平官
春，正月，丙午，赦天下	春季，正月，丙午，大赦天下
冬，十月，己卯，葬文皇帝于太陵，庙号高祖，与文献皇后同坟异穴	冬季，十月，己卯，文帝葬于太陵，庙号高祖，与独孤皇后同坟异穴
诏除妇人及奴婢，部曲之课，男子二十二成丁	炀帝下诏免除妇女及奴婢、部曲的赋税，规定男子二十二岁成丁
丙申，发丁男数十万掘堑，自龙门东接长平、汲郡，抵临清关，渡河至浚仪、襄城，达于上洛，以置关防	丙申，炀帝征发男丁几十万人挖掘沟，从龙门东接长平、汲郡，到临清关，越过黄河至浚仪、襄城，到达上洛，用来布置关防
壬子，陈叔宝卒；赠大将军、长城县公，谥曰炀	壬子，南陈国后主陈叔宝去世，被追赠为大将军、长城县公，谥号为炀
癸丑，下诏于伊洛建东京，仍曰：宫室之制，本以便生，今所营构，务从俭约	癸丑，炀帝下诏在伊、洛营建东京，诏书说：宫室的规制，本应从方便使用出发，现在营建的宫室，务必要节俭
蜀王秀之得罪也，右卫大将军元胄坐与交通除名，久不得调	蜀王杨秀获罪的时候，右卫大将军元胄因犯有与杨秀结交往来的罪而被除名，长期不得起用
时慈州刺史上官政坐事徙岭南，将军丘和以蒲州失守除名，胄与和有旧，酒酣，谓和曰：上官政，壮士也，今徙岭表，得无大事乎	当时慈州刺史上官政因犯罪被流放到岭南，将军丘和因为蒲州失守被除名，元胄与丘和有旧谊，两人饮酒酣，元胄对丘和说：上官政是壮士，现在被流放到岭表，不会出大事吧
因自拊腹曰：若是公者，不徒然矣	他抚摩着肚子说：像此公这样的人，就不会不出事了
和奏之，胄竟坐死	丘和将此话报告炀帝，元胄竟然因此获罪而死
于是征政为骁卫将军，以和为代州刺史	于是炀帝召回上官政任命为骁骑将军，任命丘和为代州刺史
春，正月，壬辰朔，赦天下，改元	春季，正月，壬辰朔，大赦天下，改年号
立妃萧氏为皇后	炀帝册立王妃萧氏为皇后
废诸州总管府	炀帝下诏撤销各州的总管府
丙辰，立晋王昭为皇太子	丙辰，炀帝立晋王杨昭为皇太子
二月，戊辰，敕有司大陈金宝、器物、锦彩、车马，引杨素及诸将讨汉王琼有功者立于前，使奇章公牛弘宣诏，称扬功伐，赐赉各有差	二月，戊辰，炀帝命令有关部门官员大规模地陈列金宝、器物、锦彩、车马，让人领着杨素和各位讨伐汉王杨谅有功的将领站在前面，命令奇章公牛弘宣读诏书，称赞讨伐杨谅的功劳，炀帝对他们分别进行赏赐
素等再拜舞蹈而出	杨素等人再三拜谢舞蹈而去
己卯，以素为尚书令	乙卯，任命杨素为尚书令
诏天下公除，惟帝服浅色黄衫、铁装带	炀帝颁诏于天下，除去丧服，只有炀帝身穿浅色黄衫，束着铁饰的衣带
三月，丁未，诏杨素与纳言杨达、将作大匠宇文恺营建东京，每月役丁二百万人，徙洛州郭内居民及诸州富商大贾数万户以实之	三月，丁未，炀帝下诏派杨素和纳言杨达、将作大匠宇文恺营建东京，每个月役使壮丁二百万人，迁徙洛州城内的居民和各州的富商大贾几万户充实东京
废二崤道，开册道	废弃二崤道，开辟册道
春，正月，辛酉，东京成，进将作大匠宇文恺位开府仪同三司	春季，正月，辛酉，东京建成，炀帝提升将作大匠宇文恺为开府仪同三司
丁卯，遣十使并省州县	丁卯，炀帝派十名使者合并简省州县
六月，壬子，以杨素为司徒；进封豫章王为齐王	六月，壬子，炀帝任命杨素为司徒；进封豫章王杨为齐王
元德太子昭自长安来朝，数月，将还，欲乞少留；帝不许	元德太子杨昭从长安来朝见炀帝，几个月后要返回长安
拜请无数，体素肥，因致劳疾，甲戌，薨	他想乞求允许再留住一些时候，炀帝不许，杨昭跪拜请求了无数次，他身体本来就很胖，因此得病，甲戌，太子杨昭去世
帝哭之，数声而止，寻奏声伎，无异平日	炀帝哭了几声就罢了，寻欢作乐，声色歌妓，与平常没什么两样
八月，辛卯，封皇孙为燕王，侗为越王，侑为代王，皆昭之子也	八月，辛卯，炀帝封皇孙杨为燕王，杨侗为越王，杨侑为代王，他们都是杨昭的儿子
九月，乙丑，立秦孝王子浩为秦王	九月，乙丑，炀帝立秦孝王的儿子杨浩为秦王
帝以高祖末年，法令峻刻，冬，十月，诏改修律令	炀帝认为文帝晚年法令严峻苛细，冬季，十月，下诏修改法律条文
春，正月，朔旦，大陈文物	春季，正月，朔旦，大规模地陈列、表演礼仪和技艺
时突厥启民可汗入朝，见而慕之，请袭冠带，帝不许	当时突厥启民可汗入朝，看到这一场面非常倾慕，请求袭用隋朝服饰，炀帝没有允许
明日，又率其属上表固请，帝大悦，谓牛弘等曰：今衣冠大备，至单于解辫，卿等功也	第二天，启民可汗又率领他的部属向炀帝上表恳切请求，炀帝非常高兴，对牛弘等人说：如今公卿服饰制度完备，致使单于改易朝服，这是你们的功劳
各赐帛甚厚	各自赏赐他们很丰厚的财物
三月，辛亥，帝还长安	三月，辛亥，炀帝返回长安
癸丑，帝使羽骑尉朱宽入海求访异俗，至流求国而还	癸丑，炀帝派遣羽骑尉朱宽出海求访异国风俗，朱宽到达流求国后返回
夏，四月，庚辰，下诏欲安辑河北，巡省赵、魏	夏季，四月，庚辰，炀帝下诏要安抚管理河北，巡视检查赵、魏之地
牛弘等造新律成，凡十八篇，谓之《大业律》；甲申，始颁行之	牛弘等人制定新法律，共十八篇，称之为《大业律》；甲申，开始颁布施行
民久厌严刻，喜于宽政	百姓久已厌恶法律严酷苛繁，对宽政十分高兴
其后征役繁兴，民不堪命，有司临时迫胁以求济事，不复用律令矣	但后来频繁的劳役征发，使百姓无法忍受，官吏们常常临时胁迫百姓服役以应付差使，也就不再按律令执行了
旅骑尉刘炫预修律令，弘尝从容问炫曰：《周礼》士多而府史少，今令史百倍于前，减则不济，其故何也	旅骑尉刘炫参与修订律令，牛弘曾从容地问刘炫：《周礼》记载是士多而吏员少，现在吏员比从前多出百倍，减少则无法应付事务，这是什么原因呢
炫曰：古人委任责成，岁终考其殿最，案不重校，文不繁悉，府史之任，掌要目而已	刘炫说：古人委任吏员须要有责任有成绩，年终考核成绩，案卷不用重新审理，文牍不求繁多琐碎，吏员的责任，只是掌握工作的要点而已
今之文簿，恒虑覆治，若锻炼不密，则万里追证百年旧案	现在的吏员总是担心文簿要重新审理考核，假若文辞考虑不周密，就会不远万里去追查印证百年的旧案
故谚云：老吏抱案死	所以有谚语说：老吏伏抱文案而死
事繁政弊，职此之由也	事物繁杂这是为政的弊端，这就是吏员多而效率低的原因
弘曰：魏、齐之时，令史从容而已，今则不遑宁处，何故	牛弘说：北魏、北齐之时，吏员们办事很从容，现在则忽忽忙忙不得安宁，这是什么缘故
炫曰：往者州唯置纲纪，郡置守、丞，县置令而已	刘炫说：过去州只设置长吏、司马，郡只设置郡守、郡丞，县仅设县令而已
其余具僚则长官自辟，受诏赴任，每州不过数十	其余应配备的僚属，则由长官自己挑选任命，得到诏命后就赴任，每州吏员不过几十人
今则不然，大小之官，悉由吏部，纤介之迹，皆属考功	如今则不然，大大小小的官吏，全部由吏部掌管，零零碎碎的事务都属于考绩范围
省官不如省事，官事不省而望从容，其可得乎	减少官吏不如减少事务，官员们的事务不减，却希望他们办事从容，那可能吗
弘善其言而不能用	牛弘很同意刘炫的话，但却不能采纳
壬辰，改州为郡；改度量权衡，并依古式	壬辰，炀帝改州为郡；改度、量、衡，全部依照古式
改上柱国以下官为大夫；置殿内省，与尚书、门下、内史、秘书为五省；增谒者、司隶台，与御史为三台；分大府寺置少府监，与长秋、国子、将作、都水为五监；又增改左、右翊卫等为十六府；废伯、子、男爵，唯留王、公、侯三等	改上柱国以下的官为大夫；设置殿内省与尚书、门下、内史、秘书省共为五省；增设谒者台、司隶台与御史台并为三台；分太府寺设置少府监，与长秋、国子、将作、都水为五监；又增改左、右翊卫等为十六府；废除伯、子、男的爵位，只留王、公、侯三等爵位
初，高祖受禅，唯立四亲庙，同殿异室而已，帝即位，命有司议七庙之制	当初，文帝受周禅，只立了四亲庙，而且是同殿异室而已
礼部侍郎摄太常少卿许善心等奏请为太祖、高祖各立一殿，准周文、武二祧，与始祖而三，余并分室而祭，从迭毁之法	炀帝即位，命令有关部门讨论建七庙的定制，礼部侍郎代行太常少卿许善心等奏请为太祖、高祖各建一座殿，依据周文王、周武王宗庙的标准，与始祖共建立三座殿，其余的人都分室祭祀，按照亲尽庙毁之法祭祀
至是，有司请如前议，于东京建宗庙	于是，有关部门奏请炀帝按上述议定的那样，在东京建立宗庙
帝谓秘书监柳曰：今始祖及二祧已具，后世子孙处朕何所	炀帝对秘书监柳说：如今始祖与文、武王的宗庙都已具备，后世子孙把我又放到什么位置上呢
六月，丁亥，诏为高祖建别庙，仍修月祭礼	六月，丁亥，炀帝下诏为文帝另建宗庙，太阴在丙之月祭祀
既而方事巡幸，竟不果立	不久之后炀帝就忙于巡游之事，竟终于没有建立
帝过雁门，雁门太守丘和献食甚精；至马邑，马邑太守杨廓独无所献，帝不悦	炀帝巡游经过雁门，雁门太守丘和进献的食物非常精美；他到了马邑，唯独马邑太守杨廓无所献，炀帝很不高兴
以和为博陵太守，仍使廓至博陵观和为式	他任命丘和为博陵太守，让杨廓到博陵去向丘和学习
由是所至献食，竞为丰侈	由此炀帝所到之处所进献的食物，竞相丰富奢侈
壬申，以齐王为河南尹；癸酉，以民部尚书杨文思为纳言	壬申，任命民部尚书杨文思为纳言
冬，十月，敕河南诸郡送一艺户陪东都三千余家，置十二坊于洛水南以处之	冬季，十月，敕命河南各郡送一艺户到东京来辅助原有的三千余家艺户，在洛水以南设置十二坊来安置他们
铁勒寇边，帝遣将军冯孝慈出敦煌击之，不利	铁勒入侵边界，炀帝派将军冯孝慈率军出敦煌阻击铁勒，出师不利
铁勒寻遣使谢罪，请降；帝使裴矩慰抚之	不久铁勒人派遣使者来谢罪，请求归降，炀帝派裴矩安抚慰籍他们
春，正月，乙巳，诏发河北诸军五百余万穿永济渠，引沁水南达于河，北通涿郡	春季，正月，乙巳，炀帝下诏征发黄河以北各军一百多万人开凿永济渠，引沁水向南到黄河，向北通涿郡
丁男不供，始役妇人	男丁不足，开始役使妇女
壬申，以太府卿元寿为内史令	壬申，任命太府卿元寿为内史令
三月，壬戌，倭王多利思比孤贡，遗帝书曰：日出处天子致书日没处天子无恙	三月，壬戌，倭王多利思比孤派人来朝贡，给炀帝的书信上说：日出处的天子致书信给日没处的天子，您可好吗
帝览之，不悦，谓鸿胪卿曰：蛮夷书无礼者，勿复以闻	炀帝看后很不高兴，对鸿胪卿说：蛮夷人的书信凡无礼的，就不要再给我看了
乙丑，车驾幸五原，因出塞巡长城	乙丑，炀帝到达五原，就此出塞巡视长城
行宫设六合板城，载以枪车	炀帝的行宫设置木制的六合城，城上载有枪车
每顿舍，则外其辕以为外围，内布铁菱；次施弩床，皆插钢锥，外向；上施旋机弩，以绳连机，人来触绳，则弩机旋转，向所触而发	每次停下驻宿，则把车辕朝外作为外围，内布铁蒺藜；再安设弩床，都插上钢锥，锥向外；上面装置旋机弩，用绳子系在弩的板机上，只要有人触动绳子，弩机就旋转，向触动的方向发射
其外又以周围，施铃柱、槌磐以知所警	在弩外周围又布置能弋射的短箭，并装设铃柱、木槌、石磐用来报警
乙卯，诏以突厥启民可汗遵奉朝化，思改戎俗，宜于万寿戍置城造屋，其帷帐床褥以上，务从优厚	乙卯，炀帝下诏说，突厥启民可汗遵奉朝廷的感化，想改变戎狄的习俗，可以在万寿戌建立城池修造房屋，他们所用的帷帐、床褥等等物品，务必从优供应
秋，七月，辛巳，发丁男二十余万筑长城，自榆谷而东	秋季，七月，辛巳，炀帝征发壮丁二十余万人修筑长城，从榆谷向东
八月，辛酉，上亲祠恒岳，赦天下	八月，辛酉，炀帝亲自到恒山去祭祀，下诏大赦天下
河北道郡守毕集，裴矩所致西域十余国皆来助祭	河北道的郡守都集中到恒山，裴矩所罗致的西域十几个国家的使者都前来助祭
冬，十月，乙卯，颁新式	冬季，十月，乙卯，颁布新的度、量、衡制度
春，正月，丙子，改东京为东都	春季，正月，丙子，炀帝改东京为东都
癸未，诏天下均田	癸未，炀帝下诏，天下实行均田制
戊子，上自东都西还	戊子，炀帝从东都回西京
己丑，制民间铁叉、搭钩、刃之类皆禁之	己丑，规定民间铁叉、搭钩、刀之类都属于违禁之物
二月，戊申，车驾至西京	二月，戊申，炀帝的车驾到达西京
帝大阅军实，称器甲之美，宇文述因进言：此皆云定兴之功	炀帝大规模地检查了军用器械，他称赞器械、铠甲的精美，宇文述趁机说：这都是云定兴的功劳
帝即擢定兴为太府丞	炀帝就提升云定兴为太府丞
春，正月，癸亥朔，未明三刻，有盗数十人，素冠练衣，焚香持华，自称弥勒佛，入自建国门，监门者皆稽首	春季，正月，癸亥朔，早晨，差三刻天亮时，有盗贼几十名，头戴白帽，衣穿白衣，焚着香，手持花，自称是弥勒佛，从建国门进入，看门的人都跪下叩头，接着这些人就夺取卫士的兵器，即将作乱
既而夺卫士仗，将为乱；齐王遇而斩之	齐王杨遇见，率兵将这些人杀死
于是都下大索，连坐者千余家	于是京师大肆搜捕，受牵连而获罪的有一千余家
乙卯，诏以近世茅土妄假，名实相乖，自今唯有功勋乃得赐封，仍令子孙承袭	乙卯，炀帝下诏，近年来封侯进爵，名不符实，从今以后，只有建有功勋的人才能得到赐土封爵，仍让子孙承袭爵位
于是旧赐五等爵，非有功者皆除之	于是过去赐的五等爵，没有功勋的都被削去爵位
庚申，以所征周、齐、梁、陈散乐悉配太常，皆置博士弟子以相传授，乐工至三万余人	庚申，把所征召来的周、齐、梁、陈四朝的散乐艺人，都安排在太常，都设置博士弟子以便相互传授技艺，乐工达到三万余人
三月，癸亥，帝幸江都宫	三月，癸亥，炀帝驾游江都营
夏，六月，甲寅，制江都太守秩同京尹	夏季，六月，甲寅，规定江都太守的品级与京尹相同
敕穿江南河，自京口至馀杭，八百余里，广十余丈，使可通龙舟，并置驿宫、草顿，欲东巡会稽	炀帝命令开凿江南河，自京口至余杭，长八百余里，宽十余丈，使之可以通行龙舟，并在沿岸设置驿宫、临时停顿处，打算向东巡游会稽
帝之幸启民帐也，高丽使者在启民所，启民不敢隐，与之见帝	炀帝到启民可汗营帐的时候，恰好高丽使者也在启民的帐里，启民不敢隐瞒，就让他觐见炀帝
黄门侍郎裴矩说帝曰：高丽本箕子所封之地，汉、晋皆为郡县；今乃不臣，别为异域	黄门侍郎裴矩劝炀帝说：高丽本是西周时箕子的封地，汉、晋时代都是中国的郡县，如今却不称臣，成了一个国家
先帝欲征之久矣，但杨谅不肖，师出无功	先帝很长时间就想征伐高丽，但是由于杨谅不成器，以致师出无功
当陛下之时，安可不取，使冠带之境，遂为蛮貊之乡乎	陛下您君临天下之时，怎能不征伐它，而使文明礼仪之境，成为荒凉野蛮的地方呢
今其使者亲见启民举国从化，可因其恐惧，胁使入朝	今天高丽的使者亲眼看到启民举国归化中国，可以趁他恐惧时，胁迫高丽派遣使者入朝
帝从之	炀帝采纳了这个意见
敕牛弘宣旨曰：朕以启民诚心奉国，故亲至其帐	让牛弘宣读诏旨说：朕因为启民诚心地尊奉中国，所以亲自来到他的营帐
明年当往涿郡，尔还日语高丽王：勿自疑惧，存育之礼，当如启民	明年朕将要去涿郡，你回去时告诉高丽王：不要心怀疑虑，只要报答朕养育之恩的礼仪，朕会象对待启民一样对待你们
苟或不朝，将帅启民往巡彼土	但是，假如不来朝见，朕将率领启民去巡视你的国土
高丽王元惧，藩礼颇阙，帝将讨之；课天下富人买武马，匹至十万钱；简阅器仗，务令精新，或有滥恶，则使者立斩	高丽王高元很害怕，但蕃国进觐的礼却很少，炀帝要讨伐高丽；命令天下的富人买军马，每匹价至十万钱；命人挑选、查验兵器和仪仗，要求务必精、新，若发现有粗制滥造的，检查官立即斩首
山东、河南大水，漂没三十余郡	山东、河南发大水，淹没三十余郡
冬，十月，乙卯，底柱崩，偃河逆流数十里	冬季，十月，乙卯，黄河的砥柱崩塌，堵塞河道，使河水逆流几十里
初，嵩高道士潘诞自言三百岁，为帝合炼金丹	当初，嵩高山的道士潘诞，自称有三百岁，他为炀帝合炼金丹
帝为之作嵩阳观，华屋数百间，以童男童女各一百二十人充给使，位视三品；常役数千人，所费巨万	炀帝为他建造嵩阳观，观内有华丽的房屋几百间，配给童男童女各一百二十人供潘诞使用，潘诞的地位相当于三品官员
云金丹应用石胆、石髓，发石工凿嵩高大石深百尺者数十处	他经常役使几千人，花费的钱财巨万
凡六年，丹不成	潘诞说炼金丹得用石胆、石髓，于是就征发石工开凿嵩高山的大石头，凿石深达百尺，共开凿了几十处，前后用了六年时间，金丹没有炼成
帝诘之，诞对以无石胆、石髓，若得童男女胆髓各三斛六斗，可以代之	炀帝责问他，潘诞回答说：没有石胆、石髓，要是得到童男童女的胆、髓各三斛六斗，也可以代替石胆、石髓
帝怒，锁诣涿郡，斩之	炀帝大怒，将潘诞枷锁押往涿郡斩首
且死，语人曰：此乃天子无福，值我兵解时至，我应生梵摩天云	潘诞临死时还对人说：这是天子没有福气，待我为兵器所杀蜕骨登仙之时，我就升于梵摩天了等等
甲辰，内史令元寿薨	甲辰，内史令元寿去世
二月，壬戌，观德王雄薨	二月，壬戌，观德王杨雄去世
夏，五月，壬午，纳言杨达薨	夏季，五月，壬午，纳言杨达去世
冬，十月，甲寅，工部尚书宇文恺卒	冬季，十月，甲寅，工部尚书宇文恺去世
十一月，己卯，以宗女为华容公主，嫁高昌	十一月，己卯，炀帝以宗室女为华容公主，嫁给高昌
宇文述素有宠于帝，且其子士及尚帝女南阳公主，故帝不忍诛	宇文述向来就受到炀帝的宠信，而且他的儿子宇文士及娶了炀帝的女儿南阳公主，因此炀帝不忍处死宇文述
甲申，与于仲文等皆除名为民，斩刘士龙以谢天下	甲申，宇文述与于仲文等都被除名为民，刘士龙被斩首以谢罪天下
萨水之败，高丽追围薛世雄于白石山，世雄奋击，破之，由是独得免官	萨水之败，高丽军在白石山追击围困薛世雄军，薛世雄奋勇攻击，将高丽军打败，因此薛世雄单独受到免官的处分
以卫文为金紫光禄大夫	任命卫文为金紫光禄大夫
诸将皆委罪于于仲文，帝既释诸将，独系仲文	诸将都把罪过推到于仲文身上，炀帝也就释放了诸将，只把于仲文关押起来
仲文忧恚，发病困笃，乃出之，卒于家	于仲文忧愤成病，发病急重，于是放他出狱，在家中去世
是岁，大旱，疫，山东尤甚	这一年，国内大旱，疫病流行，崤山以东尤其严重
春，正月，丁丑，诏征天下兵集涿郡	春季，正月，丁丑，炀帝下诏征召天下之兵在涿郡集结，开始招募平民为骁果
始募民为骁果，修辽东古城以贮军粮	修辽东古城以贮备军粮
灵武贼帅白瑜娑劫掠牧马，北连突厥，陇右多被其患，谓之奴贼	灵武的贼帅白瑜娑劫掠牧马，北联突厥，陇右地区多受到白瑜娑的侵扰，人们称之为奴贼
戊戌，赦天下	戊戌，大赦天下
己亥，命刑部尚书卫文升等辅代王侑留守西京	己亥，炀帝命令刑部尚书卫文升等人辅佐代王杨侑留守西京
帝谓侍臣曰：高丽小虏，侮慢上国；今拔海移山，犹望克果，况此虏乎	炀帝对侍臣说：高丽这个小虏，竟敢侮慢我隋朝上国，如今就是拔海移山，也是可以办到的，何况这个小虏呢
乃复议伐高丽	于是又商议出兵征伐高丽
左光禄大夫郭荣谏曰：戎狄失礼，臣下之事；千钧之弩，不为鼷鼠发机，奈何亲辱万乘以敌小寇乎	左光禄大夫郭荣劝道：戎狄之国无礼，是臣子应该处理的事情，千钧之弩，不会为小老鼠而发射，陛下何必亲自征讨这样的小小敌寇呢
帝不听	炀帝不听
三月，丙子，济阴孟海公起为盗，保据周桥，众至数万，见人称引书史，辄杀之	三月，丙子，济阴人孟海公起事为盗，据守周桥，孟海公拥有部众几万人，他见到有引用书、史的人就杀掉
丁丑，发丁男十万城大兴	丁丑，炀帝下诏征发男丁十万人筑大兴城
戊寅，帝幸辽东，命民部尚书樊子盖等辅越王侗留守东都	戊寅，炀帝驾临辽东，他命令民部尚书樊子盖等人辅佐越王杨侗留守东都
夏，四月，庚午，车驾渡辽	夏季，四月，庚午，炀帝的车驾渡过辽水
壬申，遣宇文述与上大将军杨义臣趣平壤	壬申，炀帝派遣宇文述和上大将军杨义臣率军进军平壤
九月，己卯，东海民彭孝才起为盗，有众数万	九月，己卯，东海人彭孝才聚众为盗，拥有部众数万人
甲午，车驾至上谷，以供费不给，免太守虞荷等官	甲午，炀帝车驾到达上谷，因为供给接济不上，炀帝就免去了太守虞荷等人的官职
闰月，己巳，幸博陵	闰月，己己，炀帝到达博陵
冬，十月，丁丑，贼帅吕明星围东郡，虎贲郎将费青奴击破之	冬季，十月，丁丑，贼帅吕明星包围了东郡，虎贲郎将费青奴将吕明星击败
十一月，己酉，右候卫将军冯孝慈讨张金称于清河，孝慈败死	十一月，己酉，右候卫将军冯孝慈在清河讨伐张金称，冯孝慈兵败身亡
帝召卫文升、樊子盖诣行在；慰劳之，赏赐极厚，遣还所任	炀帝召卫文升、樊子盖到他的行在，对他们加以慰劳，赏赐极为丰厚，然后让他们返回自己的任所
是岁，诏为盗者籍没其家	这一年炀帝下诏凡作盗贼的人其家属财产都要被官府没收
时群盗所在皆满，郡县官因之各专威福，生杀任情矣	当时到处都是盗贼，郡县官吏因此各自作威作福，任意地对百姓生杀予夺
丁酉，扶风贼帅唐弼立李弘芝为天子，有众十万，自称唐王	丁酉，扶风的贼帅唐弼拥立李弘芝为天子，拥有部众十万人，他自称唐王
三月，壬子，帝行幸涿郡，士卒在道，亡者相继	三月，壬子，炀帝出行到涿郡，路途中士兵不断逃亡
癸亥，至临渝宫，祭黄帝，斩叛军者以衅鼓，亡者亦不止	癸亥，炀帝到达临渝宫，在野外祭祀黄帝，斩杀叛逃的士兵并将死者的血涂在鼓上，但逃亡仍然不止
夏，四月，榆林太守成纪董纯与彭城贼帅张大虎战于昌虑，大破之，斩首万余级	夏季，四月，榆林太守成纪人董纯与彭城贼帅张大虎在昌虑交战，董纯大败张大虎，斩首万余级
甲午，车驾至北平	甲午，炀帝车驾到达北平
乙巳，有事于南郊，上不斋于次	乙巳，在西京南郊举行祭祀活动
诘朝，备法驾，至即行礼	炀帝没在斋宫斋戒
是日，大风	早晨，炀帝摆设法驾，到南郊行祭礼
上独献上帝，三公分献五帝	这一天刮起大风，炀帝单独向上帝献祭，三公分别向五帝献祭
礼毕，御马疾驱而归	祭礼完毕，炀帝车驾迅速驰返皇宫
乙卯，离石胡刘苗王反，自称天子，众至数万；将军潘长文讨之，不克	乙卯，离石郡的胡人刘苗王率众造反，他自称天子，拥有部众几万人，将军潘长文率兵讨伐刘苗王，但未能获胜
汲郡贼帅王德仁拥众数万，保林虑山为盗	汲郡贼帅王德仁拥有部众几万人，在林虑山据守为盗
帝以户口逃亡，盗贼繁多，二月，庚午，诏民悉城居，田随近给	炀帝因为户口逃亡，盗贼繁多，二月，庚午，下诏命令百姓都迁入城内居住，田地就近分给
郡县驿亭村坞皆筑城	郡县、驿亭、村坞都修筑城堡
有二孔雀自西苑飞集宝城朝堂前，亲卫校尉高德儒等十余人见之，奏以为鸾，时孔雀已飞去，无可得验，于是百僚称贺	有两只孔雀从西苑一起飞到宝城朝堂前面，亲卫校尉高德儒等十余人看见了孔雀，就奏报炀帝说看见了鸾鸟，这时孔雀已经飞走了，无法验证，于是百官们都向炀帝祝贺
诏以德儒诚心冥会，肇见嘉祥，擢拜朝散大夫，赐物百段，余人皆赐束帛；仍于其地造仪鸾殿	炀帝下诏说，因为高德儒心地虔诚与祥瑞自然吻合，所以才能看见祥瑞征兆，因此，提升他为朝散大夫，赏赐他物品百段，其余的人都赐帛一束，还在孔雀停留的地方营建仪鸾殿
以卫尉少卿李渊为山西、河东抚慰大使，承制黜陟选补郡县文武官，仍发河东兵讨捕群盗	炀帝任命卫尉少卿李渊为山西、河东抚慰大使，奉命承担郡县选补的文武官员的升迁贬退的职责，还负责征发河东之兵讨伐群盗
渊行至龙门，击贼帅毋端儿，破之	李渊率军行进到龙门，进攻贼帅毋端儿并将他打败
秋，八月，乙丑，帝巡北塞	秋季，八月，乙丑，炀帝巡游北塞
杨玄感之乱，龙舟水殿皆为所焚，诏江都更造，凡数千艘，制度仍大于旧者	杨玄感叛乱时，龙舟水殿都被他烧毁，于是炀帝下诏江都再造龙舟水殿，共几千艘，规制比原来的还大
壬申，卢明月帅众十万寇陈、汝	壬申，卢明月率部众十万人进犯陈州、汝州
十二月，庚寅，诏民部尚书樊子盖发关中兵数万击绛贼敬盘陀等	十二月，庚寅，炀帝下诏命令民部尚书樊子盖征发关中士兵几万名进击绛郡贼人敬盘陀等人
子盖不分臧否，自汾水之北，村坞尽焚之，贼有降者皆坑之；百姓怨愤，益相聚为盗	樊子盖不问清红皂白，自汾水以北，村坞都被烧毁，前来投降的贼人全被坑杀
诏以李渊代之	百姓怨恨愤怒，越来越多的人相聚为盗
有降者，渊引置左右，由是贼众多降，前后数万人，余党散入他郡	炀帝下诏用李渊替换樊了盖，再有投降的贼人，李渊就将投降者安置在自己身旁，因此有很多贼人投降，投降的人前后共有几万，其余的贼盗流散到别的郡去了
诏毗陵通守路道德集十郡兵数万人，于郡东南起营苑，周围十二里，内为十六离宫，大抵仿东都西苑之制，而奇丽过之	炀帝下诏命毗陵通守路道德汇集十郡之兵几万人，在毗陵郡城东南营建宫苑，方圆十二里；苑内有十六所离宫，大都模仿东都西苑的规制，但在新颖华丽方面还要超过西苑
又欲筑营于会稽，会乱，不果成	炀帝还打算在会稽建造宫苑，正逢各地造反，未能建成
三月，上巳，帝与群臣饮于西苑水上，命学士杜宝撰《水饰图经》，采古水事二，使朝散大夫黄衮以木为之，间以妓航、酒船，人物自动如生，钟磬筝瑟，能成音曲	三月，上巳节，炀帝与群臣在西苑水上宴饮
	他命令学士杜宝撰写《水饰图经》，收集古代七十二个关于水的故事；让朝散大夫黄衮依故事用木头制成，间杂着乐妓的船只、酒船，
夏，四月，丁巳，大业殿西院火，帝以为盗起，惊走，入西苑，匿草间，火定乃还	夏季，四月，丁巳，大业殿西院起火，炀帝以为盗贼来了，逃入西苑，藏在草丛里，火熄灭后才出来
帝自八年以后，每夜眠恒惊悸，云有贼，令数妇人摇抚，乃得眠	炀帝从大业八年以来每天夜里都睡不安稳，常常惊悸而醒，说有贼，必得命几个妇人摇抚才能入睡
五月，丙戌朔，日有食之，既	五月，丙戌朔，出现日食，是日全食
壬午，帝于景华宫征求萤火，得数斛，夜出游山，放之，光遍岩谷	壬午，炀帝在景华宫征求萤火虫，征得了几斛萤火虫，在夜里游山，把萤火虫放出来，其光亮遍及山谷
秋，七月，壬戌，济景公樊子盖卒	秋季，七月，壬戌，济景公樊子盖去世
江都新作龙舟成，送东都；宇文述劝幸江都，右候卫大将军酒泉赵才谏曰：今百姓疲劳，府藏空竭，盗贼蜂起，禁令不行，愿陛下还京师，安兆庶	江都新制造的龙舟完工，送到东都
帝大怒，以才属吏，旬日，意解，乃出之	宇文述劝炀帝巡游江都，右候卫大将军酒泉人赵才劝阻说：如今百姓疲惫劳苦，国库空竭，盗贼蜂起，禁令不行，希望陛下返回京师，安抚天下百姓
朝臣皆不欲行，帝意甚坚	炀帝勃然大怒，把赵才交司吏处治，过了十天，炀帝才平息了怒气，将赵才放出
无敢谏者	朝中的大臣都不想让炀帝出行，但炀帝去江都之意非常坚决，没有敢于进谏的人
建节尉任宗上书极谏，即日于朝堂杖杀之	建节尉任宗上书极力劝谏，当天就在朝堂上被用杖打死
甲子，帝幸江都，命越王侗与光禄大夫段达、太府卿元文都、检校民部尚书韦津、右武卫将军皇甫无逸、右司郎卢楚等总留后事	甲子，炀帝驾临江都，他命令越王杨侗与光禄大夫段达、太府卿元文都、检校民部尚书韦津、右武卫将军皇甫无逸、右司郎卢楚等人共同负责留守东都之事
津，孝宽之子也	韦津是韦孝宽的儿子
帝以诗留别宫人曰：我梦江都好，征辽亦偶然	炀帝以诗向宫人留别：我梦江都好，征辽亦偶然
奉信郎崔民象以盗贼充斥，于建国门上表谏；帝大怒，先解其颐，然后斩之	奉信郎崔民象以盗贼充斥全国为由，在建国门上表劝阻江都之行，炀帝勃然大怒，先摘掉崔民象的下巴，然后将他处死
戊辰，冯翊孙华举兵为盗	戊辰，冯翊郡人孙华举兵为盗
虞世基以盗贼充斥，请发兵屯洛口仓，帝曰：卿是书生，定犹怯	虞世基以盗贼充斥请求炀帝派兵屯驻在洛口仓，炀帝说：你是书生，必定还是恐惧畏缩
戊辰，车驾至巩	戊辰，炀帝到达巩县，命令有关部门将箕山、公路二府移到洛口仓内，并命令修筑城池以备不测
敕有司移箕山、公路二府于仓内，仍令筑城以备不虞	炀帝到达汜水，奉信郎王爱仁后又上表请求炀帝反回西京，炀帝杀死王爱仁又继续南行
至汜水，奉信郎王爱仁复上表请还西京，帝斩之而行	他到达梁郡，梁郡有人半路拦阻车驾上书说：陛下若是一定要巡游江都，天下就将不是陛下的了
至梁郡，郡人邀车驾上书曰：陛下若遂幸江都，天下非陛下之有	炀帝又将上书人杀死
又斩之	这时，李子通占据海陵，左才相劫掠淮北，杜伏威屯兵于六合，他们各自拥有部众几万人
是时李子通据海陵，左才相掠淮北，杜伏威屯六合，众各数万；帝遣光禄大夫陈棱将宿卫精兵八千讨之，往往克捷	炀帝派光禄大夫陈棱率领宿卫精兵八千人去讨伐各路盗贼，连连取胜
八月，乙巳，贼帅赵万海众数十万，自恒山寇高阳	八月，乙巳，贼帅赵万海率领部众几十万人，从恒山进犯高阳
冬，十月，己丑，许恭公宇文述卒	冬季，十月，己丑，许恭公宇文述去世
初，述子化及、智及皆无赖	当初，宇文述的儿子宇文化及、宇文智及都是无赖之徒，宇文化及曾在东宫侍奉炀帝，炀帝对他宠信亲昵
化及事帝于东宫，帝宠昵之，及即位，以为太仆少卿	炀帝即位，任命宇文化及为太仆少卿
帝幸榆林，化及、智及冒禁与突厥交市，帝怒，将斩之，已解衣辨发，既而释之，赐述为奴	炀帝巡视榆林时，宇文化及和宇文智及违犯禁令与突厥人做买卖，炀帝发怒，要杀掉他们，已经把他们的衣服剥下来头发披散开，随即，炀帝又释放了他们，将他们赐给宇文述为奴仆
智及弟士及，以尚主之故，常轻智及，惟化及与之亲昵	宇文智及的弟弟宇文士及，因为娶了公主的缘故，常常看不起宇文智及，只有宇文化及和他亲近
述卒，帝复以化及为右屯卫将军，智及为将作少监	宇文述去世，炀帝又任命宇文化及为右屯卫将军，宇文智及为将作少监
帝疏薄骨肉，蔡王智积每不自安，及病，不呼医，临终，谓所亲曰：吾今日始知得保首领没于地矣	炀帝对骨肉亲人都疏远、刻薄，蔡王杨智积常常感到不安，他患了病，不请医生治病，临终时对他的亲人说：我今天才知道能够保全脑袋而死于地下
丙辰，窦建德为坛于乐寿，自称长乐王，置百官，改元丁丑	丙辰，窦建德在乐寿县设坛，自称长乐王，设置百官，改年号丁丑
辛巳，鲁郡贼徐圆朗攻陷东平，分兵略地，自琅邪以西，北至东平，尽有之，胜兵二万余人	辛巳，鲁郡贼人徐圆朗攻陷东平，他分兵攻占土地，从琅邪以西，北到东平的地域都为徐圆朗所有，拥有精兵两万余人
卢明月转掠河南，至于淮北，众号四十万，自称无上王；帝命江都通守王世充讨之	卢明月转掠河南，到达淮北，拥有的部众号称四十万，自称无上王
世充与战于南阳，大破之，斩明月，余众皆散	炀帝命令江都通守王世充率兵讨伐卢明月，王世充在南阳与卢明月交战，大破卢明月，斩了卢明月，其余的部众都溃散了
二月，壬午，朔方鹰扬郎将梁师都杀郡丞唐世宗，据郡，自称大丞相，北连突厥	二月，壬午，朔方鹰扬郎将梁师都杀死郡丞唐世宗，占据朔方郡，自称大丞相，向北勾结突厥
梁师都略定雕阴、弘化、延安等郡，遂即皇帝位，国号梁，改元永隆	梁师都攻占了雕阴、弘化、延安等郡，就即皇帝位，国号梁，改年号为永隆
始毕遗以狼头纛，号为大度毗伽可汁	始毕可汗赠以狼头大旗，并赠以大度毗伽可汗的称号
师都乃引突厥居河南之地，攻破盐川郡	梁师都勾结突厥人占据河南之地，攻破盐川郡
左翊卫蒲城郭子和坐事徙榆林	左翊卫蒲城人郭子和，犯罪被流放到榆林
会郡中大饥，子和潜结敢死士十八人攻郡门，执郡丞王才，数以不恤百姓，斩之，开仓赈施	正逢榆林郡遇大饥荒，郭子和暗地结交了敢死之士十八人进攻郡门，抓住郡丞王才，历数他不体恤百姓疾苦的罪状，将王才处死，开仓赈济百姓
自称永乐王，改元丑平	郭子和自称永乐王，改年号丑平
尊其父为太公，以其弟子政为尚书令，子端、子升为左右仆射	尊他父亲为太公，任命他弟弟郭子政为尚书令，郭子端、郭子升为左右仆射
有二千余骑，南连梁师都，北附突厥，各遣子为质以自固	他拥有两千余名骑兵，南面勾结梁师都，北面依附突厥，两边各送一个儿子作为人质以巩固自己的势力
始毕以刘武周为定杨天子，梁师都为解事天子，子和为平杨天子；子和固辞不敢当，乃更以为屋利设	始毕可汗封刘武周为定杨天子，梁师都为解事天子，郭子和为平杨天子，郭子和再三辞谢，不敢接受，于是始毕改封他为屋利设
初，唐公李渊娶于神武肃公窦毅，生四男，建成、世民、玄霸、元吉；一女，适太子千牛备身临汾柴绍	当初，唐公李渊娶了神武肃公窦毅的女儿为妻，窦氏生了四个儿子：李建成、李世民、李玄霸、李元吉；一个女儿，嫁给太子千牛备身临汾人柴绍
李建成、李元吉弃其弟智云于河东而去，吏执智云送长安，杀之	李建成、李元吉将他们的弟弟李智云丢弃在河东而离去，当地的官吏抓住李智云送到长安处死
建成、元吉遇柴绍于道，与之偕行	李建成、李元吉在路上遇到柴绍，与他同行
六月，己卯，李建成等至晋阳	六月，己卯，李建成等人到达晋阳
李密复帅众向东都，丙申，大战于平乐园	李密又统帅部众向东都进军，丙申，与隋军在平乐园大战
密左骑、右步，中列强弩，鸣千鼓以冲之，东都兵大败，密复取回洛仓	李密左边部署骑兵，右边部署步兵，中间摆列强弩，敲响千面战鼓壮大声势以冲击隋军，东都兵大败，李密再次夺取了回洛仓
秋，七月，炀帝遣江都通守王世充将江、淮劲卒，将军王隆帅邛黄蛮，河北大使太常少卿韦霁、河南大使虎牙郎将王辩等各帅所领同赴东都，相知讨李密	秋季，七月，炀帝派江都通守王世充率领江、淮的精兵，将军王隆率领邛都夷部的黄蛮，河北讨捕大使太常少卿韦霁，河南讨捕大使虎牙郎将王辩等人各自率领辖下的军队一同赶赴东都，协同讨伐李密
霁，世康之子也	韦霁是韦世康的儿子
薛举自称秦帝，立其妻鞠氏为皇后，子仁果为皇太子	薛举自称秦帝，立妻子鞠氏为皇后，儿子薛仁果为皇太子
遣仁果将兵围天水，克之，举自金城徙都之	派遣薛仁果率兵包围并攻克了天水，薛举从金城迁都于天水
仁果多力，善骑射，军中号万人敌；然性贪而好杀	薛仁果很有力气，善于骑射，军中号称万人敌
尝获庾信子立，怒其不降，于火上，稍割以啖军士	但是他生性贪婪、残忍、嗜杀成性，曾经抓住庾信的儿子庾立，他为庾立不肯投降而发怒，将庾立在火上分尸，然后一点点地割下肉来让军士们吃
及克天水，悉召富人，倒悬之，以醋灌鼻，责其金宝	待他攻下了天水，把天水的富人都召来，倒吊起来，用醋灌鼻子，向他们索取金宝
举每戒之曰：汝之才略足以办事，然苛虐无恩，终当覆我国家	薛举常常训诫他说：你的才能谋略足以办事，但是生性严苛酷虐，对人不能施恩，终归要倾覆我的家和国呵
骁果从炀帝在江都者多逃去，帝患之，以问裴矩，对曰：人情非有匹偶，难以久处，请听军士于此纳室	跟从炀帝在江都的骁果有很多逃跑了，炀帝很忧虑这件事，问裴矩如何办，裴矩回答说：从人情上讲，没有配偶，就难以久待，请听任军士们在此成家吧
帝从之	炀帝听从了裴矩的建议
九月，悉召江都境内寡妇、处女集宫下，恣将士所取；或先与奸者听自首，即以配之	九月，将江都境内的寡妇、处女都召集到宫下，任凭将士们娶走，有些原来就有奸情的人，任凭他们自首，然后即将此女配给他为妻
乙卯，张纶徇龙泉、文成等郡，皆下之，获文成太守郑元	乙卯，张纶攻打龙泉、文成等郡，攻克，俘获文成太守郑元
元，译之子也	郑元是郑译的儿子
王世充自洛北之败，坚壁不出；越王侗遣使劳之，世充惭惧，请战于密	王世充自从在洛水之北被李密打败后，就坚守营垒不再出战，越王杨侗派遣使者去慰劳王世充，王世充既惭愧又恐惧，就向李密要求交战
丙辰，世充与密夹石子河而陈，密布陈南北十余里	丙辰，王世充与李密在石子河两岸列阵，李密阵列南北长十余里，翟让先和王世充交战，不胜而退
翟让先与世充战，不利而退；世充逐之，王伯当、裴仁基从劳横断其后，密勒中军击之，世充大败，西走	王世充追击翟让，王伯当、裴仁基从旁横断隋军的后路，李密统率中军进击王世充，王世充大败，向西逃走
十二月，癸未，追谥唐王渊大父襄公为景王；考仁公为元王，夫人窦氏为穆妃	十二月，癸未，追谥唐王李渊的祖父襄公李虎为景王，父亲仁公李为元王，李的夫人窦氏为穆妃
乙未，平凉留守张隆，丁西，河池太守萧及扶风汉阳郡相继来降	乙未，河池太守萧以及扶风、汉阳郡相继来归降李渊
以窦为工部尚书、燕国公，萧为礼部尚书、宋国公	李渊封窦为工部尚书，燕国公；封萧为礼部尚书，宋国公
姜、窦轨进至长道，为薛举所败，引还	姜、窦轨率军走到长道县，被薛举击败，就率军返回
渊使通议大夫醴泉刘世让安集唐弼余党，与举相遇，战败，为举所虏	李渊派遣通议大夫醴泉人刘世让安抚召集唐弼的余党，刘世让与薛举相遇，战败，被薛举俘虏
屈突通与刘文静相持月余，通复使桑显和夜袭其营，文静与左光禄大夫段志玄悉力苦战，显和败走，尽俘其众，通势益蹙	屈突通和刘文静相持了一个多月，屈突通又派桑显和率兵夜袭刘文静的军营
或说通降，通泣曰：吾历事两主，恩顾甚厚	刘文静和左光禄大夫段志玄全力苦战，桑显和兵败逃走，刘文静将桑显和的部下全部俘获
食人之禄而违其难，吾不为也	屈突通的处境愈加窘迫
每自摩其颈曰：要当为国家受一刀	有人劝屈突通投降，屈突通哭道：我侍奉过两个主上，皇帝对我的恩宠照顾非常优厚，拿着人家的俸禄而在困难时背叛，我不能做这样的事
劳勉将士，末尝不流涕，人亦以此怀之	他常常摸着自己的脖子说：应当为国家挨一刀
丞相渊遣其家僮召之，通立斩之	屈突通慰劳勉励将士时，没有不痛哭流涕的，大家对此也很感动
及闻长安不守，家属悉为渊所虏，乃留显和镇潼关，引兵东出，将趣洛阳	丞相李渊派其家僮去招降屈突通，他当即将僮仆杀死
通适去，显和即以城降文静	当他听说长安已经失守，家属都被李渊俘获，就留下桑显和镇守潼关，率军东去，准备奔往洛阳
文静遣窦琮等将轻骑与显和追之，及于稠桑	屈突通刚走，桑显和就献出潼关投降了刘文静
通结陈自固，窦琮遣通子寿往谕之，通骂曰：此贼何来	刘文静派窦琮等人率领轻骑与桑显和去追阻屈突通，在稠桑追上了他
昔与汝为父子，今与汝为仇雠	屈突通摆好陈势以自卫，窦琮派屈突通的儿子屈突寿去劝说他，屈突通骂道：这个贼人来干什么
命左右射之	过去我和你是父子，现在我和你是仇敌
显和谓其众曰：今京城已陷，汝辈皆关中人，去欲何之	他命令身边的人用弓箭射屈突寿
众皆释仗而降	桑显和对屈突通的部众说：如今京城已经失陷，你们都是关中人，打算去什么地方
通知不免，下马东南向再拜号哭曰：臣力屈至此，非敢负国，天地神祗实知之	屈突通的士兵就扔掉兵器投降，屈突通知道自己已无法逃脱，就下马向东南方向再三跪拜号哭道：我的力量至此已经使尽，不敢辜负国家，天地神祗是知道的
军人执通送长安，渊以为兵部尚书，赐爵蒋公，兼秦公元帅府长史	士兵抓住了屈突通押送到长安，李渊任命他为兵部尚书，赐他蒋公的爵位，兼任秦公元帅府长史
东都米斗三钱，人饿死者什二三	东都缺粮，一斗米价值三千钱，因而饿死之人有十之二三
刘文静等引兵东略地，取弘农郡，遂定新安以西	刘文静等人率兵向东攻城夺地，攻占了弘农郡，于是新安以西的地方得到了安定
甲辰，李渊遣云阳令詹俊、武功县正李仲衮徇巴、蜀，下之	甲辰，李渊派云阳令詹俊、武功县正李仲衮进攻并攻下了巴蜀
