初命晋大夫魏斯、赵籍、韩虔为诸侯	周威烈王姬午初次分封晋国大夫魏斯、赵籍、韩虔为诸侯国君
燕公薨，子僖公立	燕国燕公去世，其子燕僖公即位
	二十四年
王崩，子安王骄立	周威烈王驾崩，其子姬骄即位，是为周安王
盗杀楚声王，国人立其子悼王	盗匪杀死楚国楚声王，国中贵族拥立其子楚悼王即位
	安王元年
秦伐魏，至阳孤	秦国攻打魏国，直至阳孤
	二年
魏、韩、赵伐楚，至桑丘	韩国、魏国、赵国联合攻打楚国，直至桑丘
郑围韩阳翟	郑国围攻韩国阳翟城
韩景侯薨，子烈侯取立	韩国韩景侯去世，其子韩取即位，是为韩烈侯
赵烈侯薨，国人立其弟武侯	赵国赵烈侯去世，国中贵族拥立其弟即位，是为赵武侯
秦简公薨，子惠公立	秦国秦简公去世，其子即位，是为秦惠公
	三年
王子定奔晋	周朝王子姬定出奔晋国
虢山崩，壅河	虢山崩塌，泥石壅塞黄河
	四年
楚围郑	楚国围攻郑国
郑人杀其相驷子阳	郑国人杀死国相驷子阳
	五年
日有食之	出现日食
郑驷子阳之党弑公，而立其弟乙，是为康公	郑国宰相驷子阳的余党杀死国君郑公，改立他的弟弟姬乙，是为郑康公
宋悼公薨，子休公田立	宋国宋悼公去世，其子宋田即位，是为宋休公
	八年
齐伐鲁，取最	齐国攻打鲁国，攻占最地
郑负黍叛，复归韩	郑国的负黍地方反叛，复归顺韩国
	九年
魏伐郑	魏国攻打郑国
晋烈公薨，子孝公倾立	晋国晋烈公去世，其子姬倾即位，是为晋孝公
	十一年
秦伐韩宜阳，取六邑	秦国攻打韩国宜阳地方，夺取六个村邑
初，田常生襄子盘，盘生庄子白，白生太公和	起初，齐国田常生襄子田盘，田盘生庄子田白，田白再生太公田和
是岁，齐田和迁齐康公于海上，使食一城，以奉其先祀	这年，田和把国君齐康公流放到海边，让他保有一个城的赋税收入，以承继祖先祭祀
	十二年
秦、晋战于武城	秦国与晋国大战于武城
齐伐魏，取襄阳	齐国攻打魏国，夺取襄阳
鲁败齐师于平陆	鲁国在平陆击败齐国军队
	十三年
秦侵晋	秦国入侵晋国
齐田和会魏文侯、楚人、卫人于浊泽，求为诸侯	齐国田和在浊泽约会魏文侯及楚国、卫国贵族，要求作诸侯
魏文侯为之请于王及诸侯，王许之	魏文侯替他向周安王及各国诸侯申请，周安王准许
	十五年
秦伐蜀，取南郑	秦国攻打蜀地，夺取南郑
魏文侯薨，太子击立，是为武侯	魏国魏文侯去世，太子魏击即位，是为魏武侯
秦惠公薨，子出公立	秦国秦惠公去世，其子即位，是为秦出公
赵武侯薨，国人复立烈侯之太子章，是为敬侯	赵国赵武侯去世，国中贵族又拥立赵烈侯的太子赵章即位，是为赵敬侯
韩烈侯薨，子文侯立	韩国韩烈侯去世，其子即位，是为韩文侯
	十六年
初命齐大夫田和为诸侯	周王朝开始任命齐国大夫田和为诸侯国君
赵公子朝作乱，奔魏；与魏袭邯郸，不克	赵国公子赵朝作乱，出奔魏国，与魏国军队一起进袭赵国邯郸，未能攻克
	十七年
秦庶长改逆献公于河西而立之；杀出子及其母，沈之渊旁	秦国名叫改的庶长在河西迎接秦献公，立为国君；把秦出公和他的母亲杀死，沉在河里
齐伐鲁	齐国攻打鲁国
齐太公薨，子桓公午立	齐国太公田和去世，其子田午即位，是为齐桓公
	十九年
魏败赵师于兔台	魏国在兔台击败赵国军队
	二十年
日有食之，既	出现日全食
	二十一年
楚悼王薨	楚悼王去世
贵戚大臣作乱，攻吴起；起走之王尸而伏之	贵族国戚和大臣作乱，攻打吴起，吴起逃到悼王尸体边，伏在上面
击起之徒因射刺起，并中王尸	攻击吴起的暴徒用箭射吴起，并射中了悼王的尸体
既葬，肃王即位，使令尹尽诛为乱者；坐起夷宗者七十馀家	办完葬事，楚肃王即位，命令楚相全数翦灭作乱者，因射吴起之事而被灭族的多达七十余家
	二十二年
齐伐燕，取桑丘	齐国攻打燕国，夺取桑兵
魏、韩、赵伐齐，至桑丘	魏、韩、赵三国攻打齐国，兵至桑丘
	二十三年
赵袭卫，不克	赵国袭击卫国，未能攻克
狄败魏师于浍	北方狄族在浍山击败魏国军队
魏、韩、赵伐齐，至灵丘	魏、韩、赵三国攻打齐国，兵至灵丘
晋孝公薨，子靖公俱酒立	晋国晋孝公去世，其子姬俱酒即位，是为晋靖公
	二十五年(甲辰、前377)
蜀伐楚，取兹方	蜀人攻打楚国，夺取兹方
子思言苟变于卫侯曰：其才可将五百乘	孔，字子思，向卫国国君提起苟变说：他的才能可统领五百辆车
公曰：吾知其可将；然变也尝为吏，赋于民而食人二鸡子，故弗用也	卫侯说：我知道他是个将才，然而苟变做官吏的时候，有次征税吃了老百姓两个鸡蛋，所以我不用他
子思曰：夫圣人之官人，犹匠之用木也，取其所长，弃其所短；故杞梓连抱而有数尺之朽，良工不弃	孔说：圣人选人任官，就好比木匠使用木料，取其所长，弃其所短；因此一根合抱的良木，只有几尺朽烂处，高明的工匠是不会扔掉它的
今君处战国之世，选爪牙之士，而以二卵弃干城之将，此不可使闻于邻国也	现在国君您处在战国纷争之世，正要收罗锋爪利牙的人才，却因为两个鸡蛋而舍弃了一员可守一城的大将，这事可不能让邻国知道啊
公再拜曰：谨受教矣	卫侯一再拜谢说：我接受你的指教
鲁穆公薨，子共公奋立	鲁国鲁穆公去世，其子姬奋即位，是为鲁共公
韩文侯薨，子哀侯立	韩国韩文侯去世，其子即位，是为韩哀侯
	二十六年
王崩，子烈王喜立	周安王去世，其子姬喜即位，是为周烈王
魏、韩、赵共废晋靖公为家人而分其地	魏、韩、赵三国一同把晋靖公废黜为平民，瓜分了他的残余领地
	烈王元年
日有食之	出现日食
韩灭郑，因徙都之	韩国灭掉郑国，于是把国都迁到新郑
赵敬侯薨，子成侯种立	赵国赵敬侯去世，其子赵种即位，是为赵成侯
	三年
燕败齐师于林狐	燕国在林狐击败齐国军队
燕僖公薨，子桓公立	燕国燕僖公去世，其子即位，是为燕桓公
宋休公薨，子辟公立	宋国宋休公去世，其子即位，是为宋辟公
卫慎公薨，子声公训立	卫国卫慎公去世，其子卫训即位，是为卫声公
	四年
赵伐卫，取都鄙七十三	赵国攻打卫国，夺取七十三个村镇
魏败赵师于北蔺	魏国在北蔺击败赵国军队
	五年
魏伐楚，取鲁阳	魏国攻打楚国，夺取鲁阳
韩严遂弑哀侯，国人立其子懿侯	韩国严遂杀死韩哀侯，国中贵族立哀侯之子，是为韩懿侯
初，哀侯以韩为相而爱严遂，二人甚相害也	当初，韩哀侯曾任命韩为国相却宠爱严遂，两人互相仇恨至深
严遂令人刺韩于朝，走哀侯，哀侯抱之；人刺韩，兼及哀侯	严遂派人在朝廷行刺韩，韩逃到韩哀侯身边，韩哀侯抱住他，刺客刺韩，连带韩哀侯也被刺死
魏武侯薨，不立太子，子与公中缓争立，国内乱	魏国魏武侯去世，没有立太子，他的儿子魏与公中缓争位，国内大乱
	六年
齐威王来朝	齐威王朝拜周烈王
是时周室微弱，诸侯莫朝，而齐独朝之，天下以此益贤威王	当时周王室已十分衰弱，各诸侯国都不来朝拜，唯独齐王仍来朝拜，因此天下人愈发称赞齐威王贤德
赵伐齐，至鄄	赵国攻打齐国，直至鄄地
魏败赵师于怀	魏国在怀地击败赵国军队
楚肃王薨，无子，立其弟良夫，是为宣王	楚国楚肃王去世，他没有儿子，弟弟良夫即位，是为楚宣王
宋辟公薨，子剔成立	宋国宋辟公去世，其子宋剔成即位
	七年
日有食之	出现日食
王崩，弟扁立，是为显王	周烈王去世，弟弟姬扁即位，是为周显王
齐伐魏，取观津	齐国攻打魏国,夺取观津
赵侵齐，取长城	赵国入侵齐国，占领长城
	三年
魏、韩会于宅阳	魏国、韩国在宅阳举行会议
秦败魏师、韩师于洛阳	秦国在洛阳击败魏国和韩国军队
	四年B>
魏伐宋	魏国攻打宋国
	五年
秦献公败三晋之师于石门，斩首六万	秦献公在石门大败韩、赵、魏三国联军，斩首六万人
王赐以黼黻之服	周王特地颁赏他绣有黑、白、青花纹的服饰
	七年
魏败韩师、赵师于浍	魏国在浍地击败韩国和赵国军队
秦、魏战于少梁，魏师败绩；获魏公孙痤	秦国、魏国在少梁激战，魏国军队大败而逃，公孙痤被俘
卫声公薨，子成侯速立	卫国卫声公去世，其子卫速即位为卫成侯
燕桓公薨，子文公立	燕国燕桓公去世，其子即位为燕文公
孝公下令国中曰：昔我穆公，自岐、雍之间修德行武，东平晋乱，以河为界，西霸戎翟，广地千里，天子致伯，诸侯毕贺，为后世开业甚光美	秦孝公在国中下令说：当年我国的国君秦穆公，立足于岐山、雍地，励精图治，向东平定了晋国之乱，以黄河划定国界；向西称霸于戎翟等族，占地广达千里；被周王赐与方伯重任，各诸侯国都来祝贺，所开辟的基业是多么光大宏伟
会往者厉、躁、简公、出子之不宁，国家内忧，未遑外事	只是后来历代国君厉公、躁公、简公及出子造成国内动乱不息，才无力顾及外事
三晋攻夺我先君河西地，丑莫大焉	魏、赵、韩三国夺去了先王开创的河西领土，这是无比的耻辱
献公即位，镇抚边境，徙治栎阳，且欲东伐，复穆公之故地，修穆公之政令	到献公即位时，平定安抚边境，把都城迁到栎阳，亲往治理，准备向东征讨，收复穆公时的旧地，重修穆公时的政策法令
寡人思念先君之意，常痛于心	我想到先辈的未竟之志，常常痛心疾首
宾客群臣有能出奇计强秦者，吾且尊官，与之分土	现在宾客群臣中谁能献上奇计，让秦国强盛，我就封他为高官，给他封地
于是卫公孙鞅闻是令下，乃西入秦	卫国的公孙鞅听到这道命令，于是西行来到秦国
韩懿侯薨，子昭侯立	韩国韩懿侯去世，其子即位为韩昭侯
	十一年
秦败韩师于西山	秦国在西山击败韩国军队
	十二年
魏、韩会于	韩国、魏国在地举行会议
	十三年
赵、燕会于阿	赵国、燕国在阿地举行会议
赵、齐、宋会于平陆	赵国、齐国、宋国在平陆举行会议
	十四年
齐威王、魏惠王会田于郊	齐威王、魏惠王在效野约会狩猎
惠王曰：齐亦有宝乎	魏惠王问：齐国也有什么宝贝吗
威王曰：无有	齐威王说：没有
惠王曰：寡人国虽小，尚有径寸之珠，照车前后各十二乘者十枚	魏惠王说：我的国家虽小，尚有十颗直径一寸以上、可以照亮十二乘车子的大珍珠
岂以齐大国而无宝乎	以齐国之大，难道能没有宝贝
威王曰：寡人之所以为宝者与王异	齐威王说：我对宝贝的看法和你可不一样
吾臣有檀子者，使守南城，则楚人不敢为寇，泗上十二诸侯皆来朝	我的大臣中有位檀子，派他镇守南城，楚国不敢来犯，泗水流域的十二个诸侯国都来朝贺
吾臣有盼子者，使守高唐，则赵人不敢东渔于河	我的大臣中还有位盼子，使他守高唐，赵国人怕得不敢向东到黄河边来打渔
吾吏有黔夫者，使守徐州，则燕人祭北门，赵人祭西门，徙而从者七千余家	我的官吏中有位黔夫，令他守徐州，燕国人在北门、赵国人在西门望空礼拜求福，相随来投奔的多达七千余家
吾臣有种首者，使备盗贼，则道不拾遗	我的大臣中有位种首，让他防备盗贼，便出现路不拾遗的太平景象
此四臣者，将照千里，岂特十二乘哉	这四位大臣，光照千里，岂止是十二乘车子呢
惠王有惭色	魏惠王听了面色十分惭愧
秦孝公、魏惠王会于杜平	秦孝公、魏惠王在杜平举行会议
鲁共公薨，子康公毛立	鲁国鲁共公去世，其子姬毛即位为鲁康公
	十五年
秦败魏师于元里，斩首七千级，取少梁	秦国在元里击败魏国军队，斩首七千余人，夺取少梁
魏惠王伐赵，围邯郸	魏惠王率军攻打赵国，围困邯郸城
楚王使景舍救赵	楚王派景舍为将出兵救赵
	十六年
齐威王使田忌救赵	齐威王派田忌率军救赵
韩伐东周，取陵观、廪丘	韩国攻打东周王朝，夺取陵观、廪丘
秦大良造伐魏	秦国大良造率军攻打魏国
诸侯围魏襄陵	各诸侯国出兵围攻魏国襄陵城
	十八年
秦卫鞅围魏固阳，降之	秦国公孙鞅率军围攻魏国固阳，固阳归降
韩昭侯以申不害为相	韩昭侯任用申不害为国相
秦商鞅筑冀阙宫庭于咸阳，徙都之	秦国公孙鞅在咸阳修建宫殿，将国都迁到那里
令民父子、兄弟同室内息者为禁	又下令禁止百姓家庭不分长幼尊卑地父子、兄弟混居一堂
并诸小乡聚，集为一县，县置令、丞，凡三十一县	把四散的小村落合并到一起，成为一个县，设置县令、县丞等官员，共设了三十一个县
废井田，开阡陌	还废除旧的井田制度，打破原来的土地疆界
平斗、桶、权、衡、丈、尺	并统一斗、桶、权、衡、丈、尺等计量单位
秦、魏遇于彤	秦军和魏军在彤地发生遭遇战
赵成侯薨，公子绁与太子争立；绁败，奔韩	赵国赵成侯去世，公子赵绁与太子争夺君位，赵绁失败，逃奔韩国
	二十一年
秦商鞅更为赋税法，行之	秦国公孙鞅改革赋税制度，付诸实行
	二十二年
赵公子范袭邯郸，不胜而死	赵国公子范袭击邯郸，未能取胜却被杀死
	二十三年
齐杀其大夫牟	齐国杀死大夫田牟
鲁康公薨，子景公偃立	鲁国鲁康公去世，其子姬偃即位为鲁景公
卫更贬号曰侯，服属三晋	卫国把自己的爵位降低为侯，臣服于韩、赵、魏三国
	二十五年
诸侯会于京师	诸侯在京师举行会议
	二十六年
王致伯于秦，诸侯皆贺秦	周显王封秦国国君为诸侯之长，各国都来致贺
秦孝公使公子少官帅师会诸侯于逢泽以朝王	秦孝公命令公子少官率军队与诸侯在逢泽举行会议，以朝见周显王
	二十八年
魏庞涓伐韩	魏国庞涓率军攻打韩国
韩请救于齐	韩国派人向齐国求救
齐威王召大臣而谋曰：蚤救孰与晚救	齐威王召集大臣商议说：是早救好呢，还是晚救好呢
成侯曰：不如勿救	成侯邹忌建议：不如不救
田忌曰：弗救则韩且折而入于魏，不如蚤救之	田忌不同意，说：我们坐视不管，韩国就会灭亡，被魏国吞并
孙膑曰：夫韩、魏之兵未弊而救之，是吾代韩受魏之兵，顾反听命于韩也	还是早些出兵救援为好
且魏有破国之志，韩见亡，必东面而诉于齐矣	孙膑却说：现在韩国、魏国的军队士气正盛，我们就去救援，是我们代替韩国承受魏国的打击，反而听命于韩国了
吾因深结韩之亲而晚承魏之弊，则可受重利而得尊名也	这次魏国有吞并韩国的野心，待到韩国感到亡国迫在眉睫，一定会向东再来恳求齐国，那时我们再出兵，既可以加深与韩国的亲密关系，又可以乘魏国军队的疲弊，正是一举两得，名利双收
王曰：善	齐威王说：对
乃阴许韩使而遣之	便暗中答应韩国使臣的求救，让他回去，却迟迟不出兵
韩因恃齐，五战不胜，而东委国于齐	韩国以为有齐国的支持，便奋力抵抗，但经过五次大战都大败而归，只好把国家的命运寄托在东方齐国身上
齐、赵伐魏	齐国、赵国攻打魏国
楚宣王薨，子威王商立	楚国楚宣王去世，其子商继位为楚威王
	三十一年
秦孝公薨，子惠文王立	秦国秦孝公去世，其子即位为秦惠文王
公子虔之徒告商君欲反，发吏捕之	因公子虔的门下人指控商君要谋反，便派官吏前去捕捉他
商君亡之魏；魏人不受，复内之秦	商君急忙逃往魏国，魏国人拒不接纳，把他送回到秦国
商君乃与其徒之商於，发兵北击郑	商君只好与他的门徒来到封地商於，起兵向北攻打郑
秦人攻商君，杀之，车裂以徇，尽灭其家	秦国军队向商君进攻，将他斩杀，车裂分尸，全家老小也被杀光
韩申不害卒	韩国申不害去世
	三十三年
宋太丘社亡	宋国太丘县的祭祀神坛倒塌
邹人孟轲见魏惠王，王曰：叟，不远千里而来，亦有以利吾国乎	邹地人士孟轲求见魏惠王，惠王问道：老先生，您不远千里而来，能给我的国家带来什么利益呢
孟子曰：君何必曰利，仁义而已矣	孟轲说：君主您何必张口就要利益，有了仁义就足够了
君曰何以利吾国，大夫曰何以利吾家，士庶人曰何以利吾身，上下交征利而国危矣	如果君主光说为国谋利益，大夫光说为家谋利益，士民百姓所说的也是如何让自身得到利益，上上下下都追逐利益，那么国家就危险了
未有仁而遗其亲者也，未有义而后其君者也	只有仁爱的人不会抛弃他的亲人，忠义的人不会把国君放到脑后
王曰：善	魏惠王点头说：对
秦伐韩，拔宜阳	秦国进攻韩国，攻克宜阳
	三十五年
齐王、魏王会于徐州以相王	齐王、魏王在徐州会面，互相尊称为王
韩昭侯作高门，屈宜臼曰：君必不出此门	韩昭侯修建一座高大的门楼，屈宜臼对他说：您肯定走不出这座门的
何也	为什么呢
不时	因为时运不宜
吾所谓时者，非时日也	我所说的时候，并不是指时间
夫人固有利，不利时	人生在世有顺利、不顺利的时候
往者君尝利矣，不作高门	过去您曾经有好时运，却没有修建高门楼
前年秦拔宜阳，今年旱，君不以此时恤民之急而顾益奢，此所谓时诎举赢者也	而去年秦国夺去了我们的宜阳，今年国内又大旱，您不在这时抚恤百姓的危难，反而奢侈挥霍，这正是古话所说的越穷越摆架子
故曰不时	所以我说时运不宜
越王无强伐齐	越国国王姒无强攻打齐国
齐王使人说之以伐齐不如伐楚之利	齐王派人向他游说：伐齐国不如去攻楚国好处大
越王遂伐楚	越王于是去攻打楚国，却大败而归
楚人大败之，乘胜尽取吴故地，东至于浙江	楚国趁势占领了原先吴国的旧地，向东一直到浙江
越以此散，诸公族争立，或为王，或为君，滨于海上，朝服于楚	越国从此分崩瓦解，各家贵族争相为王，或自立为国君，分散在沿海一带，各自向楚国臣服
楚王伐齐，围徐州	楚王攻打齐国，围困徐州
韩高门成	韩国的高大门楼修成
昭侯薨，子宣惠王立	韩昭侯却死了，其子即位为韩宣惠王
齐威王薨，子宣王辟强立；知成侯卖田忌，乃召而复之	齐国齐威王去世，其子田辟强即位为齐宣王；他知道成侯邹忌陷害田忌，于是召回田忌复位
燕文公薨，子易王立	燕国燕文公去世，其子即位为燕易王
卫成侯薨，子平侯立	卫国卫成侯去世，其子即位为卫平侯
	三十七年
秦惠王使犀首欺齐、魏，与共伐赵，以败从约	秦惠王派犀首逼迫齐国、魏国，共同出兵攻伐赵国，借此破坏各国盟约
赵肃侯让苏秦，苏秦恐，请使燕，必报齐	赵肃侯斥责苏秦，苏秦十分恐惧，请求让他出使燕国，一定报复齐国
苏秦去赵而从约皆解	而苏秦一离开赵国，联合盟约便土崩瓦解
赵人决河水以灌齐、魏之师，齐、魏之师乃去	赵国引决黄河水淹灌齐国、魏国军队，齐国、魏国军队于是撤走
魏以阴晋为和于秦，实华阴	魏国献出阴晋向秦国求和，阴晋实际上就是华阴
齐王伐燕，取十城；已而复归之	齐王攻打燕国，夺取十座城，不久又归还燕国
	三十九年
秦伐魏，围焦、曲沃	秦国进攻魏国，围困焦城和曲沃
魏入少梁、河西地于秦	魏国向秦国献出少梁、河西之地
	四十年
秦伐魏，渡河，取汾阴、皮氏，拔焦	秦国进攻魏国，渡过黄河，夺取汾阴、皮氏，攻克焦城
楚威王薨，子怀王槐立	楚国楚威王去世，其子槐即位为楚怀王
宋公剔成之弟偃袭攻剔成；剔成奔齐，偃自立为君	宋国国君宋剔成的弟弟宋偃袭击宋剔成，宋剔成逃往齐国，宋偃自立为国君
	四十一年
秦公子华、张仪帅师围魏蒲阳，取之	秦国公子华、张仪率军队围攻魏国蒲阳，予以攻占
张仪言于秦王，请以蒲阳复与魏，而使公子繇质于魏	张仪又建议秦王，把蒲阳还给魏国，并派公子繇到魏国去当人质
仪因说魏王曰：秦之遇魏甚厚，魏不可以无礼于秦	张仪于是劝说魏王道：秦国待魏国十分宽厚，魏国可不能对秦国不讲礼义
魏因尽入上郡十五县以谢焉	魏国于是拿出上郡的十五个县来报答秦国
张仪归而相秦	张仪回国后被任命为秦国国相
	四十二年
秦县义渠，以其君为臣	秦国夺取西戎的义渠国，改为一个县，把国君当作臣下
秦归焦、曲沃于魏	秦国归还焦城、曲沃给魏国
	四十三年
夏，四月，戊午，秦初称王	夏季，四月，戊午，秦国君首次称王
秦张仪帅师伐魏，取陕	秦国张仪率军攻打魏国，夺取陕
秦张仪及齐、楚之相会啮桑	秦国张仪与齐国、楚国的国相在啮桑举行会议
王崩，子慎靓王定立	周显王去世，其子姬定即位为周慎靓王
燕易王薨，子哙立	燕国燕易王去世，其子姬哙即位
齐王封田婴于薛，号曰靖郭君	齐王把薛城封给田婴，号称靖郭君
靖郭君言于齐王曰：五官之计，不可不日听而数览也	靖郭君对齐王说：各主管大臣的报告，您应该每天亲自听取并反复审核
王从之；已而厌之，悉以委靖郭君	齐王照此做去，不久就厌烦了，全部委托给靖郭君代办
靖郭君由是得专齐之权	于是，齐国的大权全部落到田婴手中
卫更贬号曰君	卫国国君再次把自己的爵位由侯降到君
	二年
秦伐韩，取鄢	秦国进攻韩国，夺取鄢陵
楚、赵、魏、韩、燕同伐秦，攻函谷关	楚国、赵国、魏国、韩国、燕国联合讨伐秦国，进攻函谷关
秦人出兵逆之，五国之师皆败走	秦国出兵迎敌，五国联军败退而回
宋初称王	宋国国君开始称王
	四年
秦败韩师于鱼，斩首八万级，虏其将、申差于浊泽	秦国在鱼大败韩国军队，杀死八万人，于浊泽俘虏韩军大将和申差
诸侯振恐	各国震惊
齐大夫与苏秦争宠，使人刺秦，杀之	齐国大夫与苏秦争权，派人刺杀了苏秦
鲁景公薨，子平公旅立	鲁国鲁景公去世，其子姬旅即位为鲁平公
	五年
王崩，子赧王延立	周慎靓王去世，其子姬延即位为周赧王
	赧王上元年
秦入侵义渠，得二十五城	秦国入侵义渠，夺取二十五个城镇
是岁，齐宣王薨，子王地立	同年，齐国齐宣王去世，其子田地即位为齐王
	二年
秦王欲伐齐，患齐、楚之从亲，乃使张仪至楚，说楚王曰：大王诚能听臣，闭关绝约于齐，臣请献商於之地六百里，使秦女得为大王箕帚之妾，秦、楚嫁女娶妇，长为兄弟之国	秦王想征伐齐国，又顾虑齐国与楚国有互助条约，便派张仪前往楚国
楚王说	张仪对楚王说：大王如果能听从我的建议，与齐国废除盟约，断绝邦交，我可以向楚国献上商於地方的六百里土地，让秦国的美女
韩宣惠王薨，子襄王仓立	韩国韩宣惠王去世，其子韩仓即位为韩襄王
	四年
蜀相杀蜀侯	蜀国国相杀死封侯的国君
张仪说秦武王曰：为王计者，东方有变，然后王可以多割得地也	张仪向秦武王建议：为大王您考虑，东方发生事变，大王才能乘机多割得土地
臣闻齐王甚憎臣，臣之所在，齐必伐之	我听说齐王十分憎恨我，我居留在哪里，齐国必定要去攻打
臣愿乞其不肖之身以之梁，齐必伐梁，齐、梁交兵而不能相去，王以其间伐韩，入三川，挟天子，案图籍，此王业也	我请求让我这个不肖之人到魏国去，齐国必定要讨伐魏国，齐国、魏国正打得难解难分的时候，大王便可以乘机攻打韩国，进军三川，挟持天子，掌握天下的版图，这是帝王大业呀
王许之	秦王允许张仪到魏国去
齐王果伐梁，梁王恐	齐国果然出兵攻魏，魏王十分惊恐
张仪曰：王勿患也	张仪安慰说：大王不要担心
请令齐罢兵	让我来退掉齐兵
乃使其舍人之楚，借使谓齐王曰：甚矣王之托仪于秦也	于是派他的手下人到楚国，借使臣之口对齐王说：大王把张仪托付给秦国的办法真厉害呀
齐王曰：何故	齐王问：怎么讲
楚使者曰：张仪之去秦也固与秦王谋矣，欲齐、梁相攻而令秦取三川也	楚国使者说：张仪离开秦国本来就是与秦王定下的计谋，想让齐、魏两国互相攻击而秦国乘机夺取三川地方
今王果伐梁，是王内罢国而外伐与国，而信仪于秦王也	现在大王您果然攻打魏国，正是对内劳民伤财，对外结仇邻国，而使张仪重新获得秦王的信任
齐王乃解兵还	齐王听罢，下令退兵回国
张仪相魏一岁，卒	张仪在魏国做了一年的国相，便去世了
秦王使甘茂诛蜀相庄	秦王派甘茂诛杀蜀国国相陈庄
秦王、魏王会于临晋	秦王、魏王在临晋相会
秦初置丞相，以樗里疾为右丞相	秦国设置丞相职务，任命樗里疾为右丞相
	七年
秦、魏会于应	秦国、魏国在应城举行会议
秦王使甘茂约魏以伐韩，而令向寿辅行	秦王派甘茂去约定魏国共同进攻韩国，又让向寿作他的助手
甘茂令向寿还，谓王曰：魏听臣矣，然愿王勿伐	甘茂命令向寿回国对秦王说：魏国倒是听从了我的安排，不过我希望大王您不要进攻韩国
王迎甘茂于息壤而问其故	秦王在息壤迎接甘茂，询问原因，甘茂回答说：宜阳是个大县，其实应属郡一级
对曰：宜阳大县，其实郡也	现在大王您下令面对多重险隘，不远千里，发兵进攻，是很困难的
今王倍数险，行千里，攻之难	鲁国有个与曾参同姓名的人杀了人，有人告诉曾参的母亲，他的母亲仍旧织布，泰然自若
鲁人有与曾参同姓名者杀人，人告其母，其母织自若也	等到先后来了三个人告诉她同样的事情，曾参母亲也扔下机杼，跳墙逃走了
及三人告之，其母投杼下机，逾墙而走	我的贤良不如曾参，大王您对我的信任又不如曾参的母亲，猜疑我的人更不止三个人，所以我怕大王您将来也会有扔下机杼的举动
臣之贤不若曾参，王之信臣又不如其母，疑臣者非特三人，臣恐大王之投杼也	再说当年魏文侯任命乐羊为大将进攻中山国，三年才攻下
魏文侯令乐羊将而攻中山，三年而拔之	回来论功行赏，魏文侯向乐羊出示别人的指控书，多达一筐
反而论功，文侯示之谤书一箧	乐羊一再叩头行礼说：这不是我的功劳，实在要归功于您信任啊
乐羊再拜稽首曰：此非臣之功，君之力也	现在我甘茂，是个寄居秦国的外籍人，樗里子、公孙将来抓住韩国的事情来攻击我，大王一定会听信他们
今臣，羁旅之臣也，樗里子、公孙挟韩而议之，王必听之，是王欺魏王而臣受公仲侈之怨也	那时攻宜阳前功尽弃，结果是大王您背弃了与魏王的约定，而我遭受韩国国相公仲侈的怨恨
王曰：寡人弗听也，请与子盟	秦王说：我不会听他们的，可以和你起誓
乃盟于息壤	于是两人在息壤立下誓言
秋，甘茂、庶长封帅师伐宜阳	秋季，甘茂和名叫封的庶长率领大军前去攻打宜阳
	八年
楚王与齐国、韩国订立同盟	彗星见
十年	
秦王、楚王在黄棘会盟，秦国把上庸归还给楚国	彗星见
十二年	
天空出现彗星	秦取魏蒲阪、晋阳、封陵；又取韩武遂
秦王、魏王、韩国太子韩婴在临晋举行会议，韩国太子又前往秦国咸阳后才归去，秦国把蒲阪归还给魏国	秦大夫有私与楚太子斗者，太子杀之，亡归
秦国有个大夫私下与楚国太子争斗，楚太子杀了他后，逃回楚国	日有食之，既
十四年	
出现日全食	秦人取韩穰
秦国夺取韩国穰城	蜀守辉叛秦，秦司马错往诛之
蜀地郡守嬴辉反叛秦国，秦国派司马错前去将他处死	秦庶长奂会韩、魏、齐兵伐楚，败其师于重丘，杀其将唐昧；遂取重丘
秦国派名叫奂的庶长联合韩、魏、齐三国出兵攻打楚国，在重丘大败楚军，杀死楚将唐昧，夺取重丘	赵王伐中山，中山君奔齐
赵王出兵攻打中山国，中山国君逃奔齐国	秦泾阳君为质于齐
十五年	
秦国樗里疾去世，任命赵国人楼缓为丞相	赵武灵王爱少子何，欲及其生而立之
赵主父视察新获取的领土，离开代郡，向西在西河会见楼烦王，接受了他的部队	魏襄王薨，子昭王立
魏国魏襄王去世，其子即位为魏昭王	韩襄王薨，子王咎立
韩国韩襄王去世，其子韩咎即位为韩王	秦尉错伐魏襄城
二十年	
赵主父把长子赵章封到代，号称安阳君	秦楼缓免相，魏冉代之
秦国罢免楼缓的丞相，由魏冉代任	秦败魏师于解
二十一年	
楚襄王从秦国迎娶新娘	秦魏冉谢病免，以客卿烛寿为丞相
秦国魏冉因病辞去职务，以客卿烛寿为丞相	秦伐韩，拔宛
二十四年	
秦国进攻韩国，攻克宛	魏入河东地四百里、韩入武遂地二百里于秦
魏国把河东地方圆四百里、韩国把武遂地方圆二百里献给秦国	魏芒卯始以诈见重
魏国芒卯以诈术开始受到重用	秦大良造白起、客卿错伐魏，至轵，取城大小六十一
二十六年	
秦国攻打赵国，攻克杜阳	秦攻赵，拔新垣、曲阳
二十八年	
秦国派司马错攻击魏国河内，魏国献出安邑求和，秦国将城内人民驱赶回魏国	秦败韩师于夏山
秦王与楚王在宛相会，与赵王在中阳相会	秦蒙武击齐，拔九城
秦国攻打赵国，夺取两座城	秦伐赵，拔石城
三十四年	
秦国又攻打赵国，夺取石城	秦穰侯复为丞相
秦国武安君平定巫、黔中，秦国在此设置黔中郡	魏昭王薨，子安王立
魏国魏昭王去世，其子即位为魏安王	秦武安君伐魏，拔两城
三十九年	
秦国武安君进攻魏国，攻占两城	楚王收东地兵，得十余万，复西取江南十五邑
楚王召集东部军队，得到十余万人，又向西攻取长江以南十五邑	魏安王封其弟无忌为信陵君
楚国派左徒黄歇侍奉在秦国做人质的太子芈完	秦置南阳郡
秦国设置南阳郡	秦、魏、楚共伐燕
秦国、魏国、楚国共同进攻燕国	燕惠王薨，子武成王立
燕国燕惠王去世，其子即位为燕武成王	赵蔺相如伐齐，至平邑
四十四年	
秦中更胡伤攻赵阏与，不拔	秦国任中更之职的胡伤率军进攻赵国阏与，未能攻克
	四十七年
秦王用范睢之谋，使五大夫绾伐魏，拔怀	秦王听从范睢的计策，派五大夫绾攻打魏国，攻克怀地
	四十八年
秦悼太子质于魏而卒	秦国太子悼到魏国做人质，死在那里
	四十九年
赵惠文王薨，子孝成王丹立；以平原君为相	赵国赵惠文王去世，其子赵丹即位为赵孝成王；任用赵胜为国相
	五十年
秦宣太后薨	秦国宣太后去世
九月，穰侯出之陶	九月，魏冉离开咸阳回到陶邑
秦国武安君白起进攻韩国，攻克九座城，杀死五万人	田单为赵相
田单任赵国国相	秦武安君伐韩，取南阳；攻太行道，绝之
五十二年	
昭襄王在雍城南郊祭祀上帝	楚迁于钜阳
庄襄王封相国吕不韦为文信侯，将河南洛阳十万户作他的封地	蒙骜伐韩，取成皋、荥阳，初置三川郡
秦将蒙骜攻打韩国，夺取了成皋、荥阳，始设置三川郡	楚灭鲁，迁鲁顷公于，为家人
楚国灭亡了鲁国，把鲁顷公迁移到，贬为平民	日有食之
二年	
出现日食	蒙骜伐赵，取榆次、狼孟等三十七城
秦国属地晋阳反叛	蒙骜击定之
始皇帝	
秦国发生大饥荒	蒙骜伐韩，取十二城
魏国国君安王去世，子魏增继位，是为景王	蒙骜伐魏，取酸枣、燕、虚、长平、雍丘、山阳等三十城；初置东郡
五年	
秦军进攻魏国，夺取了汲	夏太后薨
秦国夏太后去世	蒙骜卒
秦将蒙骜去世	魏与赵邺
八年	
魏国将邺割让给赵国	韩桓惠王薨，子安立
韩国国君桓惠王去世，子韩安继位	伐魏，取垣、蒲
九年	
秦军征伐魏国，攻克垣、蒲两城	夏，四月，寒，民有冻死者
夏季，四月，天气骤然酷寒，秦国百姓有被冻死的	王宿雍
秦王嬴政住宿在雍城	己酉，王冠，带剑
己酉，秦王嬴政举行成年加冠礼，同时佩带宝剑	杨端和伐魏，取衍氏
嬴政因吕不韦事奉先王功劳卓著，不忍心将他杀死	冬，十月，文信侯免相，出就国
十年	
赵国人进攻燕国，夺取阳	赵悼襄王薨，子幽缪王迁立
战事还未结束，秦国的大将王翦、桓、杨端和已率军征伐赵国，攻击邺地，战领了九个城邑	其母，倡也，嬖于悼襄王，悼襄王废嫡子嘉而立之
其中王翦领兵攻打阏与、阳，桓率军夺取了邺、安阳	迁素以无行闻于国
秦国自六月到八月，一直不降雨	发四郡兵助魏伐楚
魏国人割献土地给秦国	代地震，自乐徐以西，北至平阴，台屋墙垣太半坏，地坼东西百三十步
代地发生地震，自乐徐以西，北到平阴，楼台房屋墙垣大半塌毁，土地开裂一条臣缝，东西宽一百三十步	内史胜灭韩，虏韩王安，以其地置颍川郡
十七年	
秦王政的祖母华阳太后去世	赵大饥
赵国发生大饥荒	卫元君薨，子角立
秦将王翦、蒙武俘获了楚国国君芈负刍，在楚地设置楚郡	大兴兵，使王贲攻辽东，虏燕王喜
二十五年	
秦国大举兴兵，派王贲率兵进攻辽东，俘获了燕国国君姬喜	王贲攻代，虏代王嘉
秦将王贲率军攻代，俘获代王赵嘉	王翦悉定荆江南地，降百越之君，置会稽郡
秦将王翦全部平定楚国长江以南的地区，降服百越的首领，设置了会稽郡	五月，天下大
早先，韩国人张良的父亲、祖父曾经做过五代韩相	始皇东游，至阳武博浪沙中，张良令力士操铁椎狙击始皇，误中副车
乃至韩国灭亡，张良尽散千金家产，想要为韩国报仇	始皇惊，求，弗得；令天下大索十日
二十九年	
秦朝廷将徇私枉法、知人有罪却释放出狱、无罪却下狱的司法官吏处罚流放去修筑长城，或到南越地区守边	使蒙恬除直道，道九原，抵云阳，堑山堙谷千八百里；数年不就
冬季，十月，戊寅，实行大赦	春，二世东行郡县，李斯从；到碣石，并海，南至会稽；而尽刻始皇所立刻石，旁著大臣从者名，以章先帝成功盛德而还
陈人秦嘉、符离人朱鸡石等聚众起兵，将东海郡守围困在郯地	二世益遣长史司马欣、董翳佐章邯击盗
陈胜闻讯，即派名叫畔的武平君任将军，督率围郯城的各路军队	章邯已破伍逢，击陈柱国房君，杀之；又进击陈西张贺军
秦嘉不接受此命令，自立为大司马，并由于厌恶隶属于武平君而告诉他的军吏说：武平君年少，不懂用兵之事，不要听他的	陈王出监战
随即假传陈胜的命令，杀了武平君畔	张贺死
东阳人宁君和秦嘉闻听陈胜兵败，便拥立景驹为楚王，领兵前往方与，打算在定陶攻击秦军，即遣公孙庆出使齐国，想要与齐合力共同进军攻秦	楚王景驹在留，沛公往从之
齐王说：陈胜战败，至今生死不明，楚国怎么能不请示齐国便自行立王呀	张良亦聚少年百余人欲往从景驹，道遇沛公，遂属焉；沛公拜良为厩将
公孙庆道：齐国不请示楚国即立王，楚国为什么要请示齐国后才立王呢	良数以太公兵法说沛公；沛公善之，常用其策；良为他人言，皆不省
况且楚国首先起事，理当号令天下	良曰：沛公殆天授
齐王田儋于是就将公孙庆杀了	故遂留不去
魏豹率军攻克了故魏国的二十多个城市，楚怀王即封立魏豹为魏王	后九月，楚怀王并吕臣、项羽军，自将之；以沛公为砀郡长，封武安侯，将砀郡兵；封项羽为长安侯，号为鲁公；吕臣为司徒，其父吕青为令尹
十二月，刘邦率军到达栗县时，遇上刚武侯，夺过他手中的部队四千多人，与自己的队伍合并起来，同魏将皇欣、武满的军队联合攻打秦军，击败了对手	故齐王建孙安下济北，从项羽救赵
燕王韩广不肯到辽东去作辽东王，臧荼就击杀了他，兼并了他的领地	是岁，以内史沛周苛为御史大夫
这一年，汉王任用内史、沛人周苛为御史大夫	项王使趣义帝行，其群臣、左右稍稍叛之
项羽派人催促义帝快到郴地去，义帝的群臣、近侍便逐渐背叛了义帝	冬，十月，项王密使九江、衡山、临江王击义帝，杀之江中
二年	
汉王到陕县去，安抚关外的父老	河南王申阳降，置河南郡
汉王返回都城栎阳	诸将拔陇西
六月，汉王返回栎阳	壬午，立子盈为太子；赦罪人
汉军引水灌淹废丘，废丘城守军投降，章邯自杀	关中大饥，米斛万钱，人相食
汉军于是完全平定了雍地，设置了中地、北地、陇西等郡	令民就食蜀、汉
关中发生大饥荒，一斛米卖到万钱，人们饿得自相残食	秋，八月，汉王如荥阳，命萧何守关中侍太子，为法令约束，立宗庙、社稷、宫室、县邑；事有不及奏决者，辄以便宜施行，上来，以闻
汉王便让关中的百姓到蜀、汉去谋生	计关中户口，转漕、调兵以给军，未尝乏绝
秋季，八月，汉王前往荥阳，命萧何留守关中服侍太子	汉王使郦食其往说魏王豹，且召之
萧何着手制订法令规章，建立宗庙、社稷、宫室、县邑机构，遇事如来不及奏报汉王裁决，就酌情灵活处理，待汉王回来时再作汇报	豹不听，曰：汉王慢而侮人，骂詈诸侯、群臣如骂奴耳，吾不忍复见也
他在关中还管理人口户籍，运输粮草，调拨士兵补给汉军兵员，从来没有缺乏、断绝过	于是汉王以韩信为左丞相，与灌婴、曹参俱击魏
甲戌晦，发生日食	十一月，癸卯晦，日有食之
秋季，七月，有异星出现于大角星旁	临江王敖薨，子尉嗣
汉王得到韩信的军队后，重又士气大振	彭越攻徇梁地，下睢阳、外黄等十七城
八月，领兵来到黄河岸边，向南驻扎在小修武，想要与楚军再战	九月，项王谓大司马曹咎曰：谨守成皋
郎中郑忠劝阻汉王，让他高筑营垒、深挖壕沟，不要与楚军交锋	即汉王欲挑战，慎勿与战，勿令得东而已
汉王听从了他的计策，派将军刘贾、卢绾率步兵两万人、骑兵几百人，渡过白马津，进入楚地，协助彭越，烧毁楚国积聚的粮草辎重，以破坏楚国的后备基础，使它无法再给前方项羽的军队供给粮草	我十五日必定梁地，复从将军
楚军进攻刘贾，刘贾总是坚守营垒不肯与楚军接战，而与彭越相互呼应救援	羽引兵东行，击陈留、外黄、睢阳等城，皆下之
冬季，十月，韩信打败了齐国的历下守军，随后直打到齐国的都城临淄	楚大司马咎守成皋，汉数挑战，楚军不出
齐王田广认为郦食其出卖了自己，就煮杀了他	使人辱之，数日，咎怒，渡兵汜水
然后领兵向东逃往高密，派使者到楚国去请求救援	士卒半渡，汉击之，大破楚军，尽得楚国金玉、货赂，咎及司马欣皆自刭汜水上
田横这时逃奔博阳，守相田光逃奔城阳，将军田既驻扎在胶东	汉王引兵渡河，复取成皋，军广武，就敖仓食
秋季，七月，汉王立黥布为淮南王	八月，北貉燕人来致枭骑助汉
汉王下令：凡军士在战争中不幸死亡的，官吏要为他们用衣被棺木殓尸，并转送回死者家中	是岁，以中尉周昌为御史大夫
此令一施行，四面八方的人都心甘情愿地来归附汉王了	昌，苛从弟也
汉王回军到达定陶县，奔入齐王韩信的营垒，接管了他的部队	临江王共尉不降，遣卢绾、刘贾击虏之
高帝刘邦向西建都洛阳	夏，五月，兵皆罢归家
六月，壬辰，高帝大赦天下	秋，七月，燕王臧荼反；上自将征之
秋季，七月，燕王臧荼反叛，高帝亲自率军征讨臧荼	赵景王耳、长沙文王芮皆薨
项羽过去的将领利几反叛，高帝又亲自带兵击败了他	后九月，治长乐宫
高帝由于天下刚刚平定，自己的儿子年幼，兄弟又少，便以秦王朝孤立而导致灭亡的教训为鉴戒，想要大肆分封同姓族人，借此镇抚天下	上以韩王信材武，所王北近巩、洛，南迫宛、叶，东有淮阳，皆天下劲兵处；乃以太原郡三十一县为韩国，徙韩王信王太原以北，备御胡，都晋阳
春季，正月，丙午，高帝把楚王韩信的封地分为两个王国，将淮河以东五十三个县封给堂兄将军刘贾做荆王，将薛郡、东海、彭城等地三十六个县封给弟弟文信君刘交为楚王	信上书曰：国被边，匈奴数入寇；晋阳去塞远，请治马邑
壬子，把云中、雁门、代郡等地五十三个县封给哥哥宜信侯刘喜做代王，把胶东、胶西、临淄、济北、博阳、城阳郡等地七十三个县封给自己平民时与同居的妇人所生的儿子刘肥当齐王，百姓中能讲齐国话的人都分给了齐国	上许之
高帝已经封赏了大功臣二十多人，其余的人日夜争功，一时决定不下来，便没能给予封赏	列侯毕已受封，诏定元功十八人位次
高帝在洛阳南宫，从天桥上望见将领们往往三人一群两人一伙地同坐在沙地中谈论着什么	皆曰：平阳侯曹参，身被七十创，攻城略地，功最多，宜第一
高帝说：这是在说些什么呀	谒者、关内侯鄂千秋进曰：群臣议皆误，夫曹参虽有野战略地之功，此特一时之事耳
留侯张良道：陛下不知道吗	上与楚相距五岁，失军亡众，跳身遁者数矣；然萧何常从关中遣军补其处，非上所诏令召，而数万众会上之乏绝者数矣
这是在图谋造反啊	又军无见粮，萧何转漕关中，给食不乏
高帝说：天下新近刚刚安定下来，为了什么缘故又要谋反呢	陛下虽数亡山东，萧何常全关中以待陛下
留侯说：陛下由平民百姓起家，依靠这班人夺取了天下	此万世之功也
如今陛下做了天子，所封赏的都是自己亲近喜爱的老友，所诛杀的都是自己生平仇视怨恨的人	今虽无曹参等百数，何缺于汉；汉得之，不必待以全
现在军吏们计算功劳，认为即使把天下的土地都划作封国也不够全部封赏的了，于是这帮人就害怕陛下对他们不能全部封赏，又恐怕因往常的过失而被猜疑以至于遭到诛杀，所以就相互聚集到一起图谋造反了	柰何欲以一旦之功而加万世之功哉
高帝于是担忧地说：这该怎么办呀	萧何第一，曹参次之
留侯道：皇上平素最憎恶、且群臣又都知道的人，是谁啊	上曰：善
高帝说：雍齿与我有旧怨，他曾经多次困辱我	于是乃赐萧何带剑履上殿，入朝不趋
我想杀掉他，但由于他功劳很多，所以不忍心下手	上曰：吾闻进贤受上赏
留侯说：那么现在就赶快先封赏雍齿，这样一来，群臣也就人人都对自己的能受封赏坚信不疑了	萧何功虽高，得鄂君乃益明
高帝这时便置备酒宴，封雍齿为什方侯，并急速催促丞相、御史论定功劳进行封赏	于是因鄂千秋所食邑，封为安平侯
群臣结束饮宴后，都欢喜异常，说道：雍齿尚且封为侯，我们这些人也就没有什么可担优的啦	是日，悉封何父子兄弟十余人，皆有食邑；益封何二千户
高帝返归栎阳	夏，五月，丙午，尊太公为太上皇
高帝从栎阳迁都长安	初置宗正官，以序九族
始设置宗正官，管理皇族宗室	夏，四月，帝行如洛阳
春季，三月，高帝前往洛阳	令贾人毋得衣锦、绣、绮、、、、，操兵、乘、骑马
高帝下令，商人不准穿锦、绣、细绫、绉纱、细葛布、布、毛织品，不准持兵器、乘车、骑马	秋，九月，行自洛阳至；淮南王、梁王、赵王、楚王皆从
高帝颁布诏书：丙寅日以前犯罪者，死罪以下，都予以赦免	二月，行自洛阳至
夏季，六月晦，出现日食	更以丞相何为相国
高帝立儿子刘恒为代王，以晋阳为都城	大赦天下
夏季，四月，高帝一行从洛阳回长安	五月，诏立秦南海尉赵佗为南粤王，使陆贾即授玺绶，与剖符通使，使和集百越，无为南边患害
周勃全部平定代郡、雁门、云中等地，在当城将陈斩首	上以荆王贾无后，更以荆为吴国；辛丑，立兄仲之子濞为吴王，王三郡、五十三城
五月，丙寅，将高帝刘邦安葬在长陵	己巳，太子即皇帝位，尊皇后曰皇太后
朝廷改封淮阳王刘友为赵王	春，正月，始作长安城西北方
春季，正月，癸酉，兰陵一平民家的井中出现两条龙	陇西地震
陇西发生地震	夏，旱
夏季，大旱	阳侯仲薨
六月，朝廷征发各封国的王、侯属下刑徒奴隶二万人修筑长安城	秋，七月，都厩灾
秋季，七月，太仆的马厩起火	是岁，蜀湔氐反，击平之
春季，正月，朝廷下令推荐民间孝顺父母、和睦兄长、努力耕作的人，免除他们的赋役	三月，甲子，皇帝冠，赦天下
三月，甲子，皇帝行成年加冠礼，大赦天下	省法令妨吏民者；除挟书律
长乐宫中鸿台发生火灾	秋，七月，乙亥，未央宫凌室灾；丙子，织室灾
冬季，雷声响起，桃树、李树开花，枣树结果	春，正月，复发长安六百里内男女十四万五千人城长安，三十日罢
春季，正月，再次征发长安周围六百里内男女民工十四万五千人修筑长安城，三十天后结束	夏，大旱，江河水少，溪谷水绝
夏季，大旱，长江、黄河水少，溪谷干涸	秋，八月，平阳懿侯曹参薨
秋季八月，平阳侯曹参去世	冬，十月，以王陵为右丞相，陈平为左丞相
六年	
冬季，十月，任命王陵为右丞相，陈平为左丞相	齐悼惠王肥薨
齐悼惠王刘肥去世	夏，留文成侯张良薨
夏季，留侯张良去世	以周勃为太尉
任命周勃为太尉	冬，发车骑、材官诣荥阳，太尉灌婴将
七年	
冬季，征发战车和骑兵、步兵前往荥阳，由太尉灌婴统率	春，正月，辛丑朔，日有食之
春季，正月，辛丑朔，出现日食	夏，五月，丁卯，日有食之，既
春季，正月，太后下令废除三族罪和妖言令	夏，四月，鲁元公主薨；封公主子张偃为鲁王，谥公主曰鲁元太后
夏季，四月，太后的女儿鲁元公主去世，封公主之子张偃为鲁元王，议定公主的谥号为鲁元太后	辛卯，封所名孝惠子山为襄城侯，朝为轵侯，武为壶关侯
辛卯，太后晋封号称是孝惠帝之子的刘山为襄城侯，刘朝为轵侯，刘武为壶关侯	五月，丙申，赵王宫丛台灾
五月，丙申，赵王宫中的丛台，发生了火灾	秋，桃、李华
秋天，桃树、李树都不合时令地开了花	冬，十一月，吕肃王台薨
二年	
冬季，十一月，吕肃王吕台去世	春，正月，乙卯，地震，羌道、武都道山崩
春季，正月，乙卯，发生大地震；羌道、武都道山体崩裂	夏，五月，丙申，封楚元王子郢客为上邳侯，齐悼惠王子章为朱虚侯，令入宿卫；又以吕禄女妻章
夏季，五月丙申，太后封楚元王之子刘郢客为上邳侯，封齐悼惠王之子刘章为朱虚侯，令二人入宫担任侍卫，并把吕禄的女儿嫁给刘章为妻	六月，丙戌晦，日有食之
六月丙戌晦，出现日食	秋，七月，恒山哀王不疑薨
秋季，七月，恒山哀王刘不疑去世	行八铢钱
朝廷下令，发行八铢钱	癸丑，立襄成侯山为恒山王，更名义
癸丑，太后晋封原襄成侯刘山为恒山王，并为他改名刘义	夏，江水、汉水溢，流四千余家
三年	
夏季，长江、汉水泛滥成灾，淹没了四千多户人家	秋，星昼见
春季，二月，癸未，太后封立号称为孝惠帝之子的刘太为昌平侯	夏，四月，丙申，太后封女弟为临光侯
春季，赵佗自称南越武帝，发兵进攻长沙国，打败几个县的守军之后离去	秋，八月，淮阳怀王强薨，以壶关侯武为淮阳王
秋季，八月，淮阳王刘强去世，太后立壶关侯刘武为淮阳王	九月，发河东、上党骑屯北地
九月，征发河东郡和上党郡的骑兵，屯守北地郡	初令戍卒岁更
春季，星星白昼出现于天空	夏，四月，丁酉，赦天下
夏季，四月，丁酉，大赦天下	封朱虚侯章弟兴居为东牟侯，亦入宿卫
太后封朱虚侯刘章的弟弟刘兴居为东牟侯，又诏令他参预宫廷宿卫	匈奴寇狄道，攻阿阳
匈奴侵略狄道，进攻阿阳	行五分钱
朝廷下令，发行五分钱	宣平侯张敖卒，赐谥曰鲁元王
宣平侯张敖去世，赐谥号为鲁元王	冬，十二月，匈奴寇狄道，略二千余人
七年	
吕之女是将军、营陵侯刘泽的妻子	赵王恢之徒赵，心怀不乐
刘泽是高祖的远支堂弟	太后以吕产女为王后，王后从官皆诸吕，擅权，微伺赵王，赵王不得自恣
齐人田生为刘泽向大谒者张卿说：太后封诸吕为王，诸位大臣并不全都心服	王有所爱姬，王后使人鸩杀之
营陵侯刘泽，在刘氏宗室中年龄最长，如果你现在能向太后建议封刘泽为王，那么，吕氏受封为王的格局就会更加稳定了	六月，王不胜悲愤，自杀
张卿入宫报告太后，太后以为很有道理，就分割齐国的琅邪郡为诸侯国，封刘泽做了琅邪王	太后闻之，以为王用妇人弃宗庙礼，废其嗣
太后派遣隆虑侯周灶领兵进攻南越国	冬，十月，辛丑，立吕肃王子东平侯通为燕王；封通弟庄为东平侯
八年	
楚元王刘交去世	夏，四月，齐、楚地震，二十九山同日崩，大水溃出
冬季，十月，曲逆侯陈平去世	诏列侯各之国；为吏及诏所止者，遣太子
汉文帝下诏，令列侯各自离京到所封领地去；身为朝廷官员和受诏书留居京师的列侯，则派遣他们的太子到封地去	十一月，乙亥，周勃复为丞相
九月，文帝下诏说：农业，是天下的根本，百姓依靠它而生存；有的百姓不从事农耕的本业，却去从事工商末业，所以百姓生活艰难	
朕对此甚为担忧，所以现在亲自率领群臣从事农业耕作，以提倡重视农业；今年只向天下百姓征收田租的一半	燕敬王泽薨
燕王刘泽去世	冬，十月，丁酉晦，日有食之
冬季，十月丁酉晦，出现日食	十一月，丁卯晦，日有食之
兴建顾成庙	春，二月，地震
五年	
冬季，十月，文帝下诏令规定：对列侯的母亲、夫人、诸侯王的儿子以及二千石以上的官吏，不经批准，不得擅自逮捕	夏，四月，赦天下
夏季，四月，大赦天下	六月，癸酉，未央宫东阙罘灾
有彗星出现在东方	春，大旱
九年	
春季，发生大旱灾	冬，上行幸甘泉
十年	
文帝改封城阳王刘喜为淮南王	匈奴寇狄道
匈奴侵犯狄道	冬，十二月，河决酸枣，东溃金堤、东郡；大兴卒塞之
冬季，十二月，黄河在酸枣县决口，向东冲溃了金堤，淹没东郡；朝廷大量征发士卒堵塞决口	春，三月，除关，无用传
晁错对文帝说：英明的君主在位，百姓不受饥寒的折磨，这并不是君主能亲自耕作供给百姓食物，亲自织布为百姓做衣服，而是君主为百姓开辟了生财之路	春，二月，甲寅，诏曰：朕亲率天下农耕以供粢盛，皇后亲桑以供祭服；其具礼仪
所以尧遇到九年的大涝灾，商汤七年的大旱灾，而全国并没有被抛弃的病饿者，其原因就在蓄	
当初，秦朝的祝官中有秘祝，一旦出现了灾异，就把造成过失的责任从皇帝身上移到臣子身上	齐太仓令淳于意有罪，当刑，诏狱逮系长安
夏季，文帝下诏书说：朕听说天之道，祸从怨而起，福由德而兴，百官的过失，都应该由朕一人负责	其少女缇萦上书曰：妾父为吏，齐中皆称其廉平；今坐法当刑
现在秘祝官员把过失的责任推给臣下，是显扬了朕的失德，朕很不赞成	妾伤夫死者不可复生，刑者不可复属，虽后欲改过自新，其道无繇也
应予废除	妾愿没入为官婢，以赎父刑罪，使得自新
这一年，河间王刘辟强去世	初，丞相张苍以为汉得水德，鲁人公孙臣以为汉当土德，其应，黄龙见；苍以为非，罢之
赵国人新垣平自称善于望气，得以进见文帝	夏，四月，上郊祀五帝于渭阳五帝庙
他说长安东北有神，结成五彩之气	于是贵新垣平至上大夫，赐累千金；而使博士、诸生刺《六经》中作《王制》，谋议巡狩、封禅事
于是文帝下令在渭阳修建五帝庙	又于长门道北立五帝坛
十六年	
夏季，四月，文帝在渭阳五帝庙郊祭五帝	徙淮南王喜为城阳王
这时，文帝宠贵新垣平，封为上大夫，赏赐黄金累计一千斤；文帝还让博士、诸生杂采《六经》中的记载，汇集成《王制》，谋划议论巡狩、封禅等事	又分齐为六国；丙寅，立齐悼惠王子在者六人：杨虚侯将闾为齐王，安都侯志为济北王，武成侯贤为川王，白石侯雄渠为胶东王，平昌侯为胶西王，侯辟光为济南王
又在长门亭的道北设立了五帝坛	淮南厉王子在者三人：阜陵侯安为淮南王，安阳侯勃为衡山王，阳周侯赐为庐江王
夏季，文帝前往雍地的阳宫	六月，代孝王参薨
春季，二月，文帝前往代国	是岁，匈奴老上单于死，子军臣单于立
这一年，匈奴老上单于死，其子军臣单于继位	夏，四月，丙寅晦，日有食之
四年	
夏季，四月，丙寅晦，出现了日食	五月，赦天下
五月，文帝宣布大赦天下	上行幸雍
文帝前往雍县	春，正月，上行幸陇西；三月，行幸雍；秋，七月，行幸代
五年	
九月，在西方天空出现了一颗异星	是岁，长沙王吴著薨，无子，国除
夏季，四月，乙卯，大赦天下	遣御史大夫青至代下与匈奴和亲
景帝派遣御史大夫陶青，到代国边塞，与匈奴和亲	五月，复收民田半租，三十而税一
冬季，十二月，西南天空出现了一颗异星	令天下男子年二十始傅
景帝命令全国男子，从二十岁开始到官府登记成为正丁，承担国家的徭役和兵役	春，三月，甲寅，立皇子德为河间王，阏为临江王，馀为淮阳王，非为汝南王，彭祖为广川王，发为长沙王
春季，三月，甲寅，景帝封立皇子刘德为河间王，刘阏为临江王，刘馀为淮阳王，刘非为汝南王，刘彭祖为广川王，刘发为长沙王	夏，四月，壬午，太皇太后薄氏崩
秋季，衡山国境内下了一场冰雹，大的直径有五寸，冰雹堆积最厚的地方达二尺	荧惑逆行守北辰，月出北辰间；岁星逆行天廷中
春季，正月，乙巳，景帝下达赦令	长星出西方
彗星出现在西方天空	洛阳东宫灾
因为吴王刘濞丢掉军队自己逃跑，吴军就崩溃瓦解了，许多部队渐渐向太尉条侯周亚夫和梁国的军队投降	河间王太傅卫绾击吴、楚有功，拜为中尉
吴王刘濞渡过淮河，逃到丹徒县，依附东越，以求自保，约有军队一万多人，并召集逃散的士兵	绾以中郎将事文帝，醇谨无他
汉朝派人用金钱利禄收买东越首领，东越首领就骗吴王出来慰劳军队，派人用矛戟刺杀了吴王，装上他的头颅，派人乘传车疾驰到汉朝廷报告	上为太子时，召文帝左右饮，而绾称病不行
吴国太子刘驹逃亡到闽越国	文帝且崩，属上曰：绾长者，善遇之
吴、楚叛乱，共三个月的时间，就全被平定了，这时，所有将领都认为太尉周亚夫的战略布署是正确的；但是，梁王却因此与太尉有了矛盾	故上亦宠任焉
夏季，六月，乙亥，景帝下诏说：官吏百姓被吴王刘濞等人连累而应当判罪的，以及从军而逃亡的，都给予赦免	春，复置关，用传出入
春季，重新设置关卡，凭符传出入	夏，四月，已巳，立子荣为皇太子，彻为胶东王
夏季，四月，己巳，景帝立皇子刘荣为皇太子，刘彻为胶东王	六月，赦天下
六月，大赦天下	秋，七月，临江王阏薨
秋季，七月，临江王刘阏去世	冬，十月，戊戌晦，日有食之
景帝送公主出嫁匈奴单于	徙广川王彭祖为赵王
景帝改封广川王刘彭祖为赵王	济北贞王勃薨
济北王刘勃去世	冬，十二月，雷，霖雨
六年	
夏季，四月，乙巳，景帝立王氏为皇后	丁巳，立胶东王彻为皇太子
丁巳，景帝立胶东王刘彻为皇太子	是岁，以太仆刘舍为御史大夫，济南太守郅都为中尉
这一年，景帝任命太仆刘舍任御史大夫，任命济南郡太守郅都为中尉	夏，四月，乙巳，赦天下
发生地震，衡山国的原都一带降冰雹，最大的冰雹直径达一尺八寸	春，二月，匈奴入燕
二年	
夏季，四月，在西北天空出现一颗异星	立皇子越为广川王，寄为胶东王
景帝封立皇子刘越为广川王，刘寄为胶东王	秋，九月，甲戌晦，日有食之
冬季，十一月，朝廷宣布废除诸侯王国的御史大夫官职	夏，四月，地震
夏季，四月，发生了地震	旱，禁酤酒
出现旱灾，朝廷禁止卖酒	三月，丁巳，立皇子乘为清河王
三月，丁巳，景帝封立皇子刘乘为清河王	秋，九月，蝗
秋季，九月，发生蝗灾	有星孛于西北
西北天空出现了一颗异星	戊戌晦，日有食之
夏季，发生蝗灾	冬，十月，戊午，日有食之
冬季，十月，戊午，出现日食	夏，立皇子舜为常山王
五年	
夏季，景帝封立皇子刘舜为常山王	六月，丁已，赦天下
六月，丁巳，大赦天下	大水
秋季，八月，己酉，未央宫东门阙发生火灾	九月，诏：诸狱疑，若虽文致于法而于人心不厌者，辄谳之
九月，景帝下诏说：诸项疑难案件，如果根据法律条文可以定为重罪，但却无法使人心服的，立即予以平议	地震
十一月，景帝下诏，更改廷尉、将作少府等官名	春，二月，乙卯，上行幸雍，郊五
春季，二月，乙卯，景帝亲临雍地，在祭祀天地五帝的处所祭天	三月，雨雪
夏季，四月，梁孝王去世	上既减笞法，笞者犹不全；乃更减笞三百曰二百，笞二百曰一百
窦太后听到消息，哭得极其悲哀，不进饮食，说：皇帝果然杀了我儿子	又定棰令：棰长五尺，其本大一寸，竹也；末薄半寸，皆平其节
景帝悲哀恐惧，不知怎么办才好；与姐姐长公主商议，于是把梁国分为五国，把梁孝王的五个儿子全都封为诸侯王：刘买为梁王，刘明为济川王，刘彭离为济东王，刘定为山阳王，刘不识为济阴王；梁孝王的五个女儿也都封给汤沐邑	当笞者笞臀；毕一罪，乃更人
景帝把这一决定禀告窦太后，太后才高兴起来，为景帝这一做法而吃了一顿饭	自是笞者得全
梁孝王没死的时候，有数以万万计的财产，他死后，梁国府库中剩余的黄金还有四十多万斤，其他财物的价值也与此相当	然死刑既重而生刑又轻，民易犯之
三月，景帝下诏，大赦天下	夏，大五日，民得酤酒
秋季，七月，丙午，丞相刘舍被免职	乙巳晦，日有食之
这一年，济阴王刘不识去世	春，正月，地一日三动
二年	
五月，景帝下诏规定，家中资财达到四万钱的，就可以做官	秋，大旱
秋季，发生大旱	冬，十月，日月皆食，赤五日
三年	
冬季，十月，发生了日食和月食，日月呈红色，持续了五天	十二月晦，雷；日如紫；五星逆行守太微；月贯天廷中
二月，癸酉，将孝景皇帝安葬在阳陵	三月，封皇太后同母弟田为武安侯，胜为周阳侯
春季，二月，汉武帝颁布赦令	行三铢钱
朝廷发行三铢钱	夏，六月，丞相卫绾免
太皇窦太后喜好黄老学说，不喜欢儒家学说	春，二月，丙戌朔，日有食之
赵绾奏请，	
春季，二月，丙戌朔，出现日食	三月，乙未，以太常柏至侯许昌为丞相
夏季，四月，夜间出现了一颗光亮如同太阳的异星	初置茂陵邑
当时，朝廷大臣的议论中多对晁错提出削藩之策被杀而表示冤枉，一心摧残和抑制诸侯王，经常弹劾揭露诸侯王的过失和罪恶，甚至达到吹毛求疵的程度，用笞刑罚威逼诸侯王的臣子屈服，迫使他们证明诸侯王有过失和罪恶；诸侯王没有一个不为此而悲愁怨恨	冬，十月，代王登、长沙王发、中山王胜、济川王明来朝
	上置酒，
黄河在平原郡泛滥成灾	大饥，人相食
发生了大饥荒，人吃人	秋，七月，有星孛于西北
秋季，七月，西北天空中出现了一颗异星	济川王明坐杀中傅，废迁房陵
济川王刘明因杀死中傅而犯罪，被废去王位，流放到房陵县	七国之败也，吴王子驹亡走闽越，怨东瓯杀其父，常劝闽越击东瓯
九月，丙子晦，出现日食	上自初即位，招选天下文学材智之士，待以不次之位
夏季，刮起了一场如同血红色的风	六月，旱
六月，出现旱灾	秋，九月，有星孛于东北
秋季，九月，东北天空出现了异星	是岁，南越王佗死，其孙文王胡立
这一年，南越王赵佗死，他的孙子文王赵胡继承了王号	春，罢三铢钱，行半两钱
春季，朝廷宣布停止使用三铢钱，发行半两钱	置五经博士
朝廷设立五经博士	夏，五月，大蝗
夏季，五月，发生严重的蝗灾	秋，八月，广川惠王越、清河哀王乘皆薨，无后，国除
秋季，八月，广川惠王刘越、清河哀王刘乘都死去，没有后代，他们的封国被废除	春，二月，乙未，辽东高庙灾
春季，二月，乙未，辽东郡的高祖庙发生火灾	夏，四月，壬子，高园便殿火；上素服五日
夏季，四月，壬子，高祖陵寝中的偏殿发生火灾；武帝因此穿戴了五天白色冠服，以示请罪	五月，丁亥，太皇太后崩
五月，丁亥，太皇太后驾崩	六月，癸巳，丞相昌免；武侯田为丞相
	骄侈：治宅甲诸第，
冬季，十一月，武帝首次命令各郡国各自察举孝廉一人，这是采纳了董仲舒的建议而采取的行动	卫尉李广为骁骑将军，屯云中，中尉程不识为车骑将军，屯雁门；
夏季，四月，武帝宣布大赦天下	五月，诏举贤良、文学、上亲策之
五月，下诏察举贤良、文学、武帝亲自出题考试	秋，七月，癸未，日有食之
秋季，七月，癸未，出现日食	冬，十月，上行幸雍，祠五
冬季，十月，武帝来到雍地，在五举行祭祀	李少君以祠灶却老方见上，上尊之
	少君者，故深泽侯舍人，
李少君凭借祭祀灶神求长生不老的方术进见武帝，武帝很尊敬他	毫人谬忌奏祠太一_７曰：天神贵者太一，太一佐曰五帝
夏季，四月，出现寒霜，冻死了野草	御史大夫安国行丞相事，引，堕车，蹇
	五月，丁巳，
武帝下诏调集一万士卒修治雁门郡的险要关隘	秋，七月，大风拔木
八月，庄稼发生螟虫之害	是岁，征吏民有明当世之务、习先圣之术者，县次续令，令与计偕
这一年，武帝征召官吏百姓中明晓当世政务、熟知古代圣王治国之术的人到朝廷任职，命令应征者与各地进京的上计吏同行，由沿途各县供应饭食	冬，初算商车
夏季，大旱，出现蝗灾	六月，上行幸雍
车骑将军卫青统率三万骑兵从雁门郡出击，将军李息领兵从代郡出击；卫青所部斩杀匈奴数千人	车夷君南闾等共二十八万人降，为苍海郡；人徒之费，拟于南夷，燕、齐之间，靡然骚动
东夷君南闾等二十八万人归降，朝廷在其居住区设置了苍海郡；因此而支付的安置徒众的费用，与南夷地区的相同，燕、齐一带，出现骚动	是岁，鲁共王馀、长沙定王发皆薨
这一年，鲁王刘馀、长沙王刘发都去世了	临人主父偃、严安，无终人徐乐，皆上书言事
临人主父偃、严安，无终县人徐乐，都向武帝上书议论政事	冬季，武帝赏赐淮南王刘安几案和手杖，恩准他不必来京朝见
三月，乙亥晦，日有食之	三月，乙亥晦，发生日食
夏，募民徙朔方十万口	夏季，汉朝廷招募了十万百姓迁居朔方郡
张欧免，上欲以蓼侯孔臧为御史大夫	张欧被罢免，武帝想任命蓼侯孔臧继任御史大夫
臧辞曰：臣世以经学为业，乞为太常，典臣家业，与从弟侍中安国纲纪古训，使永垂来嗣	孔臧辞谢说：我家中世代以传习经学为业，请任命我担任太常，典掌我家世传的职业，与堂弟、侍中孔安国一道总结、归纳古人训诫，使儒学永传后世
上乃以臧为太常，其礼赐如三公	武帝就任命孔臧为太常，对他的礼仪赏赐如同三公一样
	三年
三月，赦天下	三月，大赦天下
夏，四月，丙子，封匈奴太子於单为涉安侯，数月而卒	夏季，四月，丙子，武帝封匈奴太子於单为涉安侯，过了几个月於单就死了
匈奴数万骑入塞，杀代郡太守恭，及略千余人	匈奴的几万骑兵越过边界，攻杀代郡太守恭，还掳掠了一千多人
六月，庚午，皇太后崩	六月，庚午，皇太后驾崩
秋，罢西夷，独置南夷、夜郎两县、一都尉，稍令犍为自葆就，	秋季，朝廷罢废了在西夷地区的
匈奴又入雁门，杀略千余人	匈奴再次入侵雁门郡，杀害和掳掠一千多人
冬，上行幸甘泉	冬季，武帝前往甘泉
夏，匈奴入代郡、定襄、上郡，各三万骑，杀略数千人	夏季，匈奴用三万骑兵分别入侵代郡、定襄郡和上郡，杀害和掳掠了数千人
春，大旱	春季，发生严重旱灾
匈奴右贤王数侵扰朔方	匈奴右贤王多次率兵侵扰朔方郡
天子令车骑将军青将三万骑出高阙，	汉武帝任命车骑将军卫青率兵三万自高阙出塞，任命卫尉苏建为游击将军，左内史李沮为强弩将军，太仆公孙贺为骑将军，代相李蔡为轻车将军，他们都归车骑将军统属，一同率兵自朔方出塞；命大行李息、岸头侯张次公为将军，一同
秋，匈奴万骑入代，杀都尉朱英，略千余人	秋季，一万余名匈奴骑兵侵入代郡，杀死都尉朱英，掳掠百姓一千余人
赦天下	大赦天下
冬，十月，上行幸雍，词五，获兽，一角而足有五蹄	冬季，十月，汉武帝巡幸至雍，祭祀于王，捉到一头长有一只角、五个蹄子的怪兽，主管官员奏道：陛下祭祀虔诚，上帝作为回报，赐陛下独角之兽，这大概就是麒麟
	于是
夏，四月，赦天下	夏季，四月，大赦天下
丁卯，立皇子据为太子，年七岁	丁卯，汉武帝立皇子刘据为太子，时年七岁
五月，乙巳晦，日有食之	五月乙巳晦，，出现日食
初，张骞自月氏还，具为天子言西域诸国风俗：大宛在汉正西，	当初，张骞从月
冬，十月，上幸雍，祠五	冬季，十月，汉武帝巡幸至雍，祭祀于五
三月，戊寅，平津献侯公孙弘薨	三月戊寅，丞相、平津侯公孙弘去世
壬辰，以御史大夫乐安侯李蔡为丞相，廷尉张汤为御史大夫	壬辰，汉武帝任命御史大夫、乐安侯李蔡为丞相，廷尉张汤为御史大夫
胶东康王寄薨	胶东王刘寄去世
春，有星孛于东方	春季，东方出现异星
夏，五月，赦天下	夏季，五有大赦天下
秋，匈奴入右北平、定襄，各数万骑，杀略知余人	秋季，匈奴分别以数万骑兵侵入右北平和定襄地区，屠杀，掳惊一千余人
春，有星孛于东北	春季，在东北天空出现异星
夏，有长星出于西北	夏季，在西北天空出现彗星
是岁，汲黯坐法免，以定襄太守义纵为右内史，河内太守王温舒为中尉	该年，汲黯因触犯法律被免职，汉武帝任命定襄太守义纵为右内史，河内太守王温舒为中尉
春，三月，甲午，丞相李蔡坐盗孝景园地，葬其中，当下吏，自杀	春季，三月甲午，丞相李蔡被指控盗用汉景帝陵园外空地埋葬家人，其罪该当交付司法官吏审判，李蔡自杀
罢三铢钱，更铸五铢钱	废止三铢钱，改铸五铢钱
于是民多盗铸钱，楚地尤甚	因此很多百姓私自铸钱，以楚地最为严重
诏徙奸猾吏民于边	汉武帝颁布诏书，命将奸猾不法的官吏和百姓放逐到边疆地区
夏，四月，乙卯，以太子少傅武强侯庄青翟为丞相	夏季，四月乙卯，汉武帝任命太子少傅武强侯庄青翟为丞相
冬，十月，雨水，无冰	冬季，十月，降雨，水未结冰
上既下缗钱令而尊卜式，百姓终莫分财佐县官，于是杨可告缗钱纵矣	汉武帝颁布了缗钱令后，又尊崇卜式，但老百姓却始终不肯拿出自己的财产帮助国家，于是由杨可主持，对隐瞒财产者进行的告发和惩处大规模地进行
义纵以为此乱民，部吏捕其为可使者	义纵认为此举骚扰了百姓，命官吏逮捕杨可派出的人员
天子以纵为废格沮事，弃纵市	汉武帝以义纵抗拒圣旨、阻挠告密之事，将其处死
郎中令李敢，怨大将军之恨其父，乃击伤大将军，大将军匿讳之	郎中令李敢怨恨大将军卫青使其父李广抱恨而死，将卫青打伤，但卫青却将此事隐瞒起来
居无何，敢从上雍，至甘泉宫猎，票骑将军去病射杀敢	不久，李敢随汉武帝到雍地甘泉宫狩猎，被票骑将军霍去病用箭射死
去病时方贵幸，上为讳，云鹿触杀之	霍去病当时正受宠信，声势显赫，汉武帝为其隐瞒真相，宣称李敢是被鹿撞死的
夏，四月，乙巳，庙立皇子闳为齐王，旦为燕王，胥为广陵王，初作诰策	夏季，四月乙巳，汉武帝在太庙册封皇子刘闳为齐王，刘旦为燕王，刘胥为广陵王，从此开始用颁布诰策的形式册封诸王
自造白金、五铢钱后，吏民之坐盗铸金钱死者数十万人，其不发觉者不可胜计，天下大抵无虑皆铸金钱矣	自从铸造白金币、五铢钱之后，官吏和百姓因私铸钱币而被处死的有数十万人，至于那些尚未发觉的更是多得无法计算，天下人几乎都在私铸钱币
犯者众，吏不能尽诛	由于犯此法的人太多了，官府不可能将他们全部诛杀
六月，诏遣博士褚大、徐偃等六人分循郡国，举兼并之徒及守、相、为吏有罪者	六月，汉武帝下诏书派遣博士褚大、徐偃等六人分别到全国各郡和诸侯国视察，举劾各地并吞贫民耕地之人和违法犯罪的郡守、诸侯国丞相及其他地方官吏
秋，九月，冠军景桓侯霍去病薨	秋季，九月，冠军景桓侯霍去病去世
天子甚悼之，为冢，像祁连山	汉武帝非常悲痛，为他仿照祁连山形状修了一座坟墓
是岁，大农令颜异诛	这一年，大农令颜异被处死
夏，五月，赦天下	夏季，五月，大赦天下
济东王彭离骄悍，昏暮，与其奴、亡命少年数十人行剽杀人，取财物以为好，所杀发觉者百余人，坐废，徙上庸	济东王刘彭离骄横凶悍，常在黄昏时率领家奴和亡命少年数十人抢劫杀人，夺取财物，并以此为嗜好，被他杀害的人，已发现的就有一百多个，因此他被废除王爵、封国，贬逐到上庸
	二年
冬，十一月，张汤有罪自杀	冬季，十一月，张汤因有罪而自杀
春，起柏梁台	春季，汉武帝修筑柏梁台，在台上造了一个承露盘，高二十丈，大小要七人合抱，用铜制成
作承露盘，高二十丈，大七围，以铜为之；上有仙人掌，以承露，和玉屑饮之，云可以长生	上面装有神仙手掌，用来承接露水，再拌上玉的粉末喝下去，据说可以长生不老
宫室之修，自此日盛	从此，宫室的修建，一天比一天兴盛
二月，以太子太傅赵周为丞相	二月，汉武帝任命太子太傅赵周为丞相
三月，辛亥，以太子太傅石庆为御史大夫	三月辛亥，汉武帝任命太子太傅石庆为御史大夫
大雨雪	天降大雪
夏，大水，关东饿死者以千数	夏季，大水成灾，关东地区饿死的人数以千计
是岁，孔仅为大农令，而桑弘羊为大农中丞，稍置均输，以通货物	这一年，孔仅作了大农令，桑弘羊作了大农中丞，逐渐在郡、国设置均输官，负责调节各地物资，互通有无
浑邪王既降汉，汉兵击逐匈奴于幕北，自盐泽以东空无匈奴，西域道可通	浑邪五归降汉朝以后，汉军将匈奴势力驱逐到大沙漠以北，自盐泽以东，不见匈奴踪迹，前往西域的道路可以通行
于是张骞建言：乌孙王昆莫本为匈奴臣，后兵稍强，不肯复朝事匈奴，匈奴攻不胜而远之	于是张骞建议说：乌孙王昆莫本来是匈奴的藩属，后来兵力渐强，不肯再事奉匈奴，匈奴派兵征服，未能取胜，于是远去
今单于新困于汉，而故浑邪地空无人，蛮夷俗恋故地，又贪汉财物，今诚以此时厚币赂乌孙，招以益东，居故浑邪之地，与汉结昆弟，其势宜听，听则是断匈奴右臂也	如今匈奴单于刚刚受到我朝的沉重打击，而过去的浑邪王辖地又空旷无人，蛮夷之族的习俗依恋故地，又贪图我朝的财物，如果现在我们用丰厚的礼物拉拢乌孙，招他们东迁，到过去的浑邪王辖地居住，与我朝结为兄弟之国，他们势将听从我朝的调遣，听从了就等于断了匈奴的右臂一般
既连乌孙，自其西大夏之属皆可招来而为外臣	与乌孙结盟之后，其西面的大夏等国也都能招来成为我朝的藩属
天子以为然，拜骞为中郎将，将三百人，马各二匹，牛羊以万数，赍金币帛直数千巨万；多持节副使，道可便，遣之他旁国	汉武帝认为有理，便任命张骞为中郎将，率领三百人，每人马二匹，以及数以万计的牛羊和价值数千万钱的黄金缯帛，又任命多人为手持天子符节的副使，沿途如有通往别国的道路，既派一副使前往
冬，徙函谷关于新安	冬季，把函谷关迁到新安
春，正月，戊子，阳陵园火	春季，正月戊子，汉景帝陵园失火
夏，四月，雨雹	夏季，四月，天降冰雹
关东郡、国十余饥，人相食	关东地区十几个郡和封国严重饥馑，出现人吃人的惨景
是岁，匈奴伊稚斜单于死，子乌维单于立	该年，匈奴单于伊稚斜去世，其子乌维即单于位
	四年
春，二月，中山靖王胜薨	春季，二月，中山王刘胜去世
秋，立常山宪王子商为泗水王	秋季，汉武帝封常山宪王的儿子刘商为泗水王
初，南越文王遣其子婴齐入宿卫，在长安取邯郸氏女，生子兴	当初，南越王赵胡派其子赵婴齐入宫为汉武帝充当侍卫，婴齐在长安娶邯郸女子氏为妻，生一子，取名赵兴
文王薨，婴齐立，乃藏其先武帝玺，上书请立氏女为后，兴为嗣	赵胡死后，赵婴齐断承王位，隐藏其先祖南越武帝赵佗的印玺，上书朝廷，请求立氏女为王后，赵兴为世子
汉数使使者风谕婴齐入朝	朝廷多次派遣使臣，提醒赵婴齐入京朝觐
婴齐尚乐擅杀生自恣，惧入见要，用汉法比内诸侯，固称病，遂不入见	赵婴齐愿自操生杀予夺大权，随心所欲，害怕一旦入朝，朝廷会用法令像约束内地诸侯一样约束他，所以坚决称病，没有到长安朝见
婴齐薨，谥曰明王	赵婴齐死后，谥号称明王
太子兴代立，其母为太后	太子赵兴即王位，其母氏为王太后
上行幸雍，且郊，或曰：五帝，泰一之佐也	汉武帝巡幸至雍，将要举行祭天仪式，有人建议说：五帝为泰一神的助手，应建泰一庙，由皇上亲自祭祀
宜立泰一，而上亲郊	汉武帝迟疑未决
上疑未定	齐国人公孙卿说道：今年得到宝鼎，冬季十一月初一清晨为冬至，与黄帝时一样
齐人公孙卿曰：今年得宝鼎，其冬辛巳朔旦冬至，与黄帝时等	公孙卿有简牍，上面说：黄帝得到宝鼎，该年十一月初一清晨为冬至，总共过了三百八十年，黄帝成仙升天
卿有札书曰：黄帝得宝鼎，是岁己酉朔旦冬至，凡三百八十年，黄帝仙登于天	公孙卿将简牍上的话通过汉武帝宠幸的人奏上，汉武帝非常高兴，召公孙卿前来询问，公孙卿回答说：此书是申公给我的，申公说：汉朝兴盛还会与黄帝时一样，汉朝的圣人，是高祖皇帝的孙子至曾孙
因嬖人奏之	宝鼎的出现，正好与神意相通，黄帝在祭祀神灵的明庭迎接万种神灵，明庭就是甘泉宫
上大悦，召问，卿对曰：受此书申公，申公曰：汉兴复当黄帝之时，汉之圣者在高祖之孙且曾孙也	黄帝在首山开采铜矿，在荆山下铸造宝鼎
宝鼎出而与神通，黄帝接万灵明庭，明庭者甘泉也	宝鼎铸成之后，天上有一条龙将龙须垂下来接引黄帝，于是，黄帝骑上龙背，和群臣及后宫妃嫔七十余人一起登天成了神仙
黄帝采首山铜，铸鼎于荆山下，鼎既成，有龙垂胡髯下迎黄帝，黄帝上骑龙，与群臣后宫七十余人俱登天	于是汉武帝说：唉
于是天子曰：嗟乎	要真的能跟黄帝一样，我看待离开妻子儿女，就象抛弃拖鞋罢了
诚得如黄帝，吾视去妻子如脱屣耳	于是任命公孙卿为郎官，派他到东方，在太室山等候天神降临
	五年
夏，四月，赦天子	夏季，四月，大赦天下
丁丑晦，日有食之	丁丑晦，出现日食
丙申，以御史大夫石庆为丞相，封牧丘侯	丙申，汉武帝任命御史大夫石庆为丞相，封牧丘侯
时国家多事，桑弘羊等致利，王温舒之属峻法，而宽等推文学，皆为九卿，更进用事；事不关决于丞相，丞相庆醇谨而已	当时，国家多事，桑弘羊等人谋取财利，王温舒等人推行严刑峻法，而宽等人则大力推崇儒家经典，他们都位列九卿，相继掌握朝政大权，国家大事不向丞相汇报，也不由丞相决定，丞相石庆只是敦厚、谨慎而已
西羌众十万人反，与匈奴通使，攻故安，围罕	西羌部族十万人反叛朝廷，与匈奴互通使者，进攻故安，包围罕
匈奴入五原，杀太守	匈奴侵入五原，杀死五原太守
	六年
冬，发卒十万人，遣将军李息、郎中令徐自为征西羌，平之	冬季，发兵十万人，派将军李息、郎中令徐自为征讨西羌，平定了西羌部族的叛乱
公孙卿侯神河南，言见仙人迹缑氏城上	公孙卿在河南等候神仙降临，声称在缑氏城上看到了神仙脚印
春，天子亲幸缑氏城视迹，问卿：得毋效文成、五利乎	春季，汉武帝亲自来到缑氏城观看神仙脚印，问公孙卿说：你不是想效法少翁、栾大吧
卿曰：仙者非有求人主，人主者求之；其道非宽假，神不来	公孙卿说：神仙无求于人间君主，而人间君主有求于他，如果求神之道不宽裕，神仙就不会来
言神事如迂诞，积以岁月，乃可致也	说到神仙之事，似乎很遥远荒诞，但积够了岁月，神仙就可请到
上信之	汉武帝相信了他的话
于是郡、国各除道，缮治宫观、名山、神祠以望幸焉	于是，各郡、国都扩建道路，修缮宫观和名山的神祠，希望有神仙驾临
赛南越，祠泰一、后土，始用乐舞	为感谢神仙保佑征服南越，祭祀泰一神和后土神，并开始使用以音乐伴奏的舞蹈
驰义侯发南夷兵，欲以击南越	驰义侯征调南夷各部族的军队，想让他们去征讨南越国时，且兰族首领害怕率军远离后相邻部族会乘机掳掠本族的老弱，于是率领部众背叛汉朝，杀死汉朝使臣和犍为太守
且兰君恐远行旁国虏其老弱，乃与其众反，杀使者及犍为太守	汉潮便征调应去攻打南越的由巴、蜀罪犯组成的八校尉部队，派中郎将郭昌、卫广率领他们攻击南越，诛杀且兰及邛都、都等部族首领，平定了南夷叛乱，并设置柯郡
汉乃发巴、蜀罪人当击南越者八校尉，遣中郎将郭昌、卫广将而击之，诛且兰及邛君、侯，遂平南夷为柯郡	夜郎国原本依赖南越国，南越国灭亡后，夜郎国君便到长安朝见，汉武帝封夜郎国君为夜郎王
夜郎侯始倚南越，南越已灭，夜郎遂入朝，上以为夜郎王	冉等部族都非常害怕，纷纷请求臣属于汉朝，由朝廷设官管理
冉皆振恐，请臣置吏，乃以邛都为越郡，都为沈黎郡，冉为汶山郡，广汉西白马为武都郡	于是，汉朝在邛都设越郡，在都设沈黎郡，在冉设汶山郡，在广汉西部的白马设武都郡
是岁，齐相卜式为御史大夫	该年，齐相卜式升任御史大夫
式既在位，乃言郡、国多不便县官作盐铁器，苦恶价贵，或强令民买之；而船有算，商者少，物贵	卜式到任后，言道：各郡、国对盐铁由官府专营多感不便，官府专营的盐铁产品质次价高，有时还强迫百姓购买，船只也要交纳算赋，所以经商的人少，物价昂贵
上由是不悦卜式	汉武帝因此不再喜欢卜式
上以卜式不习文章，贬秩为太子太傅，以宽代为御史大夫	汉武帝因卜式不善文辞，将其降为太子太傅，命宽代替卜式作御史大夫
汉兵入东越境，东越素发兵距险，使徇北将军守武林	汉军进入东越国境，东越王早已派兵占据了险要地带，并命徇北将军镇守武林
楼船将军卒钱塘辕终古斩徇北将军	杨仆部下士兵钱塘人辕终古将徇北将军斩杀
故越衍侯吴阳以其邑七百人反攻越军于汉阳	原东越衍侯吴阳率当地武装七百人背叛东越王，在汉阳进攻东越军队
越建成侯敖与繇王居股杀馀善，以其众降	名叫敖的东越建成侯与繇王骆居股杀死东越王骆馀善，率众归降
上封终古为御侯，阳为卯石侯，居股为东成侯，敖为开陵侯；又封横海将军说为按道侯，横海校尉福为缭侯，东越降将多军为无锡侯	汉武帝封辕终古为御侯，吴阳为卯石侯，骆居股为东成侯，敖为开陵侯；又封横海将军韩说为按道侯，横海校尉福为缭侯，东越降将多军为无锡侯
上以闽地险阻，数反覆，终为后世患，乃诏诸将悉其民徙于江、淮之间，遂虚其地	汉武帝因闽越地区地势险恶，其人反覆无常，多次与汉朝为敌，终究是后世祸患，于是诏命各路将领将当地人全部迁到长江、淮河一带，于是闽越地区成为荒无人烟的地方
春，正月，上行幸缑氏，礼祭中岳太室，从官在山下闻若有言万岁者三	春季，正月，汉武帝出巡至缑氏城，祭祀于中岳太室，随从官员在山下似乎听到有声音连呼三次万岁
诏祠官加增太室祠，禁无伐其草木，以山下户三百为之奉邑	汉武帝命令主管祭祀的官员扩建太室祭祠，禁止砍伐山上草木，又将山下三百户百姓作为供奉太室的奉邑
齐怀王闳薨，无子，国除	齐王刘闳去世，因没有儿子，封国被撤销
冬，十月，上行幸雍，祠五；还，祝祠泰一，以拜德星	冬季，十月，汉武帝巡幸至雍，祭祀于五；回长安后，祭祀泰一神，并叩拜德星
春，正月，公孙卿言：见神人东莱山，若云欲见天子	春季，正月，公孙卿报告说：在东莱山看到神仙，他好像说要见天子
天子于是幸缑氏城，拜卿为中大夫，遂至东莱，宿留之，数日，无所见，见大人迹云	于是汉武帝前往缑氏城，封公孙卿为中大夫，到东莱住了几天，却未见到神仙，只看到了巨人的足迹
复遣方士求神怪，采芝药，以千数	汉武帝又派出数以千计的方士去寻访神，采摘灵芝
时岁旱，天子既出无名，乃祷万里沙	当时正逢旱灾，汉武帝外出巡游没有理由，便去祭祀万里沙神庙
夏，四月，还，过祠泰山	夏季，四月，返回长安，中途祭祀泰山
上还长安	汉武帝回到长安
初令越巫祠上帝、百鬼，而用鸡卜	汉武帝开始命令越族巫师祭祀上帝和众鬼，并使用鸡骨进行占卜
上以旱为忧，公孙卿曰：黄帝时，封则天旱，乾封三年	汉武帝因为旱灾而忧虑，公孙卿说：黄帝时，封祀后便出现大旱，使封土干了三年
上乃下诏曰：天旱，意乾封乎	汉武帝于是颁布诏书说：天旱，意旨是要使封土干吧
秋，作明堂于汶上	秋季，在汶水边兴建明堂
上募天下死罪为兵，遣楼船将军杨仆从齐浮渤海，左将军荀彘出辽东，以讨朝鲜	汉武帝下令招募天下犯有死罪的人当兵，由楼船将军杨仆率领，从齐国渡渤海，左将军荀彘从辽东出发，征讨朝鲜
冬，十二月，雷；雨雹，大如马头	冬季，十二月，打雷；天降冰雹，像马头一般大小
上遣将军赵破奴击车师	汉武帝派将军赵破奴攻击西域车师国
破奴与轻骑七百余先至，虏楼兰王，遂破车师，因举兵威以困乌孙、大宛之属	赵破奴率轻骑兵七百余名先到西域，生擒楼兰王，然后大破车师国，并乘机以兵威困迫乌孙、大宛等国
春、正月、甲申、封破奴为浞野侯	春季，正月甲申，汉武帝封赵破奴为浞野侯
王恢佐破奴击楼兰，封恢为浩侯	王恢因辅佐赵破奴攻袭楼兰国，被封为浩侯
于是酒泉列亭障至玉门矣	于是从酒泉到玉门都有了汉朝设立的边防要塞
初作角戏、鱼龙曼延之属	角、鱼龙、曼延之类的杂技游戏开始兴起
汉兵入朝鲜境，朝鲜王右渠发兵距险	汉军进入朝鲜境内，朝鲜王卫右渠派兵占据险要之地进行抵抗
楼船将军将齐兵七千人先至王险	楼船将军杨仆率领齐国军队七千人先行抵达王险
右渠城守，窥知楼船军少，即出城击楼船；楼船军败散，遁山中十余日，稍求退散卒，复聚	卫右渠据城坚守，探知杨仆兵力单薄，便出城袭击杨仆
左将军击朝鲜水西军，未能破	杨仆军兵败溃散，逃入山中十几天，后逐渐找回溃散的兵卒，重新聚集起来
天子为两将未有利，乃使卫山因兵威往谕右渠	左将军荀彘率部攻击朝鲜水西面的军队，未能攻破
右渠见使者，顿首谢：愿降，恐两将诈杀臣；今见信节，请复降	汉武帝因为两位将军未能取胜，便派卫山前往朝鲜，用军事压力劝谕卫右渠归顺
遣太子入谢，献马五千匹，及馈军粮；人众万余，持兵方渡水	卫右渠会见卫山，叩头道歉，说道：我愿意归降，但害怕两位将军用诈术杀我；如今见到天子信节，所以请求再次归降
使者及左将军疑其为变，谓太子：已服降，宜令人毋持兵	卫右渠派太子前往汉朝谢罪，并献马五千匹，又为汉军提供军粮
太子亦疑使者、左将军诈杀之，遂不渡水，复引归	朝鲜太子率众一万余人，手持武器，将要渡过水，卫山和荀彘疑心要生出变故，便对太子说：既然已经归降，应命你手下人不要携带兵器
山还报天子	太子也怕卫山和荀彘用计杀他，于是不肯渡水，带人返回
天子诛山	卫山回京报告汉武帝，汉武帝将卫山诛杀
秋，七月，胶西于王端薨	秋季，七月，胶西王刘端去世
武都氐反，分徙酒泉	武都郡氐族叛乱，汉朝将他们分批迁往酒泉
	四年，(甲戍，前107)
冬，十月，上行幸雍，祠五	冬季，十月，汉武帝巡游至雍，祭祀于五
通回中道，遂北出萧关，历独鹿、鸣泽，自代而还，幸河东	回中的道路已然打通，于是汉武帝北出萧关，经独鹿山、鸣泽湖，到代地返回、途中巡察了河东郡
春，三月，祠后土，赦汾阴、夏阳、中都死罪以下	春季，三月，汉武帝祭祀后土神，下令赦免汾阴、夏阳、中都地区死刑以下囚犯
夏、大旱	夏季，大旱
长平列侯卫青薨	长平侯卫青去世
起冢，象庐山	汉武帝为他修建了一座像匈奴国中的庐山一样形状的坟墓
上既攘却胡、越，开地斥境，乃置交趾、朔方之州，及冀、幽、并、兖、徐、青、扬、荆、豫、益、凉等州，凡十三部，皆置刺史焉	汉武帝已经驱逐了北方的匈奴，消灭了南方的越族政权，开疆拓土，于是设置交趾、朔方二州，以及冀州、幽州、并州、兖州、徐州、青州、扬州、荆州、豫州、益州、凉州，共将全国划分为十三州，全都设刺史
上以名臣文武欲尽，乃下诏曰：盖有非常之功，必待非常之人	汉武帝因朝中有名的文武大臣快要没有了，所以颁布诏书，求取贤才：凡是非同寻常的功业，必须等待非同寻常的人才去完成
故马或奔而致千里，士或有负俗之累而立功名	所以有的马虽然凶暴不驯，却能一口气奔驰千里；有的士人虽然遭到世俗的诟骂，却能建功立业
夫泛驾之马，弛之士，亦在御之而已	无论是容易翻车之马，还是放荡不羁之士，都只看如何驾御而已
其令州、郡察吏、民有茂才、异等可为将、相及使绝国者	命令各州、郡官长考察本地官吏和一般百姓中，是否有才干优秀或不同凡俗，能够胜任将相之职，或出使遥远国家的人，保荐给朝廷
冬，上行幸回中	冬季，汉武帝巡游回中地区
春，作首山宫	春季，兴建首山宫
三月，行幸河东，祠后土，赦汾阴殊死以下	三月，汉武帝巡游河东地区，祭祀后土神，赦免汾阴地区死罪以下囚犯
汉既通西南夷，开五郡，欲地接以前通大夏，岁遣使十余辈出此初郡，皆闭昆明，为所杀，夺币物	汉朝打通西南夷之后，增设五郡，希望在这一带找出一条通往大夏国的道路，每年都要派出十几批使者，从这些新郡出发，但都被困在昆明，使者被杀，财物被抢
于是天子赦京师亡命，令从军，遣拔胡将军郭昌将以击之，斩首数十万	于是汉武帝赦免京师的死罪之徒，命他们从军，派拔胡将军郭昌率领前往昆明地区进行征讨，共斩杀数十万人
后复遣使，竟不得通	可是以后再派出使者，到底还是不能通过此地
秋，大旱，蝗	秋季，大旱，并发生蝗灾
乙酉，柏梁台灾	乙酉(二十二日)，柏梁台遭火灾
十二月，甲午朔，上亲禅高里，祠后土，临渤海，将以望祀蓬莱之属，冀至殊廷焉	十二月甲午朔(初一)，汉武帝在高里山亲自祭祀地神，又祭后土神，然后来到渤海边，准备遥祭蓬莱等仙山，希望能亲身到达神仙所在的仙庭
春，上还，以柏梁灾，故朝诸侯、受计于甘泉	春季，汉武帝回返长安，因柏梁台失火，所以在甘泉宫接受各诸侯王的朝拜和各郡、国载录户口，赋税的簿册
甘泉作诸侯邸	在甘泉修建诸侯王宫邸
大中大夫公孙卿、壶遂、太史令司马迁等言：历纪坏废，宜改正朔	大中大夫公孙卿、壶遂、太史令司马迁等上奏说：历法、纪年都已坏废，应当改正朔
上诏宽与博士赐等共议，以为宜用夏正	汉武帝命宽与名叫赐的博士等共同商议，认为应使用夏胡历法
夏，五月，诏卿、遂、迁等共造汉《太初历》，以正月为岁首，色上黄，数用五，定官名，协音律，定宗庙百官之仪，以为典常，垂之后世云	夏季，五月，汉武帝下诏，命公孙卿、壶遂、司马迁等共同制定汉朝《太初历》，以正月为一年的开始，崇尚黄颜色，以五为吉祥数字，重新定官名，协调音律，制定宗庙、百官的仪礼，作为国家常规，流传后世
匈奴儿单于好杀伐，国人不安；又有天灾，畜多死	匈奴儿单于性好杀戮，使国中百姓不安，又发生天灾，很多牲畜死亡
左大都尉使人间告汉曰：我欲杀单于降汉，汉远，即兵来迎我，我即发	匈奴左大都尉派人偷偷对汉朝说：我打算杀死单于，归降汉朝，但汉朝路远，如能派兵来接应，我马上就可以发动
上乃遣因将军公孙敖筑塞外受降城以应之	于是汉武帝派因将军公孙敖在塞外修建受降城，驻兵接应
秋，八月，上行幸安定	秋季，八月，汉武帝巡游安定郡
中尉王温舒坐为奸利，罪当族，自杀；时两弟及两婚家亦各自坐他罪而族	中尉王温舒被指控犯有奸诈贪利之罪，应当灭族，王温舒自杀；当时，王温舒的两个弟弟和两个亲家也分别因其他罪名被灭族
光禄勋徐自为曰：悲夫	光禄勋徐自为说：可悲哪
古有三族，而王温舒罪至同时而五族乎	古时候有灭三族的，而今王温舒的罪到了同时灭五族的地步
关东蝗大起，飞西至敦煌	关东地区发生严重蝗灾，大批蝗虫向西飞去，到达敦煌
	二年(戊寅、前103)
春，正月，戊申，牧丘恬侯石庆薨	春季，正月戊申(疑误)，牧丘侯石庆去世
三月，上行幸河东，祠后土	三月，汉武帝巡游河东郡，祭祀后土神
夏，五月，籍吏民马补车骑马	夏季，五月，登记征用官吏和百姓的马匹，补充军马
秋，蝗	秋季，发生蝗灾
贰师将军之西也，既过盐水，当道小国各城守，不肯给食，攻之不能下；下者得食，不下者数日则去	贰师将军李广利率兵西征，过盐泽之后，沿途小国都据城自守，不肯供应汉军粮食，攻又攻不下；攻下之后，粮食自可得到补充；如不能攻破，数日后便离去
比至郁成，士至者不过数千，皆饥罢	等到达郁成时，全军只剩下数千人，且全都饥饿疲惫
攻郁成，郁成大破之，所杀伤甚众	进攻郁成，反被镇守郁成的军队打得大败，伤亡惨重
贰师将军与李哆、赵始成等计：至郁成尚不能举，况至其王都乎	李广利与李哆、赵始成等商议道：到郁成尚且不能攻破，更何况到大宛的国都呢
引兵而还	于是领兵返回
至敦煌，士不过什一二	到敦煌时，士兵只剩下出征时的十分之一二
使使上书言：道远乏食，且士卒不患战而患饥，人少，不足以拔宛，愿且罢兵，益发而复往	李广利派人上奏汉武帝：道路遥远，粮食缺乏，将士们虽不惧战斗，但饥饿难忍；况且人数太少，不足以攻下大宛，希望能暂且罢兵，待证调更多的军队后再前往征讨
天子闻子，大怒，使使遮玉门曰：军有敢入者辄斩之	汉武帝闻奏大怒，派使臣至玉门阻拦，同时下令：军队有胆敢退入玉门关的，一律斩首
贰师恐，因留敦煌	李广利大为惶恐，因而留在敦煌
冬，十二月，宽卒	十二月，宽去世
	三年(己卯、前102)
春，正月，胶东太守延广为御史大夫	春季，正月，胶东太守延广被任命为御史大夫
匈奴儿单于死，子年少，匈奴立其季父右贤王犁湖为单于	匈奴儿单于去世，因其子年纪小，匈奴部众共立儿单于的叔父右贤王湖为单于
上遣光禄勋徐自为出五原塞数百里，远者千余里，筑城、障、列亭，西北至庐朐，而使游击将军韩说、长平侯卫伉屯其旁；使强弩都尉路博德筑居延泽上	汉武帝派光禄勋徐自为从五原出塞数百里，最远处达千余里，修筑城墙、要塞、亭燧等，向西北直到庐朐，命游击将军韩说、长平侯卫伉屯兵庐朐附近；命强弩都尉路博德在居延泽筑城镇守
秋，匈奴大入定襄、云中，杀略数千人，败数二千石而去，行破坏光禄所筑城、列亭、障；又使右贤王入酒泉、张掖，略数千人	秋季，匈奴大举侵入定襄、云中二郡，杀掠数千人，打败汉朝好几名二千石官后方才离去，沿途破坏光禄勋徐自为所筑城墙、要塞、亭遂等；又派右贤王侵入酒泉、张掖二郡，掳掠数千人
会军正任文击救，尽复失所得而去	正好汉军军正任文率兵前来救援，右贤王兵败，丧失了全部掳掠所得后退走
是岁，睢阳侯张昌坐为太常乏祠，国除	这一年，睢阳侯张昌被指控身为太常官，掌管祭祀事务有不到之处，被废除封爵食邑
秋，起明光宫	秋季，汉武帝兴建明光宫
冬，上行幸回中	冬季，汉武帝巡游回中地区
上嘉匈奴单于之义，遣中郎将苏武送匈奴使留在汉者，因厚赂单于，答其善意	汉武帝嘉许匈奴单于的义举，派中郎将苏武将留在汉朝的匈奴使臣送回匈奴，顺便携带厚礼，答谢匈奴单于的好意
武与副中郎将张胜及假吏常惠等俱，既至匈奴，置币遗单于	苏武与副使中郎将张胜及暂时充任使团官吏的常惠等一同前往，到达匈奴后，将礼品送给单于
单于益骄，非汉所望也	单于却更加骄横，不是汉朝原来所希望的样子
天雨白牦	天空降下硬而弯曲的白毛
夏，大旱	夏季，大旱
五月，赦天下	五月，大赦天下
发谪戍屯五原	征发贬谪有罪的人到五原郡屯垦戍边
浞野侯赵破奴自匈奴亡归	浞野侯赵破奴从匈奴逃回汉朝
是岁，济南太守王卿为御史大夫	这一年，济南太守王卿被任命为御史大夫
	二年(壬午、前99)
春，上行幸东海	春季，汉武帝巡游东海郡
还幸回中	在回京途中巡游回中
春，二月，王卿有罪自杀，以执金吾杜周为御史大夫	春季，二月，王卿因罪自杀，汉武帝任命执金吾杜周为御史大夫
初榷酒酤	开始实行酒类专卖
三月，上行幸泰山，修封，祀明堂，因受计	三月，汉武帝巡游泰山，扩建祭天神坛，祭祀于明堂，并在此接受各郡、国的户籍、财政簿册
还，祠常山，玄玉	回京途中，祭祀于常山，并将黑色玉石埋于祭坛之下
方士之候祠神人、入海求蓬莱者终无有验，而公孙卿犹以大人迹为解，天子益怠厌方士之怪迂语矣；然犹羁縻不绝，冀遇其真	方士们在各地等候神仙降临和入海寻找蓬莱山等始终没有结果，而公孙卿仍以所谓巨人的足印进行辩解，从而使汉武帝对方士们的奇谈怪论日益厌倦，但仍与他们保持联系，并不禁绝，希望能遇到真有本领的人
自此之后，方士言神祠者弥众，然其效可睹矣	从此以后，方士们谈论神灵之事的虽更加众多，但其效果是可想而知了
夏，四月，大旱	夏季，四月，大旱
赦天下	大赦天下
秋，匈奴入雁门	秋季，匈奴侵入雁门
太守坐畏弃市	雁门太守因畏缩惧敌被朝廷处死
	四年(甲申、前97)
春，正月，朝诸侯王于甘泉宫	春季，正月，汉武帝在甘泉宫接受各诸侯王的朝见
发天下七科谪及勇敢士，遣贰师将军李广利将骑六万、步兵七万出朔方；强弩都尉路博德将万余人与贰师会；游击将军韩说将步兵三万人出五原；因杆将军公孙敖将骑万、步兵三万人出雁门	汉武帝征发全国贱民七科谪和勇敢之士，派贰师将军李广利率骑兵六万、步兵七万自朔方出塞，强弩都尉路博德率一万余人与李广利会合，游击将军韩说率步兵三万自五原出塞，因杆将军公孙敖率骑兵一万、步兵三万自雁门出塞，袭击匈奴
匈奴闻之，悉远其累重于余吾水北；而单于以兵十万待水南，与贰师接战	匈奴听到这一消息后，将其家属、财物等全部迁徙到余吾水以北地区，然后由单于亲率十万大军在余吾水南岸迎战李广利率领的汉朝军队
贰师解而引归，与单于连斗十余日	李广利率兵与单于大军连续交战十余日，撤兵而还
游击无所得	韩说所部没有收获
因杆与左贤王战，不利，引归	公孙敖与匈奴左贤王作战失利，撤兵而回
夏，四月，立皇子为昌邑王	夏季，四月，汉武帝封皇子刘为昌邑王
	太始元年(乙酉、前96)
春，正月，公孙敖坐妻巫蛊要斩	春季，正月，公孙敖因其妻以巫蛊害人而被腰斩
徙郡国豪桀于茂陵	汉武帝强迫各郡、国的富豪和有权势的人迁居茂陵
夏，六月，赦天下	夏季，六月，大赦天下
春，正月，上行幸回中	春季，正月，汉武帝巡游回中
杜周卒，光禄大夫暴胜之为御史大夫	杜周去世，汉武帝任命光禄大夫暴胜之为御史大夫
秋，旱	秋季，干旱
春，正月，上行幸甘泉宫	春季，正月，汉武帝前往甘泉宫
二月，幸东海，获赤雁	二月，巡游东海郡，捉到一只赤色大雁
幸琅邪，礼日成山，登之罘，浮大海而还	又巡游琅邪郡，在成山拜日，并登上之罘山，然后乘船在海上巡游后返回长安
赵人江充为水衡都尉	赵国人江充被任命为水衡都尉
初，充为赵敬肃王客，得罪于太子丹，亡逃；诣阙告赵太子阴事，太子坐废	当初，江充本是赵敬肃王的门客，因为得罪了赵王太子刘丹，逃出赵国，来到朝廷告发了刘丹的隐私秘事，刘丹因此被废除赵国太子之位
上召允入见	汉武帝召江充入宫见面，见他仪表堂堂，身体魁梧，衣着轻暖而华丽，暗中称奇
充容貌魁岸，被服轻靡，上奇之；与语政事，大悦，由是有宠，拜为直指锈衣使者，使督察贵戚、近臣逾侈者	与他谈论一番政事后，汉武帝大为高兴，从此对江充宠信，封其为直指绣衣使者，让他督察皇亲国戚、天子近臣中的违背体制、奢侈不法行为
充举劾无所避，上以为忠直，所言皆中意	江充检举参劾，毫无避讳，汉武帝因此认为他忠正直率，所说的话都合汉武帝的心意
尝从上甘泉，逢太子家使乘车马行驰道中，充以属吏	江充曾随汉武帝前往甘泉宫，正遇上太子刘据派遣去甘泉宫问安的使者坐着马车皇帝专用的驰道上行走，江充便将其逮捕问罪
太子闻之，使人谢充曰：非爱车马，诚不欲令上闻之，以教敕亡素者；唯江君宽之	太子听说后，派人向江充求情说：我并非爱惜车马，实在是不愿让皇上知道后，认为我平时没有管教左右，希望江先生宽恕
充不听，遂白奏	江充并不理睬，径自上奏
上曰：人臣当如是矣	汉武帝说：作臣子的，就应当这样
大见信用，威震京师	对江充大加信任，从而使江充威镇京师
	四年(戊子、前93)
春，三月，上行幸泰山	春季，三月，汉武帝巡游泰山
壬午，祀高祖于明堂以配上帝，因受计	壬午，在明堂祭祀高祖刘邦，以之配祀上帝，并在此接受各郡、国记录户籍财政情况的簿册
癸未，祀孝景皇帝于明堂	癸未，在明堂祭祀景帝刘启
甲申，修封	甲申，扩建祭天神坛
丙戍，禅石闾	丙戌，在石闾祭祀地神
夏，四月，幸不其	夏季，四月，汉武帝巡游不其山
五月，还，幸建章宫，赦天下	五月返回长安，前往建章宫，下诏大赦天下
冬，十月，甲寅晦，日有食之	冬季，十月甲寅晦，出现日食
春，正月，上还，幸建章宫	春季，正月，汉武帝返回长安，前往建章宫
三月，赵敬肃王彭祖薨	三月，赵王刘彭祖去世
彭祖取江都易王所幸淖姬，生男，号淖子	刘彭祖娶的是江都易王刘非的宠姬淖姬，生了一个儿子，取名刘淖子
时淖姬兄为汉宦者，上召问：淖子何如	当时淖姬的哥哥在皇宫中当宦官，汉武帝便召他询问：淖子为人如何
对曰：为人多欲	淖姬的哥哥回答说：他为人欲望太多
上曰：多欲不宜君国子民	汉武帝说道：欲望太多的人不适合当国君管理百姓
问武始侯昌，曰：无咎无誉	又问武始侯刘昌的情况，淖姬的哥哥说：刘昌既无过错，也没有什么值得赞扬的地方
上曰：如是可矣	汉武帝说：这样就可以了
遣使者立昌为赵王	于是派使臣立刘昌为赵王
夏，大旱	夏季，大旱
上居建章宫，见一男子带剑入中龙华门，疑其异人，命收之	汉武帝住在建章宫，看到一个男子带剑进入中龙华门，怀疑是不寻常的人，便命人捕捉
男子捐剑走，逐之弗获	该男子弃剑逃跑，侍卫们追赶，未能擒获
上怒，斩门候	汉武帝大怒，将掌管宫门出入的门候处死
冬，十一月，以三辅骑士大搜上林，闭长安城门索；十一日乃解	冬季，十一月，汉武帝征调三辅地区的骑兵对上林苑进行大搜查，并下令关闭长安城门进行搜索，十一天后解除戒严
巫蛊始起	巫蛊事开始出现
春，正月，下贺狱，案验；父子死狱中，家族	春季，正月，公孙贺被逮捕下狱，经调查罪名属实，父子二人都死于狱中，并被灭族
以涿郡太守刘屈牦为丞相，封澎侯	汉武帝任命涿郡太守刘屈牦为丞相，封其为澎侯
屈牦，中山靖王子也	刘屈牦是中山靖王刘胜的儿子
夏，四月，大风，发屋折木	夏季，四月，狂风大作，房屋被掀起，树木被折断
闰月，诸邑公主、阳石公主及皇后弟子长平侯伉皆巫蛊诛	闰四月，诸邑公主、阳石公主及卫皇后之弟卫青的儿子长平侯卫伉，都因巫蛊案而被处死
上行幸甘泉	汉武帝巡游甘泉
初，上年二十九乃生戾太子	当初，汉武帝二十九岁时才有了戾太子，对他非常喜爱
甚爱之	刘据长大后，性格仁慈宽厚、温和谨慎，汉武帝嫌他不像自己那样精明强干；汉武帝平日宠爱的王夫人也生一子名叫刘闳，李姬生二子刘旦、刘胥，李夫人生一子刘
及长，性仁恕温谨，上嫌其材能少，不类己；而所幸王夫人生子闳，李姬生子旦、胥，李夫人生子，皇后、太子宠浸衰，常有不自安之意	皇后、太子因皇上对他们的宠爱逐渐减少，常常有不能自安的感觉
上觉之，谓大将军青曰：汉家庶事草创，加四夷侵陵中国，朕不变更制度，后世无法；不出师征伐，天下不安；为此者不得不劳民	汉武帝察觉后，对大将军卫青说：我朝有很多事都还处于草创阶段，再加上周围的外族对我国的侵扰不断，朕如不变更制度，后代就将失去准则依据；如不出师征伐，天下就不能安定，因此不能不使百姓们受些劳苦
若后世又如朕所为，是袭亡秦之迹也	但倘若后代也像朕这样去做，就等于重蹈了秦朝灭亡的覆辙
太子敦重好静，必能安天下，不使朕忧	太子性格稳重好静，肯定能安定天下，不会让朕忧虑
欲求守文之主，安有贤于太子者乎	要找一个能够以文治国的君主，还能有谁比太子更强呢
闻皇后与太子有不安之意，岂有之邪	听说皇后和太子有不安的感觉，难道真是如此吗
可以意晓之	你可以把朕的意思转告他们
大将军顿首谢	卫青叩头感谢
皇后闻之，脱簪请罪	皇后听说后，特意摘掉首饰向汉武帝请罪
太子每谏征伐四夷，上笑曰：吾当其劳，以逸遗汝，不亦可乎	每当太子劝阻征伐四方时，汉武帝就笑着说：由我来担当艰苦重任，而将安逸留给你，不也挺好吗
癸亥，地震	八月癸亥，发生地震
九月，商丘成为御史大夫	九月，商丘成出任御史大夫
立赵敬肃王小子偃为平干王	汉武帝立赵敬肃王刘彭祖的小儿子刘偃为平干王
匈奴入上谷、五原、杀掠吏民	匈奴侵入上谷、五原二郡，对当地的地方官和老百姓进行屠杀和劫掠
	三年(辛卯、前90)
春，正月，上行幸雍，至安定、北地	春季，正月，汉武帝巡游至雍，又到达安定、北地二郡
匈奴入五原、酒泉、杀两都尉	匈奴侵入五原、酒泉、杀死二郡都尉
三月，遣李广利将七万人出五原，商丘成将二万人出西河，马通将四万骑出酒泉，击匈奴	三月，汉武帝派李广利率兵七万从五原出塞，商丘成率兵二万从西河出塞，马通率骑兵四万从酒泉出塞，袭击匈奴
夏，五月，赦天下	夏季，五月，汉武帝下诏大赦天下
秋，蝗	秋季，发生蝗灾
二月，丁酉，雍县无云如雷者三，陨石二，黑如	二月丁酉，雍县上空没有乌云，却出现三声像打雷一样的声音，落下两颗陨石，色黑如漆
三月，上耕于钜定	三月，汉武帝到钜定县亲自耕田
还，幸泰山，修封	回京途中巡游泰山，扩建祭天神坛
庚寅，祀于明堂	庚寅，在明堂举行祭祀仪式
癸巳，禅石闾，见群臣，上乃言曰：朕即位以来，所以狂悖，使天下愁苦，不可追悔	癸巳，在石闾山祭祀地神，并接见群臣，汉武帝说道：朕自即位以来，干了很多狂妄悖谬之事，使天下人愁苦，朕后悔莫及
自今事有伤害百姓，糜费天下者，悉罢之	从今以后，凡是伤害百姓、浪费天下财力的事，一律废止
田千秋曰：方士言神仙者甚众，而无显功，臣请皆罢斥遣之	田千秋说：很多方士都在谈论神仙之事，却都没有什么明显的功效，我请求皇上将他们一律罢斥遣散
上曰：大鸿胪言是也	汉武帝说：大鸿胪说得对
于是悉罢诸方士候神人者	于是将等候神仙降临的方士们全部遣散
是后上每对群臣自叹：向时愚惑，为方士所欺	此后，汉武帝每每对群臣自叹说：我往日愚惑，受了方士的欺骗
天下岂有仙人，尽妖妄耳	天下怎会有神仙，全是胡说八道
节食服药，差可少病而已	节制饮食，服用药物，最多是可以少生些病而已
夏，六月，还，幸甘泉	夏季，六月，汉武帝返回，前往甘泉
丁巳，以大鸿胪田千秋为丞相，封富民侯	六月丁巳，汉武帝擢升大鸿胪田千秋为丞相，封为富民侯
千秋无他材能，又无伐阅功劳，特以一言寤意，数月取宰相，封侯，世未尝有也	田千秋没有其他的才干，又没有什么资历和功劳，只因一句话使汉武帝醒悟，就在数月之中登上丞相高位，晋封侯爵，这是世上从未有过的
然为人敦厚有智，居位自称，逾于前后数公	然而田千秋为人敦厚，又有智慧，身居相位颇为称职，超过他前后的几位丞相
秋，八月，辛酉晦，日有食之	秋季，八月辛酉晦，出现日食
春，正月，上行幸甘泉，郊泰；遂幸安定	春季，正月，汉武帝前往甘泉宫，在泰祭祀天神，然后巡游安定
昌邑哀王薨	昌邑哀王刘去世
二月，赦天下	二月，大赦天下
夏，六月，商丘成坐祝诅自杀	夏季，六月，商丘成因被指控诅咒皇帝而自杀
秋，七月，地震	秋季，七月，发生地震
春，正月，上朝诸侯王于甘泉宫	春季，正月，汉武帝在甘泉宫接受诸侯王的朝见
二月，行幸五柞宫	二月，前往县五柞宫
三月，甲辰，葬孝武皇帝于茂陵	三月甲辰，将汉武帝安葬于茂陵
夏，六月，赦天下	夏季，六月，大赦天下
秋，七月，有星孛于东方	秋季，七月，东方出现异星
济北王宽坐禽兽行自杀	济北王刘宽因被指控行为如同禽兽而自杀
夏，益州夷二十四邑、三万余人皆反	夏季，益州所属二十四个夷人村寨三万余人全部背叛汉朝
遣水衡都尉吕破胡募吏民及发犍为、蜀郡奔命往击，大破之	汉朝廷派水衡都尉吕破胡招募官吏和百姓从军，又征调犍为、蜀郡的武勇精壮之人前往征讨，大破叛军
秋，七月，赦天下	秋季，七月，大赦天下
大雨，至于十月，渭桥绝	天降大雨，一直持续到十月，渭桥被大水冲断
九月，丙子，敬侯金日薨	九月丙子，侯金日去世
初，武帝病，有遗诏，封金日为侯，上官桀为安阳侯，霍光为博陆侯；皆以前捕反者马何罗等功封	当初汉武帝病危时，曾留下遗诏，封金日为侯，上官桀为安阳侯，霍光为博陆侯，都是因为先前逮捕叛逆者马何罗等人之功而赐与封爵
日以帝少，不受封，光等亦不敢受	金日以新皇帝年纪幼小为理由，不肯接受封爵，霍光等也不敢接受
及日病困，光白封，日卧受印绶；一日薨	等到金日病重时，霍光才将武帝临终时封他们三人为侯的事报告汉昭帝，于是金日躺在病床上接受了侯的印信和绶带，一天后去世
日两子赏、建俱侍中，与帝略同年，共卧起	金日的两个儿子金赏、金建都担任侍中，与汉昭帝年龄差不多一般大小，起床、睡觉都在一起
赏为奉车，建驸马都尉	金赏的官职是奉车都尉，金建是驸马都尉
及赏嗣侯，佩两绶，上谓霍将军曰：金氏兄弟两人，不可使俱两绶邪	后来金赏继承了父亲金日的侯爵，佩戴两种绶带，汉昭帝便对霍光说道：金氏兄弟二人，不能让他们都佩戴两种绶带吗
对曰：赏自嗣父为侯耳	霍光回答说：只能由金赏一人继承他父亲的侯爵
上笑曰：侯不在我与将军乎	汉昭帝笑着说：封侯不是由我和将军决定吗
对曰：先帝之约，有功乃得封侯	霍光说：根据先皇的约定，对国家有功的人才能封侯
遂止	于是汉昭帝作罢
闰月，遣故廷尉王平等五人持节行郡国，举贤良，问民疾苦、冤、失职者	闰十月，汉昭帝派前任廷尉王平等五人携带皇帝符节巡视各郡、国，举荐贤良人士，察问民间疾苦、冤屈和地方官是否有失职行为
冬，无冰	冬季，气候温暖，不结冰
	二年
春，正月，封大将军光为博陆侯，左将军桀为安阳侯	春季，正月，汉昭帝封大将军霍光为博陆侯，左将军上官桀为安阳侯
或说霍光曰：将军不见诸吕之事乎	有人劝霍光说：将军没有看到当初吕氏家族覆亡的教训吗
处伊尹、周公之位，摄政擅权，而背宗室，不与共职，是以天下不信，卒至于灭亡	吕氏身处伊尹、周公的地位，主持朝政，专擅大权，却疏远皇族成员，不与他们共享朝权，因此失去了天下人的信任，最后终于灭亡
今将军当盛为位，帝春秋富，宜纳宗室，又多与大臣共事，反诸吕道	如今将军身居高位，皇上年幼，应当纳用皇族成员，并多与大臣共商政事，与吕氏家族的作法相反
如是，则可以免患	如果这样，便可以免除祸患
光然之，乃择宗室可用者，遂拜楚元王孙辟疆及宗室刘长乐皆为光禄大夫，辟疆守长乐卫尉	霍光认为有道理，便在皇室成员中选择可以担任官职的人才，任命楚元王之孙刘辟疆和皇室成员刘长乐都为光禄大夫，刘辟疆还兼任长乐宫卫尉
三月，遣使者振贷贫民无种、食者	三月，汉昭帝派使者向缺乏种子、口粮的贫苦农民发放赈贷
初，武帝征伐匈奴，深入穷追，二十余年，匈奴马畜孕重堕，罢极，苦之，常有欲和亲意，未能得	当初，汉武帝派兵征伐匈奴，深入腹地，穷追猛打，前后二十余年，使匈奴的马匹牲畜不能正常孕育繁殖，受到严重消耗，百姓贫苦疲惫到了极点，常常希望与汉朝恢复和亲关系，但却一直未能实现
狐鹿孤单于有异母弟为左大都尉，贤，国人乡之	匈奴狐鹿孤单于有一个同父异母的弟弟，担任匈奴左大都尉，很是贤明，民心归附于他
母阏氏恐单于不立子而立左大都尉也，乃私使杀之	单于的母亲怕单于不立儿子为继承人而传位给弟弟左大都尉，便私自派人将左大都尉杀死
左大都尉同母兄怨，遂不肯复会单于庭	此事引起左大都尉的同母哥哥的怨恨，从此不再去单于王庭
是岁，单于病且死，谓诸贵人：我子少，不能治国，立弟右谷蠡王	这一年，单于病重不起，临死前，对贵族们说：我的儿子年纪幼小，不能治理国家，我决定将单于之位传给弟弟右谷蠡王
及单于死，卫律等与颛渠阏氏谋，匿其丧，矫单于令，更立子左谷蠡王为壶衍单于	单于死后，卫律等人与单于的正室夫人颛渠阏氏密谋、隐瞒了单于去世的消息，并伪造单于命令，改立单于的儿子左谷蠡王为壶衍单于
左贤王、右谷蠡王怨望，率其众欲南归汉，恐不能自致，即胁卢屠王，欲与西降乌孙	左贤王、右谷蠡王心怀不满，打算率领部众向南归附汉朝，又怕自己的力量单薄，难以实现，于是胁迫卢屠王，打算与卢屠王一起向西归降乌孙
卢屠王告之单于，使人验问，右谷蠡王不服，反以其罪罪卢屠王，国人皆冤之	卢屠王将此事向壶衍单于告发，壶衍单于派人前去查问，右谷蠡王不肯承认，反将阴谋背叛之事推到卢屠王身上，匈奴人都认为卢屠王冤枉
于是二王去居其所，不复肯会龙城，匈奴始衰	于是左贤王和右谷蠡王离去，留居在自己的辖地，不肯再参与每年一次的龙城祭祀大典，匈奴从此衰落
	三年
春，二月，有星孛于西北	春季，二月，西北方向出现异星
冬，十一月，壬辰朔，日有食之	冬季，十一月壬辰朔，出现日食
春，三月，甲寅，立皇后上官氏，赦天下	春季，三月甲寅，汉昭帝颁布诏书，立上官氏为皇后，大赦天下
西南夷姑缯、叶榆复反，遣水衡都尉吕辟胡将益州兵击之	西南夷姑缯、叶榆两部族再次背叛汉朝，汉朝廷派水衡都尉吕辟胡率领益州军队前往征讨
辟胡不进，蛮夷遂杀益州太守，乘胜与辟胡战，士战及溺死者四千余人	吕辟胡屯兵不前，致使叛乱的蛮夷杀死益州太守，并乘胜与吕辟胡所部汉军交战，汉军战死及溺水而死的士卒达四千余人
冬，遣大鸿胪田广明击之	冬季，汉朝廷派大鸿胪田广明率兵前往征讨
廷尉李种坐故纵死罪弃市	廷尉李种因被指控故意为犯有死罪的人开脱罪名，被当众斩首
是岁，上官安为车骑将军	这一年，上官安被任命为车骑将军
	五年
春，正月，追尊帝外祖赵父为顺成侯	春季，正月，汉昭帝追尊外祖父赵父为顺成侯
顺成侯有姊君，赐钱二百万、奴婢、第宅以充实焉	顺成侯有位姐姐名叫赵君，汉昭帝赐给她钱二百万以及奴婢、住宅等，以充实她的财产
诸昆弟各以亲疏受赏赐，无在位者	兄弟们也都按着血缘的亲疏得到赏赐，但没有授予封爵、官职的
夏，六月，封上官安为桑乐侯	夏季，六月，汉昭帝封上官安为桑乐侯
安日以骄淫，受赐殿中，对宾客言：与我婿饮，大乐	上官安日益骄纵淫乱，汉昭帝赐他在宫中饮宴，他回家后，对门客说：与我女婿一起喝酒，非常高兴
见其服饰，使人归，欲自烧物	看见汉昭帝的服饰，便派人回家，要将自己的东西烧掉
子病死，仰而骂天	儿子因病去世，上官安竟仰面骂天
其顽悖如此	其顽劣狂悖到了如此地步
罢儋耳、真番郡	汉朝撤销儋耳、真番二郡
秋，大鸿胪广明、军正王平击益州，斩首、捕虏三万余人，获畜产五万余头	秋季，大鸿胪田广明、军正王平率兵征讨在益州叛乱的西南夷姑缯、叶榆两部族，共斩杀、捕获叛乱者三万余人，缴获牲畜五万余头
谏大夫杜延年见国家承武帝奢侈、师旅之后，数为大将军光言：年岁比不登，流民未尽还，宜修孝文时政，示以俭约、宽和，顺天心，说民意，年岁宜应	谏大夫杜延年看到汉武帝的奢侈和屡次兴兵出征给国家留下的困难，多次对大将军霍光说：连年收成不好，离乡背井的百姓还没有全部回到自己的家园，应当恢复孝文皇帝时的治国方针，提倡节俭，为政宽和，顺从天意，取悦民心，年景就会跟着好转
光纳其言	霍光采纳了他的建议
延年，故御史大夫周之子也	杜延年是前御史大夫杜周的儿子
	六年
春，二月，诏有司问郡国所举贤良、文学，民所疾苦、教化之要，皆对：愿罢盐、铁、酒榷、均输官，毋与天下争利，示以俭节，然后教化可兴	春季，二月，汉昭帝下诏命有关官员向各郡、国举荐的贤良、文学询问，了解民间疾苦和教化百姓的要点，大家都建议：希望取消盐、铁、酒类的专卖制度，罢黜均输官，不要与天下人争利，向百姓表示节俭，然后才可以振兴、教化
桑弘羊难，以为：此国家大业，所以制四夷，安边足用之本，不可废也	但桑弘羊表示反对，他认为：盐、铁、酒类的专卖制度和均输措施等，都是国家赖以控制四夷、保卫边疆，使财用充足的根本大业，不能废除
于是盐铁之议起焉	于是，一场关于盐铁专卖等问题的辩论开始了
初，苏武既徙北海上，禀食不至，掘野鼠、去草实而食之	当初，苏武被匈奴放逐到北海边以后，得不到粮食供应，便挖掘野鼠，吃鼠洞中的草籽
杖汉节牧羊，卧起操持，节旄尽落	他手持汉朝的符节牧羊，无论睡卧还是起身都带着它，以致节杖上的毛缨全部脱落了
武在汉，与李陵俱为侍中；陵降匈奴，不敢求武	苏武在汉朝时，与李陵同为侍中，李陵投降匈奴后，不敢求见苏武
久之，单于使陵至海上	过了很长时间，单于派李陵来到北海边，为苏武摆下酒筵，并以乐队助兴
为武置酒设乐，因谓武曰：单于闻陵与子卿素厚，故使来说足下，虚心欲相待	李陵对苏武说：单于听说我与你一向情谊深厚，所以派我来劝你，单于愿意对你虚心相待
终不得归汉，空自苦；亡人之地，信义安所见乎	你终究不能再回汉朝，自己白白受苦在这荒无人烟的地方，你的信义节操，又有谁看到呢
足下兄弟二人，前皆坐事自杀；来时，太夫人已不幸；子卿妇年少，闻已更嫁矣；独有女弟二人、两女、一男，今复十余年，存亡不可知	你的两个兄弟，先前已都因罪自杀；我来此时，你母亲也已不幸去世；你的夫人年轻，听说已经改嫁别人了；只剩下两个妹妹、两个女儿、一个儿子，如今又过了十几年，是否还在人世，不得而知
人生如朝露，何久自苦如此	人的一生，就像早晨的露水一般短暂，你又何必长久地如此自苦
陵始降时，忽忽如狂，自痛负汉，加以老母系保宫	我刚投降匈奴时，精神恍惚，像要发疯，恨自己辜负汉朝，还连累老母被拘禁牢狱
子卿不欲降，何以过陵	你不愿归降匈奴的心情，怎么会超过我
且陛下春秋高，法令无常，大臣无罪夷灭者数十家	况且皇上年事已高，法令变化无常，大臣无罪而被抄杀满门的达数十家，安危不可知，你还要为谁这样做呢
安危不可知，子卿尚复谁为乎	苏武说：我父子本无才德功绩，全靠皇上栽培，才得以身居高位，与列侯、将军并列，且使我们兄弟得以亲近皇上，所以我常常希望能够肝脑涂地，报答皇上的大恩
武曰：武父子无功德，皆为陛下所成就，位列将，爵通侯，兄弟亲近，常愿肝脑涂地	如今得以杀身报效皇上，既使是斧钺加身，汤锅烹煮，我也心甘情愿
今得杀身自效，虽斧钺、汤镬，诚甘乐之	为臣的侍奉君王，就如同儿子侍奉父亲一般，儿子为父亲而死，没有遗憾
臣事君，犹子事父也；子为父死，无所恨	希望你不要再说了
愿勿复再言	李陵与苏武一连饮酒数日，又劝道：子卿你再听我一句话
陵与武饮数日，复曰：子卿壹听陵言	苏武说：我自己料想必死已经很久了，大王你一定要我苏武投降，就请结束今日的欢聚，让我死在你的面前
武曰：自分已死久矣，王必欲降武，请毕今日之欢，效死于前	李陵见苏武一片至诚，长叹道：唉
陵见其至诚，喟然叹曰：嗟乎，义士	你真是义士
陵与卫律之罪上通于天	我与卫律的罪过上通于天
因泣下沾衿，与武决去	不觉泪湿衣衿，与苏武告别而去
赐武牛羊数十头	赐给苏武牛羊数十头
夏，旱	夏季，干旱
秋，七月，罢榷酤官，从贤良、文学之议也	秋季，七月，汉昭帝接受贤良、文学们的建议，撤销负责酒类专卖的官员
武帝之末，海内虚耗，户口减半	汉武帝末年，国家财力虚耗，户口减少了一半
霍光知时务之要，轻徭薄赋，与民休息	霍光了解当时的要务，减轻赋税和徭役，使百姓得到休息
至是匈奴和亲，百姓充实，稍复文、景之业焉	如今与匈奴恢复和亲，百姓生活充实，渐渐恢复了汉文帝、汉景帝时期的定安、繁荣局面
诏以钩町侯毋波率其邑君长、人民击反者有功，立以为钩町王	汉昭帝颁布诏书，因町侯毋波率领其所属部落的头人和部众镇压叛乱者有功，将毋波封为町王
赐田广明爵关内侯	赐田广明关内侯爵位
	元凤元年
春，武都氐人反，遣执金吾马适建、龙侯韩增、大鸿胪田广明将三辅、太常徒，皆免刑，击之	春季，武都郡氐族人造反，汉昭帝派执金吾马适建、龙侯韩增、大鸿胪田广明率领三辅地区及太常所属的刑徒，一律免其刑罚，前往镇压
夏，六月，赦天下	夏季，六月，大赦天下
秋，七月，乙亥晦，日有食之，既	秋季，七月乙亥，出现日全食
八月，改元	八月，改年号为元凤元年
庚午，右扶风王为御史大夫	庚午，右扶风王被任命为御史大夫
冬，十月，封杜延年为建平侯，燕仓为宜城侯，故丞相征事任宫捕得桀，为弋阳侯，丞相少史王山寿诱安入府，为商利侯	冬季，十月，汉昭帝封杜延年为建平侯，燕仓为宜城侯，原任丞相征事任宫捕获上官桀，被封为弋阳侯，丞相少史王山寿引诱上官安进入丞相府，被封为商利侯
久之，文学济阴魏相对策，以为：日者燕王为无道，韩义出身强谏，为王所杀	过了很久，文学济阴人魏相在回答昭帝的策问时，认为：先前燕王刘旦大逆不道，韩义挺身而出，强行劝阻，被燕王所杀
义无比干之亲而蹈比干之节，宜显赏其子以示天下，明为人臣之义	韩义不像商朝比干那样与纣王有亲属关系，但却有比干劝谏纣王一样的节义，应在天下人面前公开奖励韩义的儿子，以明确为臣的大义
乃擢义子延寿为谏大夫	于是，汉昭帝擢升韩义之子韩延寿为谏大夫
大将军光以朝无旧臣，光禄勋张安世自先帝时为尚书令，志行纯笃，乃白用安世为右将军兼光禄勋以自副焉	大将军霍光因为朝廷中缺少旧臣，而光禄勋张安世在汉武帝时就担任尚书令，心地纯正真诚，便奏请汉昭帝任命张安世为右将军兼光禄勋，作为自己的副手
安世，故御史大夫汤之子也	张安世为前御史大夫张汤的儿子
光又以杜延年有忠节，擢为太仆、右曹、给事中	霍光又因杜延年志节忠诚，特擢升其为太仆、右曹、给事中
光持刑罚严，延年常辅之以宽	霍光执法严厉，杜延年则常常以宽厚辅之
吏民上书言便宜，辄下延年平处复奏	每当官吏或百姓上书朝廷有所建议，总是先交杜延年研究其是否当行，再上奏汉昭帝
可官试者，至为县令；或丞相、御史除用，满岁，以状闻；或抵其罪法	凡参加朝廷考试合格的人，或派到地方，最高为县令，或交丞相、御史任用，一年后将其为官情况奏闻朝廷，有罪者依法惩治
夏，四月，上自建章宫徙未央宫	夏季，四月，汉昭帝从建章宫迁居到未央宫
六月，赦天下	六月，大赦天下
春，正月，泰山有大石自起立；上林有柳树枯僵自起生，有虫食其叶成文，曰公孙病已立	春季，正月，泰山上有一块大石自己立了起来；上林苑中有一棵枯死倒地的柳树自己立起复活，又有虫子在其树叶上啃咬出公孙病已立的字样
符节令鲁国眭弘上书，言：大石自立，僵柳复起，当有匹庶为天子者	担任符节令的鲁国人眭弘，上书说：大石自己站立，枯倒柳树复起，当有一位平民百姓成为天子
枯树复生，故废之家公孙氏当复兴乎	枯树复活，是不是预示着以前被废黜的公孙氏家族应当复兴呢
汉家承尧之后，有传国之运，当求贤人禅帝位，退自封百里，以顺天命	汉天子为帝尧的后代，有将国家传给别人的命运，应当访求贤明的人，将帝位禅让给他，自己退下，做一个拥有一百里封地的列侯，以顺应天命
弘坐设妖言惑众伏诛	眭弘以制造妖言、蛊惑人心的罪名被处死
匈奴单于使犁王窥边，言酒泉、张掖兵益弱，出兵试击，冀可复得其地	匈奴单于派犁污王刺探汉朝边防情况
时汉先得降者，闻其计，天子诏边警备	犁污王回报说，酒泉、张掖一带的汉朝兵力日益衰弱，如果派兵作试探性攻击，有希望收复旧有地区
后无几，右贤王、犁王四千骑分三队，入日勒、屋兰、番和	此时，汉朝已先从归降的匈奴人口中听到这个计谋，汉昭帝便下诏命边塞地区加强戒备
张掖太守、属国都尉发兵击，大破之，得脱者数百人	没过多久，匈奴右贤王、犁污王率领骑兵四千分为三队，侵入日勒、屋兰、番和三县
属国义渠王射杀犁王，赐黄金二百斤，马二百匹，因封为犁王	汉朝张掖太守、属国都尉发兵反击，匈奴军大败，仅数百人逃脱，属国的义渠部落王将匈奴犁污王射死，汉朝赏赐给他黄金二百斤，马二百匹，并因此封他为犁污王
自是后，匈奴不敢入张掖	从此以后，匈奴不敢侵犯张掖
冬，辽东乌桓反	冬季，辽东乌桓部落反叛
初，冒顿破东胡，东胡余众散保乌桓及鲜卑山为二族，世役属匈奴	当初，匈奴冒顿单于击败东胡族，东胡残余部众分别占据乌桓及鲜卑山，形成了两个部族，世代臣服于匈奴
武帝击破匈奴左地，因徙乌桓于上谷、渔阳、右北平、辽东塞外，为汉侦察匈奴动静	汉武帝击破匈奴左翼地区，将乌桓迁徙到上谷、渔阳、右北平和辽东的塞外地区，令其为汉朝侦察匈奴动静
置护乌桓校尉监领之，使不得与匈奴交通	汉朝还设置了护乌桓校尉一官，负责对乌桓人的监督和管辖，使他们不能与匈奴建立联系
至是，部众渐强，遂反	至此，乌桓势力逐渐强大起来，于是起兵反叛汉朝
春，正月，丁亥，帝加元服	春季，正月丁亥，汉昭帝举行加冠典礼
甲戌，富民定侯田千秋薨	甲戌，富民侯田千秋去世
时政事壹决大将军光；千秋居丞相位，谨厚自守而已	当时的国家政事全部由霍光一个人决定，田千秋身居丞相之位，只是谨慎稳重，自我保全而已
六月，赦天下	六月，大赦天下
初，遣太子赖丹为质于龟兹；贰师击大宛还，将赖丹入至京师	当初，国派太子赖丹到龟兹国去作人质，贰师将军李广利攻击大宛回朝时，将赖丹带到京城长安
霍光用桑弘羊前议，以赖丹为校尉，将军田轮台	霍光采用桑弘羊以前的建议，任命赖丹为校尉，率领军队前往轮台屯田
龟兹贵人姑翼谓其王曰：赖丹本臣属吾国，今佩汉印绶来，迫吾国而田，必为害	龟兹贵族姑翼对龟兹国王说：赖丹本来是我国的臣属，如今却佩戴汉朝的印信、绶带前来，在逼近我国边境的地方屯垦，必将给我国造成危害
王即杀赖丹而上书谢汉	于是龟兹王派人杀死赖丹，然后上书汉朝谢罪
夏，大旱	夏季，大旱
秋，罢象郡，分属郁林、柯	秋季，撤除象郡，将其地分别归属郁林、柯二郡
冬，十一月，大雷	冬季，十一月，大雷
十二月，庚戌，宜春敬侯王诉薨	十二月庚戌，宜春侯王去世
	六年
春，正月，募郡国徒筑辽东、玄菟城	春季，正月，募集各郡、国服劳役的人修筑辽东、玄菟二城
夏，赦天下	夏季，大赦天下
乌桓复犯塞，遣度辽将军范明友击之	乌桓再次侵犯边塞，汉朝派度辽将军范明友率兵出击
冬，十一月，乙丑，以杨敞为丞相，少府河内蔡义为御史大夫	冬季，十一月乙丑，汉昭帝任命杨敞为丞相，少府、河内人蔡义为御史大夫
春，二月，诏减口赋钱什三	春季，二月，汉昭帝下诏书将七岁至十四岁百姓交纳的口赋减少十分之三
夏，四月，癸未，帝崩于未央宫；无嗣	夏季，四月癸未，汉昭帝在未央宫驾崩，没有儿子
时武帝子独有广陵王胥，大将军光与群臣议所立，咸持广陵王	当时，汉武帝的儿子只有广陵王刘胥还在，大将军霍光与群臣商议立谁为新皇帝，大家都认为应当立广陵王
王本以行失道，先帝所不用；光内不自安	广陵王本来因行为不合礼法，汉武帝不喜欢他，所以霍光心中感到不安
郎有上书言：周太王废太伯立王季，文王舍伯邑考立武王，唯在所宜，虽废长立少可也	有一位郎官上书朝廷指出：周太王废弃年长的儿子太伯，立太伯的弟弟王季为继承人；周文王舍弃年长的儿子伯邑考，立伯邑考的弟弟周武王为继承人
广陵王不可以承宗庙	这两个事例说明，只要适合继承皇位，即使是废长立幼也完全可以
言合光意	广陵王不能继位
光以其书示丞相敞等	这道奏章的内容正合霍光的心意
擢郎为九江太守	霍光将奏章拿给丞相杨敞等人观看，并提升这位郎官作了九江太守
即日承皇后诏，遣行大鸿胪事少府乐成、宗正德、光禄大夫吉、中郎将利汉迎昌邑王贺，乘七乘传诣长安邸	当日，由上官皇后颁下诏书，派代理大鸿胪职务的少府乐成、宗正刘德、光禄大夫丙吉、中郎将利汉用七辆驿车将昌邑王刘贺迎接到长安的昌邑王官邸
光又白皇后，徙右将军安世为车骑将军	霍光又禀明皇后，调右将军张安世为车骑将军
壬申，葬孝昭皇帝于平陵	壬申，将汉昭帝安葬于平陵
昌邑王既立，淫戏无度	昌邑王刘贺作了皇帝后，淫乱荒唐没有节制
昌邑官属皆征至长安，往往超擢拜官	原昌邑国官吏全部被征召到长安，很多人得到破格提拔
相安乐迁长乐卫尉	昌邑国相安乐被任命为长乐卫尉
龚遂见安乐，流涕谓曰：王立为天子，日益骄溢，谏之不复听	龚遂见到安乐，哭着对他说：大王被立为天子之后，日益骄纵，规劝他也不再听从
今哀痛未尽，日与近臣饮酒作乐，斗虎豹，召皮轩车九旒，驱驰东西，所为悖道	如今仍在居丧期间，他却每天与亲信饮酒作乐，观看虎豹搏斗，又传召悬挂着天子旌旗的虎皮轿车，坐在上面东奔西跑，所作所为违背了正道
古制宽，大臣有隐退；今去不得，阳狂恐知，身死为世戮，柰何	古代制度宽厚，大臣可以辞职隐退，如今想走走不得，想伪装疯狂，又怕被人识破，死后还要遭人唾骂，教我如何是好
君，陛下故相，宜极谏争	您是陛下原来的丞相，应当极力规劝才是
八月，己巳，安平敬侯杨敞薨	八月己巳，安平侯杨敞去世
九月，大赦天下	九月，大赦天下
戊寅，蔡义为丞相	戊寅，蔡以被任为丞相
初，许广汉女适皇曾孙，一岁，生子	当初，许广汉的女儿嫁给皇曾孙刘病已，一年后生下一子，名叫刘
数月，曾孙立为帝，许氏为	数月之后，刘病已即皇帝位，封许氏为
是时霍将军有小女与皇太后亲，公卿议更立皇后，皆心拟霍将军女，亦未有言	此时，霍光有一小女儿，与皇太后有亲属关系，所以公卿大臣商议立皇后，心中都认为应立霍光的女儿，但也没有明说
上乃诏求微时故剑	汉宣帝下诏寻找微贱时用的宝剑，大臣们懂得皇上的心意，便奏请立许为皇后
大臣知指，白立许为皇后	十一月壬子，许氏被立为皇后
十一月，壬子，立皇后许氏	霍光认为其父亲许广汉是受过刑的人，不宜做封国的国君
霍光以后父广汉刑人，不宜君国；岁余，乃封为昌成君	一年多以后，才封许广汉为昌成君
太皇太后归长乐宫	太皇太后回到长乐宫居住
长乐宫初置屯卫	长乐宫开始驻兵守卫
	中宗孝宣皇帝上之上本始元年
春，诏有司论定策安宗庙功	春季，汉宣帝诏令有关部门议定对安定宗庙有功人员的褒奖
大将军光益封万七千户，与故所食凡二万户	大将军霍光增加食邑一万七千户，加上以前的，共享有二万户的赋税
车骑将军富平侯安世以下益封者十人，封侯者五人，赐爵关内侯者八人	车骑将军富平侯张安世以下，增加封邑户数的共十人，封为列侯的共五人，赐关内侯爵位的共八人
夏，四月，庚午，地震	夏季，四月庚午，发生地震
五月，凤皇集胶东、千乘	五月，发现有凤凰聚集于胶东、千乘
赦天下，勿收田租赋	汉宣帝下诏大赦天下，免收田赋
秋，七月，诏立燕剌王太子建为广阳王；立广陵王胥少子弘为高密王	秋季，七月，汉宣帝下诏立燕剌王刘旦的太子刘建为广阳王，广陵王刘胥的小儿子刘弘为高密王
戊辰，五将军发长安	戊辰，奉命出征匈奴的五位将军从长安出发
匈奴闻汉兵大出，老弱奔走，驱畜产远遁逃，是以五将少所得	匈奴听到汉朝派大兵前来征讨的消息后，便带着老弱，驱赶着牲畜向远方逃奔
夏，五月，军罢	因此，汉朝五位将领收获却不大
度辽将军出塞千二百余里，至蒲离候水，斩首、捕虏七百余级	夏季，五月，汉军罢兵而还
前将军出塞千二百余里，至乌员，斩首、捕虏百余级	度辽将军范明友出塞一千二百余里，到达蒲离候水，共斩杀和俘获匈奴七百余人
蒲类将军出塞千八百余里，西至候山，斩首、捕虏，得单于使者蒲阴王以下三百余级	前将军韩增出塞一千二百余里，到达乌员，共斩杀、俘获匈奴一百余人
闻虏已引去，皆不至期还	蒲类将军赵充国出塞一千八百余里，向西到达候山，共斩杀、俘获匈奴单于使臣蒲阴王及以下三百余人
天子薄其过，宽而不罪	以上三位将军因听说匈奴已然退走，所以不到预定目标就全都退兵而回
祁连将军出塞千六百里，至鸡秩山，斩首、捕虏十九级	汉宣帝认为他们的过失并不严重，所以从宽处理，未加处罚
逢汉使匈奴还者冉弘等，言鸡秩山西有虏众，祁连即戒弘，使言无虏，欲还兵	祁连将军田广明出塞一千六百里，到达鸡秩山，共斩杀、俘获匈奴十九人，正好与从匈奴回来的汉朝使臣冉弘等相遇
御史属公孙益寿谏，以为不可	冉弘等说鸡秩山以西地区有匈奴军队，但田广明却警告冉弘，让他们对别人说没有看到匈奴人的踪迹，打算退兵
祁连不听，遂引兵还	御史属官吏公孙益寿劝谏田广明，认为不可退兵，田广明不听，率兵而还
虎牙将军出塞八百余里，至丹馀吾水上，即止兵不进，斩首、捕虏千九百余级，引兵还	虎牙将军田顺出塞八百余里，到达丹馀吾水边，停兵不进，共斩杀、俘获匈奴一千九百余人，率兵而还
上以虎牙将军不至期，诈增卤获，而祁连知虏在前，逗遛不进，皆下吏，自杀	汉宣帝认为田顺未到预定目标就退兵而回，还虚报战果；田广明明知敌人就在前面，却畏缩逗留，不敢前进，下令将二人治罪，二人自杀
擢公孙益寿为侍御史	汉宣帝擢升公孙益寿为侍御史
大旱	大旱
六月，己丑，阳平节侯蔡义薨	六月己丑，阳平侯蔡义去世
甲辰，长信少府韦贤为丞相	甲辰，长信少府韦贤担任丞相
大司农魏相为御史大夫	大司农魏相被任命为御史大夫
春，三月，乙卯，立霍光女为皇后，赦天下	春季，三月乙卯，立霍光的女儿霍成君为皇后，大赦天下
初，许后起微贱，登至尊日浅，从官车服甚节俭	当初，许皇后出身微贱，登上皇后宝座的时间不长，其侍从、车马、服饰等都非常节俭
及霍后立，舆驾、侍从益盛，赏赐官属以千万计，与许后时悬绝矣	及至霍成君立为皇后，车驾、侍从等日益盛大，对官属的赏赐以千万计，与许皇后时有天壤之别
五月，凤皇集北海安丘、淳于	五月，有凤凰聚集在北海郡的安丘、淳于二县
春，正月，有星孛于西方	春季，正月，西方天空出现异星
十二月，癸亥晦，日有食之	十二月癸亥晦，出现日食
凤皇集鲁，群鸟从之	凤凰在鲁国聚集，成群的飞鸟追随
大赦天下	大赦天下
六月，壬辰，以魏相为丞相	六月壬辰，汉宣帝任命魏相为丞相
辛丑，丙吉为御史大夫，疏广为太子太傅，广兄子受为少傅	辛丑，任命丙吉为御史大夫，疏广为太子太傅，疏广兄长的儿子疏受为少傅
冬，十月，诏曰：乃者九月壬申地震，朕甚惧焉	冬季，十月，汉宣帝颁布诏书说：先前在九月壬申发生的地震，使朕非常恐惧
有能箴朕过失，及贤良方正直言极谏之士，以匡朕之不逮，毋讳有司	如有能指出朕的过失，以及各郡、国举荐的贤良方正和直言极谏之士，要匡正朕的失误，对有关高级官员的错误也不必回避
朕既不德，不能附远，是以边境屯戍未息	由于朕的品德不足，不能使远方的蛮族归附，因而边境的屯戍事务一直不能结束
今复饬兵重屯，久劳百姓，非所以绥天下也	如今又调兵增加边塞屯戍力量，使百姓长期劳苦不止，不利于天下的安定
其罢车骑将军、右将军屯兵	解散车骑将军张安世、右将军霍禹所属的两支屯戍部队
又诏：池未御幸者，假与贫民	又下诏命令：将未使用过的皇家池塘和禁苑借给贫苦百姓，让他们在其中从事生产活动
郡国宫馆勿复修治	各郡、国的宫室、别馆，不要再进行修缮
流民还归者，假公田，贷种食，且勿算事	返回原籍的流民，由官府借给公田，贷给种子、粮食，免除他们的财产税和徭役
十二月，诏曰：间者吏用法巧文浸深，是朕之不德也	十二月，汉宣帝下诏书说：近来，官吏们舞文弄法的现象越来越严重，这都是朕的错误
夫决狱不当，使有罪兴邪，不辜蒙戮，父子悲恨，朕甚伤之	案狱处理不当，使有罪者愈发作恶，无辜者遭受严刑处罚，父子兄弟悲伤愤恨，朕对此甚为难过
今遣廷史与郡鞠狱，任轻禄薄，其为置廷尉平，秩六百石，员四人	如今派廷尉史参与各郡的司法事务，但职权小俸禄少，应再设置廷尉平四名，俸禄为六百石
其务平之	务必使审判公平，以符合朕的心意
以称朕意	于是每年秋天，当对一年中的案狱做最后决定时，汉宣帝经常到宣室殿，住那里实行斋戒，亲自裁决
于是每季秋后请谳时，上常幸宣室，斋居而决事，狱刑号为平矣	从此，对各类刑罚案狱的判决号称公平
春，二月，赐外祖母号为博平君；封舅无故为平昌侯，武为乐昌侯	春季，二月，汉宣帝赐其外祖母博平君称号，封其舅父王无故为平昌侯、王武为乐昌侯
夏，五月，山阳、济阴雹如鸡子，深二尺五寸，杀二十余人，飞鸟皆死	夏季，五月，山阳、济阴两地下了一场冰雹，如鸡蛋般大小，深二尺五寸，有二十多人被冰雹砸死，当地的飞鸟也全部丧生
诏：自今子有匿父母、妻匿夫、孙匿大父母，皆勿治	汉宣帝下诏书说：从今以后，凡属儿子窝藏父母、妻子窝藏丈夫、孙子窝藏祖父母的，一律不治罪
立广川惠王孙文为广川王	汉宣帝立广川惠王的孙子刘文为广川王
霍显及禹、山、云自见日侵削，数相对啼泣自怨	霍显和霍禹、霍山、霍云眼看霍家的权势日益被削弱，多次聚在一起痛哭流涕，自怨自艾
山曰：今丞相用事，县官信之，尽变易大将军时法令，发扬大将军过失	霍山说：如今丞相当权，受到天子的信任，将大将军在世时的法令全部更改，还专门宣扬大将军的过失
又，诸儒生多窭人子，远客饥寒，喜妄说狂言，不避忌讳，大将军常雠之	再者，那些儒生大都为贫贱出身，从偏远的地方来到京中，衣食无着，却爱说狂言，不避忌讳，大将军一向痛恨他们，但如今皇上却专爱和这些腐儒谈话
今陛下好与诸儒生语，人人自书对事，多言我家者	他们每人都上书奏事，纷纷指责我们霍家
尝有上书言我家昆弟骄恣，其言绝痛；山屏不奏	曾经有人上书说我们兄弟骄横霸道，言词十分激烈，被我压下没有呈奏
后上书者益黠，尽奏封事，辄使中书令出取之，不关尚书，益不信人	后来上书者越来越狡猾，都改成秘密奏章，皇上总是让中书令出来取走，并不通过尚书，日益不信任我
又闻民间欢言霍氏毒杀许皇后，宁有是邪	又听说民间纷纷传言霍氏毒死许皇后，难道有这回事吗
显恐急，即具以实告禹、山、云	霍显吓坏了，便将实情告诉霍禹、霍山、霍云
禹、山、云惊曰：如是，何不早告禹等	霍禹、霍山、霍云大惊，说道：果真如此，为什么不早告诉我们
县官离散、斥逐诸婿，用是故也	皇上将霍家女婿都贬斥放逐，就是为了这个缘故
此大事，诛罚不小，奈何	这是大事，一旦事发，必遭严惩，怎么办
于是始有邪谋矣	于是开始有反叛朝廷的阴谋
九月，诏减天下盐贾	九月，汉宣帝下诏降低天下盐价
又令郡国岁上系囚以掠笞若瘐死者，所坐县、名、爵、里，丞相、御史课殿最以闻	又下令各郡、国，每年将本地因受刑或病饿而死的囚犯的县份、姓名、官爵和所居邑里呈报朝廷，由丞相、御史对地方官员考评，排出等级后奏报汉宣帝
十二月，清河王年坐内乱废，迁房陵	十二月，清河王刘年因被指控乱伦，被废去王爵，贬居房陵
是岁，北海太守庐江朱邑以治行第一入为大司农，勃海太守龚遂入为水衡都尉	这一年，北海太守庐江人朱邑，以治理地方政绩和个人品行排名第一，被调入朝中担任大司农，勃海太守龚遂也调入朝中担任水衡都尉
先是，勃海左右郡岁饥，盗贼并起，二千石不能禽制	当初，勃海周围各郡遇到荒年，百姓饥馑，盗贼并起，二千石官员不能擒获制止
上选能治者，丞相、御史举故昌邑郎中令龚遂，上拜为勃海太守	汉宣帝下令征选有能力治理的官员，丞相、御史举荐前昌邑国郎中令龚遂，于是汉宣帝任命龚遂为勃海太守
召见，问：何以治勃海，息其盗贼	召见时，汉宣帝问龚遂：你用什么办法来治理勃海郡，平息那里的盗贼呢
对曰：海濒遐远，不沾圣化，其民困于饥寒而吏不恤，故使陛下赤子盗弄陛下之兵于潢池中耳	龚遂说：勃海郡地处海滨，远离京师，得不到圣明君主的教化，当地百姓为饥寒所困苦，而地方官吏却不加体恤，所以才使陛下的子民盗取陛下的兵器，在小池溏中耍弄罢了
今欲使臣胜之邪，将安之也	如今陛下是打算派我镇压他们呢
上曰：选用贤良，固欲安之也	还是安抚他们呢
遂曰：臣闻治乱民犹治乱绳，不可急也；唯缓之，然后可治	汉宣帝说：我征选贤良人才，当然是要安抚他们
臣愿丞相、御史且无拘臣以文法，得一切便宜从事	龚遂说：我听说，治理作乱的百姓，就如同整理一团乱绳一般，不能操之过急，只有先将紧张的局势缓和下来，然后才能治理
上许焉，加赐黄金赠遣	我希望丞相、御史不要用严格的法令约束我的行动，准许我相机行事
乘传至勃海界，郡闻新太守至，发兵以迎	汉宣帝批准了龚遂的请求，并加赏黄金，派他前往
遂皆遣还	龚遂乘坐国家的驿车，来到勃海郡界，郡中官员听说新太守来到，派军队前往迎接
移书敕属县：悉罢逐捕盗贼吏，诸持、钩、田器者皆为良民，吏毋得问；持兵者乃为贼	龚遂将军队全部遣还，并下达文书给所属各县，命令：将所有负责缉捕盗贼的官吏一律撤销，凡是手持锄头、镰刀和其他农具的，一律视为良民百姓，地方官吏不得刁难，只有手持兵器的才算是盗贼
遂单车独行至府	然后，龚遂单人独车前往郡衙门就职
盗贼闻遂教令，即时解散，弃其兵弩而持钩、，于是悉平，民安土乐业	盗贼们听说新太守的命令后，立即解散，抛弃兵器弓弩，拿起镰刀、锄头，于是盗贼全部平息，百姓安居乐业
遂乃开仓廪假贫民，选用良史慰安牧养焉	于是，龚遂下令打开官仓，赈济贫苦百姓，选派品行优良的官吏对百姓们进行安抚、管理
遂见齐俗奢侈，好末技，不田作，乃躬率以俭约，劝民务农桑，各以口率种树畜养	龚遂发现齐地风俗奢侈，人们喜欢经营工商业，不愿在田间劳作，便以身作则，提倡勤俭节约，劝导百姓从事农业生产，按各家人口的多少，规定必须种树若干，养家畜若干
民有带持刀剑者，使卖剑买牛，卖刀买犊，曰：何为带牛佩犊	凡百姓有带刀持剑的，让他们卖剑买耕牛，卖刀买牛犊，说道：你为什么把壮牛和牛犊佩带在身上
劳来循行，郡中皆有畜积，狱讼止息	经过龚遂的辛勤劝勉，往来巡查，终于使勃海郡内各家各户都有了积蓄，刑狱讼案也大为减少
乌孙公主女为龟兹王绛宾夫人	嫁给乌孙国王的汉朝公主刘解忧的女儿是龟兹国王绛宾的夫人
绛宾上书言：得尚汉外孙，愿与公主又俱入朝	绛宾上书汉宣帝说：我有幸娶汉朝外孙女为妻，愿与公主的女儿同到长安朝见
	元康元年
三月，诏以凤皇集泰山、陈留，甘露降未央宫，赦天下	三月，汉宣帝下诏，因有凤凰聚集于泰山、陈留一带，又有甘露降于未央宫，所以大赦天下
冬，置建章卫尉	冬季，设置建章卫尉
是岁，少府宋畴坐议凤皇下彭城，未至京师，不足美，贬为泗水太傅	这一年，少府宋畴因声称凤凰飞集彭城，未到长安，不足以赞美，受到指控，被贬为泗水国太傅
上选博士、谏大夫通政事者补郡国守相，以萧望之为平原太守	汉宣帝征选通晓政务的博士、谏大夫充任郡太守和封国丞相，任命萧望之为平原太守
望之上疏曰：陛下哀愍百姓，恐德之不究，悉出谏官以补郡吏	萧望之上书汉宣帝说：陛下哀怜百姓，唯恐恩德不能遍及天下，将朝中谏官全部派到各郡、国掌管地方事务
朝无争臣，则不知过，所谓忧其未而忘其本者也	但朝中缺少直谏之臣，就不能使陛下了解朝政的缺失，这正是所谓只忧虑末梢而忘记了根本
上乃征望之入守少府	于是汉宣帝征调萧望之担任少府
东海太守河东尹翁归，以治郡高第入为右扶风	东海太守河东人尹翁归，因治理郡务成绩优等，被调入京担任右扶风一职
翁归为人，公廉明察，郡中吏民贤、不肖及奸邪罪名尽知之	尹翁归为人公正、廉洁、明察，对郡中官吏和普通百姓的好坏及奸邪之徒的罪状无不尽知
县县各有记籍，自听其政；有急名则少缓之	他对治下每个县的情况都有专门记载，亲自处理各县的政务
吏民小解，辄披籍	凡遇下属处理事务过于苛急，他便命其稍加平缓；如属下官吏办事稍有懈怠，他则亲自查阅有关记载督促
取人必于秋冬课吏大会中及出行县，不以无事时	尹翁归逮捕罪犯，都在秋冬考核官吏大会中，或出巡各县之际，而不在平日无事时进行
其有所取也，以一警百	他逮捕罪犯，目的在于以一警百
吏民皆服，恐惧，改行自新	官吏和百姓全都敬服，心怀恐惧，改过自新
其为扶风，选用廉平疾奸吏以为右职，接待有礼，好恶与同之；其负翁归，罚亦必行	尹翁归出任右扶风，选用清廉公正、疾恶如仇的官员担任高级职务；待人接物注重礼节，无论自己喜欢还是厌恶，都同样对待；但对违抗命令者，也必加处罚
然温良谦退，不以行能骄人，故尤得名誉于朝廷	然而尹翁归为人温和谦虚，从不依恃自己的才能看不起别人，因此在朝中尤其受人赞誉
初，乌孙公主少子万年有宠于莎车王	当初，嫁与乌孙王的汉朝公主的小儿子万年受到莎车王的宠爱
莎车王死而无子，时万年在汉，莎车国人计，欲自托于汉，又欲得乌孙心，上书请万年为莎车王	莎车王死后，没有儿子，当时万年正在汉朝，莎车国人商议，既想托庇于汉朝，又想取得乌孙国的欢心，于是上书汉朝廷，请求立万年为莎车王
汉许之，遣使者奚充国送万年	汉朝同意所请，派使者奚充国护送万年前往莎车
万年初立，暴恶，国人不说	万年刚当上莎车国王，就非常残暴凶恶，莎车人深为不满
春，正月，赦天下	春季，正月，大赦天下
又曰：闻古天子之名，难知而易讳也；其更讳询	汉宣帝在诏书上还说：听说，古代天子的名字，民间都不常用，容易避讳，所以我改名为刘询
魏相好观汉故事及便宜章奏，数条汉兴已来国家便宜行事及贤臣贾谊、晁错、董仲舒等所言，奏请施行之	魏相喜欢阅读有关汉朝旧事的记载和前人提出改良建议的奏章，多次列举汉朝建国以来推行的于国有益的措施以及贤臣贾谊、晁错、董仲舒等人的建议，奏请汉宣帝批准实行
相敕掾史按事郡国，及休告，从家还至府，辄白四方异闻	丞相府的官员因公事到郡国及休假从家回到相府，魏相都命他们将各地发生的奇闻异事报告给他
或有逆贼、风雨灾变，郡不上，相辄奏言之	如果有的地区出现逆贼，或自然灾害，郡府不向朝廷报告，总是由魏相奏闻朝廷
与御史大夫丙吉同心辅政，上皆重之	魏相与御史大夫丙吉同心协力辅佐朝政，汉宣帝对二人都很倚重
帝以萧望之经明持重，议论有余，材任宰相，欲详试其政事，复以为左冯翊	汉宣帝认为萧望之善于筹划，为人持重，很会分析议论，才能堪为丞相，打算仔细考察他处理政务的能力，便又任命他为左冯翊
望之从少府出为左迁，恐有不合意，即移病	萧望之本为少府，如今从宫廷被降到地方，担心皇上对自己有不满意之处，便上书汉宣帝，以有病为理由，打算辞去官职
上闻之，使侍中成都侯金安上谕意曰：所用皆更治民以考功	汉宣帝知道后，派侍中成都侯金安上向萧望之解释自己的意思说：这样做都是为了考察你治理百姓的能力
君前为平原太守日浅，故复试之于三辅，非有所闻也	你以前当平原太守的时间太短，所以再调你到三辅地区试用，并非听到什么不利于你的议论
望之即起视事	于是萧望之立即起身处理政事
春，三月，诏封故昌邑王贺为海昏侯	春季，三月，汉宣帝下诏封原昌邑王刘贺为海昏侯
夏，四月，丙子，立皇子钦为淮阳王	夏季，四月丙子，汉宣帝立皇子刘钦为淮阳王
皇太子年十二，通《论语》、《孝经》	皇太子刘年十二岁，已通晓《论语》、《孝经》
太傅疏广谓少傅受曰：吾闻知足不辱，知止不殆	太傅疏广对少傅疏受说：我听说知道满足的人不会受辱，知道适可而止的人不会遇到危险
今仕宦室二千石，官成名立，如此不去，惧有后悔	而今我们作官已到二千石高位，功成名就，这样再不离去，恐怕将来会后悔
即日，父子俱移病，上疏乞骸骨	于是，当天，叔侄二人就一起以身体患病为理由，上书汉宣帝请求退休
上皆许之，加赐黄金二十斤，皇太子赠以五十斤	汉宣帝批准所请，加赐黄金二十斤，皇太子也赠送黄金五十斤
公卿故人设祖道供张东都门外，送者车数百两	公卿大臣和故人在东都门外设摆酒宴，陈设帷帐，为他们送行，前来相送的人乘坐的车辆达数百辆之多
道路观者皆曰：贤哉二大夫	沿途观看的人都赞道：两位大夫真是贤明
或叹息为之下泣	有人甚至为之感叹落泪
春，正月，诏：年八十以上，非诬告、杀伤人，他皆勿坐	春季，正月，汉宣帝颁布诏书说：年纪在八十以上的人，除犯有诬告、杀人、伤人之罪以外，其他罪一概免予论处
上令有司求高祖功臣子孙失侯者，得槐里公乘周广汉等百三十六人，皆赐黄金二十斤，复其家，令奉祭祀，世世勿绝	汉宣帝命有关部门查访汉高祖功臣的子孙中失去侯爵的人，共查出槐里公乘周广汉等一百三十六人，一律赐予黄金二十斤，免除其家徭役赋税，命其负责祖先的祭祀事务，世世不绝
丙寅，富平敬侯张安世薨	丙寅，富平侯张安世去世
是时，比年丰稔，谷石五钱	这时，因农业连年丰收，一石谷物的价格是五钱
义渠安国至羌中，召先零诸豪三十余人，以尤桀黠者皆斩之；纵兵击其种人，斩首千余级	义渠安国到达羌中，召集先零部落众首领三十余人前来，将其中最为桀骜狡猾者全部杀死，又纵兵袭击先零人，斩首一千余级
于是诸降羌及归义羌侯杨玉等怨怒，无所信乡，遂劫略小种，背畔犯塞，攻城邑，杀长吏	于是引起归附汉朝的各羌人部落和归义羌侯杨玉的愤怒怨恨，不再信任、顺服汉朝，于是劫掠弱小种族，侵犯汉朝边塞，攻打城池，杀伤官吏
安国以骑都尉将骑二千屯备羌；至浩，为虏所击，失亡车重、兵器甚众	义渠安国以骑都尉身分率领二千骑兵防备羌人，进至浩，遭到羌人袭击，损失了很多车马辎重和武器
安国引还，至令居，以闻	义渠安国率兵撤退，到达令居，奏闻朝廷
六月，有星孛于东方	六月，东方天空出现异星
大司农朱邑卒	大司农朱邑去世
上以其循吏，闵惜之，诏赐其子黄金百斤，以奉其祭祀	汉宣帝因他是个奉职守法的官吏，感到怜惜，下诏赐其子黄金一百斤，作为祭祀之用
是岁，前将军、龙侯韩增为大司马、车骑将军	这一年，汉宣帝任命前将军、龙侯韩增为大司马、车骑将军
丁令比三岁钞盗匈奴，杀略数千人	丁令国连续三年出兵劫掠匈奴，杀死及掳掠数千人
匈奴遣万余骑往击之，无所得	匈奴派遣骑兵一万余人前去攻击丁令国，但没有收获
	二年
春，正月，以凤皇、甘露降集京师，赦天下	春季，正月，因有凤凰飞集长安，并有甘露降落，所以大赦天下
夏，五月，赵充国奏言：羌本可五万人军，凡斩首七千六百级，降者三万一千二百人，溺河湟、饿死者五六千人，定计遗脱与煎巩、黄羝俱亡者不过四千人	夏季，五月，赵充国上奏说：羌人部众和军队本约五万人，前后被斩首共七千六百人，投降三万一千二百人，在黄河、湟水中淹死以及饿死的有五六千人，计算起来，剩下跟随其首领煎巩、黄羝一起逃亡的不过四千人
羌靡忘等自诡必得，请罢屯兵	现已归降的羌人首领靡忘等自己保证可以擒获这些人，所以我请求罢除屯田部队
奏可	汉宣帝批准所奏
充国振旅而还	赵充国整顿部队返回
春，三月，丙辰，高平宪侯魏相薨	春季，三月丙辰，高平侯魏相去世
夏，四月，戊辰，丙吉为丞相	夏季，四月戊辰，丙吉被任命为丞相
吉上宽大，好礼让，不亲小事；时人以为知大体	丙吉崇尚宽大，讲究礼让，一般小事并不过问，当时人认为他识大体
秋，七月，甲子，大鸿胪萧望之为御史大夫	秋季，七月甲子，大鸿胪萧望之被任命为御史大夫
八月，诏曰：吏不廉平，则治道衰	八月，汉宣帝下诏书说：官吏如不清廉公正，国家就不能得到治理
今小吏皆勤事而俸禄薄，欲无侵渔百姓，难矣	现在低级官吏的事务繁忙，而薪俸却很微薄，若想不让他们侵夺、敲诈百姓，实在很难
其益吏百石已下俸十五	从今以后，百石以下官吏增加俸禄十分之五
匈奴单于又杀先贤掸两弟；乌禅幕请之，不听，心恚	匈奴单于又杀死先贤掸的两个弟弟
其后左奥王死，单于自立其小子为奥王，留庭	乌禅幕为其求情，遭到单于拒绝，因此心怀怨恨
奥贵人共立故奥王子为王，与俱东徙	后匈奴左奥王去世，单于立自己的小儿子为奥王，留居王庭
单于右丞相将万骑往击之	奥部落贵族共同拥立已故奥王之子为王，同他一起率部众向东迁徙
失亡数千人，不胜	单于派右丞相率骑兵万人前往追击，损失数千人，未能取胜
春，二月，以凤皇、甘露降集京师，赦天下	春季，二月，长安有凤凰飞集、甘露降落，因而大赦天下
五月，匈奴单于遣弟呼留若王胜之来朝	五月，匈奴单于派其弟呼留若王胜之前来朝见汉宣帝
冬，十月，凤皇十一集杜陵	冬季，十月，十一只凤凰飞集杜陵
匈奴握衍朐单于暴虐，好杀伐，国中不附	匈奴握衍朐单于暴虐凶残，好杀人，全国上下都离心离德
及太子、左贤王数谗左地贵人，左地贵人皆怨	太子、左贤王又多次诬陷东部地区的贵族，这些人全都感到怨恨
会乌桓击匈奴东边姑夕王，颇得人民，单于怒	正在此时，乌桓派兵袭击居于匈奴东部边疆的姑夕王，获得大批人口，单于很恼怒
姑夕王恐，即与乌禅幕及左地贵人共立稽侯为呼韩邪单于，发左地兵四五万人，西击握衍朐单于，至姑且水北	姑夕王害怕单于降罪，便与乌禅幕及东部地区贵族一同拥立稽侯为呼韩邪单于，并征发东部地区军队四五万人，向西进攻握衍朐单于，直抵姑且水北岸
未战，握衍朐单于兵败走，使人报其弟右贤王曰：匈奴共攻我，若肯发兵助我乎	尚未交战，握衍朐单于的军队已先行败逃，派人通知其弟右贤王说：匈奴人一起攻击我，你肯发兵帮助我吗
右贤王曰：或不爱人，杀昆弟、诸贵人	右贤王说：你不爱惜别人，屠杀兄弟和各位贵族，你就死在自己那里吧，不要来玷污我
各自死若处，无来污我	握衍朐单于感到愤恨，自杀而死
握衍朐单于恚，自杀	左大且渠都隆奇逃到右贤王住地，属下部众全部归降呼韩邪单于
左大且渠都隆奇亡之右贤王所，其民尽降呼韩邪单于	呼韩邪单于回到王庭
呼韩单于归庭；数月，罢兵，使各归故地，乃收其兄呼屠吾斯在民间者，立为左谷蠡王，使人告右贤贵人，欲令杀右贤王	数月之后，将军队遣散，命各回本地，找到在民间的兄长呼屠吾斯，立为左谷蠡王，并派人煽动右贤王属下贵族，打算命其杀死右贤王
其冬，都隆奇与右贤王共立日逐王薄胥堂为屠耆单于，发兵数万人东袭呼韩邪单于，呼韩邪单于兵败走	这年冬天，都隆奇与右贤王共同拥立日逐王薄胥堂为屠耆单于，发兵数万向东进攻呼韩邪单于，呼韩邪单于军队败逃
屠耆单于还，以其长子都涂吾西为左谷蠡王，少子姑瞀楼头为右谷蠡王，留居单于庭	屠耆单于返回本地，立其长子都涂吾西为左谷蠡王，小儿子姑瞀楼头为右谷蠡王，命二人留居单于王庭
	五凤元年
春，正月，上幸甘泉，郊泰	春季，正月，汉宣帝前往甘泉，在泰祭祀天神
皇太子冠	皇太子刘举行加冠典礼
冬，十有二月，乙酉朔，日有食之	冬季，十二月乙酉朔，出现日食
春，正月，上幸甘泉，郊泰	春季，正月，汉宣帝前往甘泉，在泰祭祀天神
车骑将军韩增薨	车骑将军韩增去世
五月，将军许延寿为大司马、车骑大将军	五月，将军许延寿被任命为大司马、车骑大将军
丞相丙吉年老，上重之	丞相丙吉年事已高，汉宣帝很尊重他
萧望之意常轻吉，上由是不悦	萧望之常轻视丙吉，汉宣帝对此很不高兴
丞相司直奏望之遇丞相礼节倨慢，又使吏买卖，私所附益凡十万三千，请逮捕系治	丞相司直上奏弹劾萧望之，说他对丞相时傲慢无礼，又曾派属下官吏给自己家买卖东西，被派者私下贴钱共十万三千，请求将萧望之逮捕治罪
秋，八月，壬午，诏左迁望之为太子太傅；以太子太傅黄霸为御史大夫	秋季，八月壬午，汉宣帝下诏将萧望之降为太子太傅，任命太子太傅黄霸为御史大夫
春，正月，癸卯，博阳定侯丙吉薨	春季，正月癸卯，博阳侯丙吉去世
三月，上幸河东，祠后土	三月，汉宣帝巡游河东郡，祭祀后土神
减天下口钱；赦天下殊死以下	下诏减少天下人头税，赦免天下死刑以下罪犯
六月，辛酉，以西河太守杜延年为御史大夫	六月辛酉，汉宣帝任命西河太守杜延年为御史大夫
置西河、北地属国以处匈奴降者	设置西河、北地属国，以安置归降汉朝的匈奴人
广陵厉王胥使巫李女须祝诅上，求为天子	广陵王刘胥让巫师李女须诅咒汉宣帝，求神灵保佑他自己作皇帝
事觉，药杀巫及宫人二十余人以绝口	此事被人发觉，刘胥用毒药将巫师李女须以及宫女二十余人毒死，企图杀人灭口
公卿请诛胥	公卿大臣请求将刘胥处死
	四年
春，胥自杀	春季，刘胥自杀
匈奴单于称臣，遣弟右谷蠡王入侍	匈奴单于向汉朝称臣，派其弟右谷蠡王到长安来充当人质
以边塞亡寇，减戍卒什二	汉朝因边塞地区没有了外族入侵的战事，将屯戍兵卒减少十分之二
大司农中丞耿寿昌奏言：岁数丰穰，谷贱，农人少利	大司农中丞耿寿昌上奏说：连续几年丰收，谷价低，农民获利少
故事：岁漕关东谷四百万斛以给京师，用卒六万人	按以往惯例，每年从函谷关以东地区运输粮食四百万斛以供应京师，需用运粮卒六万人
宜籴三辅、弘农、河东、上党、太原郡谷，足供京师，可以省关东漕卒过半	应从三辅、弘农、河东、上党、太原等郡购买粮食，以供应京师，可以节省函谷关以东运粮卒一半以上
上从其计	汉宣帝接受了耿寿昌的建议
寿昌又白：令边郡皆筑仓，以谷贱增其贾而籴，谷贵时减贾而粜，名曰常平仓	耿寿昌又禀告说：命令沿边各郡一律修建粮仓，在粮价低时加价买进，粮价高时减价售出，名为常平仓
民便之	百姓因此受益
上乃下诏赐寿昌爵关内侯	汉宣帝于是下诏赐耿寿昌关内侯爵
夏，四月，辛丑朔，日有食之	夏季，四月辛丑朔，出现日食
匈奴闰振单于率其众东击郅支单于	匈奴闰振单于率领军队向东进攻郅支单于
郅支与战，杀之，并其兵；遂进攻呼韩邪	郅支单于与其交战，杀死闰振单于，兼并了闰振单于的军队，于是进攻呼韩邪单于
呼韩邪兵败走，郅支都单于庭	呼韩邪单于兵败退走，郅支单于建都单于王庭
	甘露元年
春，正月，行幸甘泉，郊泰	春季，正月，汉宣帝前往甘泉，在泰祭祀天神
皇太子柔仁好儒，见上所用多文法吏，以刑绳下，常侍燕从容言：陛下持刑太深，宜用儒生	皇太子刘性格温柔仁厚，喜欢儒家经术，看到汉宣帝任用的官员大多为精通法令的人，依靠刑法控制臣下，曾在陪侍汉宣帝进餐的时候，从容进言说：陛下过于依赖刑法，应重用儒生
帝作色曰：汉家自有制度，本以霸王道杂之；柰何纯任德教，用周政乎	汉宣帝生气地说：我大汉自有大汉的制度，本来就是王道与霸道兼用，怎能像周朝那样，纯用所谓礼义教化呢
且俗儒不过时宜，好是古非今，使人眩于名实，不知所守，何足委任	况且俗儒不识时务，喜欢肯定古人古事，否定今人今事，使人分不清何为名，何为实，不知所守，怎能委以重任
乃叹曰：乱我家者太子也	于是叹息道：败坏我家基业的人将是太子
匈奴呼韩邪单于之败也，左伊秩訾王为呼韩邪计，劝令称臣入朝事汉，从汉求助，如此，匈奴乃定	匈奴呼韩邪单于被郅支单于打败之后，左伊秩訾王为呼韩邪单于出谋划策，劝他称臣归附汉朝，请求汉朝帮助，这样做了，才能平定匈奴内乱
呼韩邪问诸大臣，皆曰：不可	呼韩邪单于征求各位大臣的意见，都说：不行
匈奴之俗，本上气力而下服役，以马上战斗为国，故有威名于百蛮	我们匈奴的风俗，历来崇尚力量，耻于在下面服侍别人，靠马上征战建立国家，所以威名才传遍蛮夷各国
战死，壮士所有也	战死沙场，是壮士的本分
今兄弟争国，不在兄则在弟，虽死犹有威名，子孙常长诸国	如今我们内部兄弟争国，不是哥哥得到，就是弟弟得到，即使战死，仍有威名，子孙永远统辖蛮夷各国
汉虽强，犹不能兼并匈奴；柰何乱先古之制，臣事于汉，卑辱先单于，为诸国所笑	汉朝虽然强大，仍不能吞并匈奴，我们为何败坏先祖的制度，向汉朝称臣，使历代先王蒙受羞辱，被各国耻笑
虽如是而安，何以复长百蛮	即使能因此而得到安定，又怎能再统辖蛮夷各国
左伊秩訾曰：不然，强弱有时	左伊秩訾王说道：不对，强弱之势，随时间的推移而改变
今汉方盛，乌孙城郭诸国皆为臣妾	如今汉朝正当兴盛，乌孙等城邦国家都已向汉朝称臣
自且侯单于以来，匈奴日削，不能取复，虽屈强于此，未尝一日安也	我国自且侯单于以来，势力日益削减，不能恢复，尽管倔强至今，却未曾有一天安宁
今事汉则安存，不事则危亡，计何以过此	而今，称臣于汉，则得以安全生存；如果不肯屈服，必陷于危亡境地
诸大人相难久之	还有什么计策比这更好呢
呼韩邪从其计，引众南近塞，遣子右贤王铢娄渠堂入侍	各位大臣不断对左伊秩訾王提出诘难，最后，呼韩邪单于终于接受了左伊秩訾王的建议，率众南下，向汉朝边塞靠近，派其子右贤王铢娄渠堂到长安做人质
郅支单于亦遣子右大将驹于利受入侍	郅支单于也派其子右大将驹于利受到长安做人质
二月，丁巳，乐成敬侯许延寿薨	二月丁巳，乐成侯许延寿去世
夏，四月，黄龙见新丰	夏季，四月，在新丰发现黄龙
春，正月，立皇子嚣为定陶王	春季，正月，汉宣帝立皇子刘嚣为定陶王
诏赦天下，减民算三十	汉宣帝颁布诏书，大赦天下，减少百姓的人头税三十钱
珠崖郡反	珠崖郡造反
夏，四月，遣护军都尉张禄将兵击之	夏季，四月，汉宣帝派护军都尉张禄率兵镇压
杜延年以老病免	杜延年因年老多病，被免除职务
五月，己丑，廷尉于定国为御史大夫	五月己丑，廷尉于定国被任命为御史大夫
冬，十二月，上行幸阳宫、属玉观	冬季，十二月，汉宣帝巡游阳宫、属玉观
匈奴呼韩邪单于款五原塞，愿奉国珍，朝三年正月	匈奴呼韩邪单于抵达五原边塞，表示愿奉献本国珍宝，于甘露三年正月来长安朝见汉宣帝
诏有司议其仪	汉宣帝下诏命主管官员商议朝见仪式
丞相、御史曰：圣王之制，先京师而后诸夏，先诸夏而后夷狄	丞相、御史大夫都说：依古代圣王的制度，先京师而后诸侯，先诸侯而后夷狄
匈奴单于朝贺，其礼仪宜如诸侯王，位次在下	匈奴单于前来朝贺，其礼仪应与诸侯王相同，位次排在诸侯王之后
太子太傅萧望之以为：单于非正朔所加，故称敌国，宜待以不臣之礼，位在诸侯王上	太子太傅萧望之认为：单于不奉汉朝正朔，本不是我国的臣属，所以称为匹敌之国，应不用臣属的礼仪对待他，使其位次在诸侯王之上
外夷稽首称藩，中国让而不臣，此则羁縻之谊，谦亨之福也	外夷向我国低头，自愿居于藩属地位；我国谦让，不以臣属之礼对待他，为的是笼络于他，显示我国的谦虚大度
《书》曰：戎狄荒服，言其来服荒忽亡常	《尚书》有言：戎狄外族很难驯服，说明外夷的归附反复无常
如使匈奴后嗣卒有鸟窜鼠伏，阙于朝享，不为畔臣，万世之长策也	如果将来匈奴的后代子孙突然像飞鸟远窜、老鼠潜伏一般不再前来朝见进贡，也不算我国的背叛之臣，这才是万代的长远策略
天子采之，下诏曰：匈奴单于称北蕃，朝正朔	汉宣帝采纳了萧望之的意见，下诏说：匈奴单于自称我国北方藩属，将于明年正月初一前来朝见
朕之不德，不能弘覆	朕的恩德不够，不能受此隆重大礼
其以客礼待之，令单于位在诸侯王上，赞谒称臣而不名	应以国宾之礼相待，使单于的位次在诸侯王之上，拜谒时只称臣，不具名
诏遣车骑都尉韩昌迎单于，发所过七郡二千骑为陈道上	汉宣帝下诏派车骑都尉韩昌前去迎接单于，征调沿途七郡二千名骑兵陈列于道旁
	三年
春，正月，上行幸甘泉，郊泰	春季，正月，汉宣帝前往甘泉，在泰祭祀天神
凤皇集新蔡	凤凰飞集新蔡县
三月，己巳，建成安侯黄霸薨	三月己巳，建成侯黄霸去世
五月，甲午，于定国为丞相，封西平侯	五月甲午，于定国被任命为丞相，封西平侯
太仆沛郡陈万年为御史大夫	太仆沛郡人陈万年任御史大夫
诏诸儒讲五经同异，萧望之等平奏其议，上亲称制临决焉	汉宣帝下诏命儒家学者们讲述他们对五经的解释的相同和不同之处，由萧望之等公平上奏，再由汉宣帝亲自出席作出裁决
乃立梁丘《易》、大小夏侯《尚书》、梁《春秋》博士	结果，决定以梁丘贺注解的《易经》、夏侯胜、夏侯建注解的《尚书》、梁赤注解的《春秋》作为标准本，分别设置博士
夏，广川王海阳坐禽兽行、贼杀不辜废，徙房陵	夏季，广川王刘海阳，因被指控行为如同禽兽，残杀无辜，废去王爵，迁徙到房陵县
冬，十月，未央宫宣室阁火	冬季，十月，未央宫宣室阁失火
是岁，徙定陶王嚣为楚王	这一年，汉宣帝将定陶王刘嚣改封为楚王
匈奴呼韩邪、郅支两单于俱遣使朝献，汉待呼韩邪使有加焉	匈奴呼韩邪、郅支两单于都派使臣前来朝贡汉朝，对待呼韩邪单于的使臣优于郅支单于的使臣
	黄龙元年
春，正月，上行幸甘泉，郊泰	春季，正月，汉宣帝前往甘泉，在泰祭祀天神
三月，有星孛于王良、阁道，入紫微宫	三月，有异星出现于王良星、阁道星座，进入紫微星座
帝寝疾，选大臣可属者，引外属侍中乐陵侯史高、太子太傅萧望之、少傅周堪至禁中，拜高为大司马、车骑将军，望之为前将军、光禄勋，堪为光禄大夫，皆受遗诏辅政，领尚书事	汉宣帝卧病在床，挑选可以嘱托后事的大臣，召外戚侍中乐陵侯史高、太子太傅萧望之、少傅周堪来到宫中，任命史高为大司马、车骑将军、萧望之为前将军、光禄勋，周堪为光禄大夫，共同接受遗诏，辅佐朝政，主管尚书事务
冬，十二月，甲戌，帝崩于未央宫	冬季，十二月甲戌，汉宣帝在未央宫驾崩
癸巳，太子即皇帝位，谒高庙，尊皇太后曰太皇太后，皇后曰皇太后	癸巳，皇太子刘即皇帝位，拜谒汉高祖祭庙，尊皇太后为太皇太后，皇后为皇太后
春，二月，以凤皇、甘露降集京师，赦天下	春季，二月，长安有凤凰飞集、甘露降落，因而大赦天下
五月，匈奴单于遣弟呼留若王胜之来朝	五月，匈奴单于派其弟呼留若王胜之前来朝见汉宣帝
冬，十月，凤皇十一集杜陵	冬季，十月，十一只凤凰飞集杜陵
匈奴握衍朐单于暴虐，好杀伐，国中不附	匈奴握衍朐单于暴虐凶残，好杀人，全国上下都离心离德
及太子、左贤王数谗左地贵人，左地贵人皆怨	太子、左贤王又多次诬陷东部地区的贵族，这些人全都感到怨恨
会乌桓击匈奴东边姑夕王，颇得人民，单于怒	正在此时，乌桓派兵袭击居于匈奴东部边疆的姑夕王，获得大批人口，单于很恼怒
姑夕王恐，即与乌禅幕及左地贵人共立稽侯为呼韩邪单于，发左地兵四五万人，西击握衍朐单于，至姑且水北	姑夕王害怕单于降罪，便与乌禅幕及东部地区贵族一同拥立稽侯为呼韩邪单于，并征发东部地区军队四五万人，向西进攻握衍朐单于，直抵姑且水北岸
未战，握衍朐单于兵败走，使人报其弟右贤王曰：匈奴共攻我，若肯发兵助我乎	尚未交战，握衍朐单于的军队已先行败逃，派人通知其弟右贤王说：匈奴人一起攻击我，你肯发兵帮助我吗
右贤王曰：或不爱人，杀昆弟、诸贵人	右贤王说：你不爱惜别人，屠杀兄弟和各位贵族，你就死在自己那里吧，不要来玷污我
各自死若处，无来污我	握衍朐单于感到愤恨，自杀而死
握衍朐单于恚，自杀	左大且渠都隆奇逃到右贤王住地，属下部众全部归降呼韩邪单于
左大且渠都隆奇亡之右贤王所，其民尽降呼韩邪单于	呼韩邪单于回到王庭
呼韩单于归庭；数月，罢兵，使各归故地，乃收其兄呼屠吾斯在民间者，立为左谷蠡王，使人告右贤贵人，欲令杀右贤王	数月之后，将军队遣散，命各回本地，找到在民间的兄长呼屠吾斯，立为左谷蠡王，并派人煽动右贤王属下贵族，打算命其杀死右贤王
其冬，都隆奇与右贤王共立日逐王薄胥堂为屠耆单于，发兵数万人东袭呼韩邪单于，呼韩邪单于兵败走	这年冬天，都隆奇与右贤王共同拥立日逐王薄胥堂为屠耆单于，发兵数万向东进攻呼韩邪单于，呼韩邪单于军队败逃
屠耆单于还，以其长子都涂吾西为左谷蠡王，少子姑瞀楼头为右谷蠡王，留居单于庭	屠耆单于返回本地，立其长子都涂吾西为左谷蠡王，小儿子姑瞀楼头为右谷蠡王，命二人留居单于王庭
	五凤元年
春，正月，上幸甘泉，郊泰	春季，正月，汉宣帝前往甘泉，在泰祭祀天神
皇太子冠	皇太子刘举行加冠典礼
冬，十有二月，乙酉朔，日有食之	冬季，十二月乙酉朔，出现日食
春，正月，上幸甘泉，郊泰	春季，正月，汉宣帝前往甘泉，在泰祭祀天神
车骑将军韩增薨	车骑将军韩增去世
五月，将军许延寿为大司马、车骑大将军	五月，将军许延寿被任命为大司马、车骑大将军
丞相丙吉年老，上重之	丞相丙吉年事已高，汉宣帝很尊重他
萧望之意常轻吉，上由是不悦	萧望之常轻视丙吉，汉宣帝对此很不高兴
丞相司直奏望之遇丞相礼节倨慢，又使吏买卖，私所附益凡十万三千，请逮捕系治	丞相司直上奏弹劾萧望之，说他对丞相时傲慢无礼，又曾派属下官吏给自己家买卖东西，被派者私下贴钱共十万三千，请求将萧望之逮捕治罪
秋，八月，壬午，诏左迁望之为太子太傅；以太子太傅黄霸为御史大夫	秋季，八月壬午，汉宣帝下诏将萧望之降为太子太傅，任命太子太傅黄霸为御史大夫
春，正月，癸卯，博阳定侯丙吉薨	春季，正月癸卯，博阳侯丙吉去世
三月，上幸河东，祠后土	三月，汉宣帝巡游河东郡，祭祀后土神
减天下口钱；赦天下殊死以下	下诏减少天下人头税，赦免天下死刑以下罪犯
六月，辛酉，以西河太守杜延年为御史大夫	六月辛酉，汉宣帝任命西河太守杜延年为御史大夫
置西河、北地属国以处匈奴降者	设置西河、北地属国，以安置归降汉朝的匈奴人
广陵厉王胥使巫李女须祝诅上，求为天子	广陵王刘胥让巫师李女须诅咒汉宣帝，求神灵保佑他自己作皇帝
事觉，药杀巫及宫人二十余人以绝口	此事被人发觉，刘胥用毒药将巫师李女须以及宫女二十余人毒死，企图杀人灭口
公卿请诛胥	公卿大臣请求将刘胥处死
	四年
春，胥自杀	春季，刘胥自杀
匈奴单于称臣，遣弟右谷蠡王入侍	匈奴单于向汉朝称臣，派其弟右谷蠡王到长安来充当人质
以边塞亡寇，减戍卒什二	汉朝因边塞地区没有了外族入侵的战事，将屯戍兵卒减少十分之二
大司农中丞耿寿昌奏言：岁数丰穰，谷贱，农人少利	大司农中丞耿寿昌上奏说：连续几年丰收，谷价低，农民获利少
故事：岁漕关东谷四百万斛以给京师，用卒六万人	按以往惯例，每年从函谷关以东地区运输粮食四百万斛以供应京师，需用运粮卒六万人
宜籴三辅、弘农、河东、上党、太原郡谷，足供京师，可以省关东漕卒过半	应从三辅、弘农、河东、上党、太原等郡购买粮食，以供应京师，可以节省函谷关以东运粮卒一半以上
上从其计	汉宣帝接受了耿寿昌的建议
寿昌又白：令边郡皆筑仓，以谷贱增其贾而籴，谷贵时减贾而粜，名曰常平仓	耿寿昌又禀告说：命令沿边各郡一律修建粮仓，在粮价低时加价买进，粮价高时减价售出，名为常平仓
民便之	百姓因此受益
上乃下诏赐寿昌爵关内侯	汉宣帝于是下诏赐耿寿昌关内侯爵
夏，四月，辛丑朔，日有食之	夏季，四月辛丑朔，出现日食
匈奴闰振单于率其众东击郅支单于	匈奴闰振单于率领军队向东进攻郅支单于
郅支与战，杀之，并其兵；遂进攻呼韩邪	郅支单于与其交战，杀死闰振单于，兼并了闰振单于的军队，于是进攻呼韩邪单于
呼韩邪兵败走，郅支都单于庭	呼韩邪单于兵败退走，郅支单于建都单于王庭
	甘露元年
春，正月，行幸甘泉，郊泰	春季，正月，汉宣帝前往甘泉，在泰祭祀天神
皇太子柔仁好儒，见上所用多文法吏，以刑绳下，常侍燕从容言：陛下持刑太深，宜用儒生	皇太子刘性格温柔仁厚，喜欢儒家经术，看到汉宣帝任用的官员大多为精通法令的人，依靠刑法控制臣下，曾在陪侍汉宣帝进餐的时候，从容进言说：陛下过于依赖刑法，应重用儒生
帝作色曰：汉家自有制度，本以霸王道杂之；柰何纯任德教，用周政乎	汉宣帝生气地说：我大汉自有大汉的制度，本来就是王道与霸道兼用，怎能像周朝那样，纯用所谓礼义教化呢
且俗儒不过时宜，好是古非今，使人眩于名实，不知所守，何足委任	况且俗儒不识时务，喜欢肯定古人古事，否定今人今事，使人分不清何为名，何为实，不知所守，怎能委以重任
乃叹曰：乱我家者太子也	于是叹息道：败坏我家基业的人将是太子
匈奴呼韩邪单于之败也，左伊秩訾王为呼韩邪计，劝令称臣入朝事汉，从汉求助，如此，匈奴乃定	匈奴呼韩邪单于被郅支单于打败之后，左伊秩訾王为呼韩邪单于出谋划策，劝他称臣归附汉朝，请求汉朝帮助，这样做了，才能平定匈奴内乱
呼韩邪问诸大臣，皆曰：不可	呼韩邪单于征求各位大臣的意见，都说：不行
匈奴之俗，本上气力而下服役，以马上战斗为国，故有威名于百蛮	我们匈奴的风俗，历来崇尚力量，耻于在下面服侍别人，靠马上征战建立国家，所以威名才传遍蛮夷各国
战死，壮士所有也	战死沙场，是壮士的本分
今兄弟争国，不在兄则在弟，虽死犹有威名，子孙常长诸国	如今我们内部兄弟争国，不是哥哥得到，就是弟弟得到，即使战死，仍有威名，子孙永远统辖蛮夷各国
汉虽强，犹不能兼并匈奴；柰何乱先古之制，臣事于汉，卑辱先单于，为诸国所笑	汉朝虽然强大，仍不能吞并匈奴，我们为何败坏先祖的制度，向汉朝称臣，使历代先王蒙受羞辱，被各国耻笑
虽如是而安，何以复长百蛮	即使能因此而得到安定，又怎能再统辖蛮夷各国
左伊秩訾曰：不然，强弱有时	左伊秩訾王说道：不对，强弱之势，随时间的推移而改变
今汉方盛，乌孙城郭诸国皆为臣妾	如今汉朝正当兴盛，乌孙等城邦国家都已向汉朝称臣
自且侯单于以来，匈奴日削，不能取复，虽屈强于此，未尝一日安也	我国自且侯单于以来，势力日益削减，不能恢复，尽管倔强至今，却未曾有一天安宁
今事汉则安存，不事则危亡，计何以过此	而今，称臣于汉，则得以安全生存；如果不肯屈服，必陷于危亡境地
诸大人相难久之	还有什么计策比这更好呢
呼韩邪从其计，引众南近塞，遣子右贤王铢娄渠堂入侍	各位大臣不断对左伊秩訾王提出诘难，最后，呼韩邪单于终于接受了左伊秩訾王的建议，率众南下，向汉朝边塞靠近，派其子右贤王铢娄渠堂到长安做人质
郅支单于亦遣子右大将驹于利受入侍	郅支单于也派其子右大将驹于利受到长安做人质
二月，丁巳，乐成敬侯许延寿薨	二月丁巳，乐成侯许延寿去世
夏，四月，黄龙见新丰	夏季，四月，在新丰发现黄龙
春，正月，立皇子嚣为定陶王	春季，正月，汉宣帝立皇子刘嚣为定陶王
诏赦天下，减民算三十	汉宣帝颁布诏书，大赦天下，减少百姓的人头税三十钱
珠崖郡反	珠崖郡造反
夏，四月，遣护军都尉张禄将兵击之	夏季，四月，汉宣帝派护军都尉张禄率兵镇压
杜延年以老病免	杜延年因年老多病，被免除职务
五月，己丑，廷尉于定国为御史大夫	五月己丑，廷尉于定国被任命为御史大夫
冬，十二月，上行幸阳宫、属玉观	冬季，十二月，汉宣帝巡游阳宫、属玉观
匈奴呼韩邪单于款五原塞，愿奉国珍，朝三年正月	匈奴呼韩邪单于抵达五原边塞，表示愿奉献本国珍宝，于甘露三年正月来长安朝见汉宣帝
诏有司议其仪	汉宣帝下诏命主管官员商议朝见仪式
丞相、御史曰：圣王之制，先京师而后诸夏，先诸夏而后夷狄	丞相、御史大夫都说：依古代圣王的制度，先京师而后诸侯，先诸侯而后夷狄
匈奴单于朝贺，其礼仪宜如诸侯王，位次在下	匈奴单于前来朝贺，其礼仪应与诸侯王相同，位次排在诸侯王之后
太子太傅萧望之以为：单于非正朔所加，故称敌国，宜待以不臣之礼，位在诸侯王上	太子太傅萧望之认为：单于不奉汉朝正朔，本不是我国的臣属，所以称为匹敌之国，应不用臣属的礼仪对待他，使其位次在诸侯王之上
外夷稽首称藩，中国让而不臣，此则羁縻之谊，谦亨之福也	外夷向我国低头，自愿居于藩属地位；我国谦让，不以臣属之礼对待他，为的是笼络于他，显示我国的谦虚大度
《书》曰：戎狄荒服，言其来服荒忽亡常	《尚书》有言：戎狄外族很难驯服，说明外夷的归附反复无常
如使匈奴后嗣卒有鸟窜鼠伏，阙于朝享，不为畔臣，万世之长策也	如果将来匈奴的后代子孙突然像飞鸟远窜、老鼠潜伏一般不再前来朝见进贡，也不算我国的背叛之臣，这才是万代的长远策略
天子采之，下诏曰：匈奴单于称北蕃，朝正朔	汉宣帝采纳了萧望之的意见，下诏说：匈奴单于自称我国北方藩属，将于明年正月初一前来朝见
朕之不德，不能弘覆	朕的恩德不够，不能受此隆重大礼
其以客礼待之，令单于位在诸侯王上，赞谒称臣而不名	应以国宾之礼相待，使单于的位次在诸侯王之上，拜谒时只称臣，不具名
诏遣车骑都尉韩昌迎单于，发所过七郡二千骑为陈道上	汉宣帝下诏派车骑都尉韩昌前去迎接单于，征调沿途七郡二千名骑兵陈列于道旁
	三年
春，正月，上行幸甘泉，郊泰	春季，正月，汉宣帝前往甘泉，在泰祭祀天神
凤皇集新蔡	凤凰飞集新蔡县
三月，己巳，建成安侯黄霸薨	三月己巳，建成侯黄霸去世
五月，甲午，于定国为丞相，封西平侯	五月甲午，于定国被任命为丞相，封西平侯
太仆沛郡陈万年为御史大夫	太仆沛郡人陈万年任御史大夫
诏诸儒讲五经同异，萧望之等平奏其议，上亲称制临决焉	汉宣帝下诏命儒家学者们讲述他们对五经的解释的相同和不同之处，由萧望之等公平上奏，再由汉宣帝亲自出席作出裁决
乃立梁丘《易》、大小夏侯《尚书》、梁《春秋》博士	结果，决定以梁丘贺注解的《易经》、夏侯胜、夏侯建注解的《尚书》、梁赤注解的《春秋》作为标准本，分别设置博士
夏，广川王海阳坐禽兽行、贼杀不辜废，徙房陵	夏季，广川王刘海阳，因被指控行为如同禽兽，残杀无辜，废去王爵，迁徙到房陵县
冬，十月，未央宫宣室阁火	冬季，十月，未央宫宣室阁失火
是岁，徙定陶王嚣为楚王	这一年，汉宣帝将定陶王刘嚣改封为楚王
匈奴呼韩邪、郅支两单于俱遣使朝献，汉待呼韩邪使有加焉	匈奴呼韩邪、郅支两单于都派使臣前来朝贡汉朝，对待呼韩邪单于的使臣优于郅支单于的使臣
	黄龙元年
春，正月，上行幸甘泉，郊泰	春季，正月，汉宣帝前往甘泉，在泰祭祀天神
三月，有星孛于王良、阁道，入紫微宫	三月，有异星出现于王良星、阁道星座，进入紫微星座
帝寝疾，选大臣可属者，引外属侍中乐陵侯史高、太子太傅萧望之、少傅周堪至禁中，拜高为大司马、车骑将军，望之为前将军、光禄勋，堪为光禄大夫，皆受遗诏辅政，领尚书事	汉宣帝卧病在床，挑选可以嘱托后事的大臣，召外戚侍中乐陵侯史高、太子太傅萧望之、少傅周堪来到宫中，任命史高为大司马、车骑将军、萧望之为前将军、光禄勋，周堪为光禄大夫，共同接受遗诏，辅佐朝政，主管尚书事务
冬，十二月，甲戌，帝崩于未央宫	冬季，十二月甲戌，汉宣帝在未央宫驾崩
癸巳，太子即皇帝位，谒高庙，尊皇太后曰太皇太后，皇后曰皇太后	癸巳，皇太子刘即皇帝位，拜谒汉高祖祭庙，尊皇太后为太皇太后，皇后为皇太后
春，二月，冯奉世还京师，更为左将军，赐爵关内侯	春季，二月，冯奉世回长安，调任左将军，封关内侯
三月，立皇子康为济阳王	三月，元帝赐封皇子刘康当济阳王
夏，四月，平昌考侯王接薨	夏季，四月，平昌侯王接去世
秋，七月，壬戌，以平恩侯许嘉为大司马、车骑将军	秋季，七月壬戌，任命平恩侯许嘉当大司马、车骑将军
冬，十一月，己丑，地震，雨水	冬季，十一月己丑，地震，降雨
春，二月，赦天下	春季，二月，大赦天下
三月，上行幸雍，祠五	三月，元帝前往雍城，祭祀五帝
夏，六月，甲戌，孝宣园东阙灾	夏季，六月甲戌，孝宣皇帝陵园东门失火
诸陵分属三辅	元帝下诏，各位皇帝的陵园，以其所在地区，分属三辅管理
以渭城寿陵亭部原上为初陵；诏勿置县邑及徙郡国民	在渭城寿陵亭部原上预设坟墓，下诏不要把它发展成为一个县，也不要强迫各郡、各封国移民到那里
	五年
春，正月，上行幸甘泉，郊泰	春季，正月，元帝前往甘泉，在泰祭祀天神
三月，幸河东，祠后土	三月，再往河东，祭祀后土神
秋，颍川水流杀人民	秋季，颍川郡水灾，淹死百姓
冬，上幸长杨射熊馆，大猎	冬季，元帝前往长杨宫射熊馆，大肆游猎
十二月，乙酉，毁太上皇、孝惠皇帝寝庙园，用韦玄成等之议也	十二月乙酉，元帝采用丞相韦玄成等的建议，下诏拆毁太上皇、孝惠皇帝的祭庙
春，正月，戊辰，陨石于梁	春季，正月戊辰，陨石坠在梁国
三月，上行幸雍，祠五	三月，元帝前往雍城，祭祀五帝
冬，河间王元坐贼杀不辜废，迁房陵	冬季，河间王刘元，被控残杀无罪之人，撤销爵位，贬逐房陵
罢孝文太后寝祠园	元帝下令撤除文帝母亲薄太后的陵园
春，正月，上行幸甘泉，郊泰	春季，正月，元帝前往甘泉，在泰祭祀天神
三月，行幸河东，祠后土	三月，前往河东，祭祀后土神
夏，四月，赦天下	夏季，四月，大赦天下
六月，立皇子兴为信都王	六月，元帝赐封皇子刘兴为信都王
八月，癸亥，以光禄勋匡衡为御史大夫	八月癸亥，元帝擢升光禄勋匡衡任御史大夫
闰月，丁酉，太皇太后上官氏崩	闰八月丁酉，上官太皇太后驾崩
冬，十一月，齐、楚地震，大雨雪，树折，屋坏	冬季，十一月，齐、楚地区地震，下大雪，树木折断，民房倒塌
	三年
夏，六月，甲辰，扶阳共侯韦玄成薨	夏季，六月甲辰丞相扶阳侯韦玄成去世
秋，七月，匡衡为丞相	秋季，七月，元帝擢升匡衡作丞相
戊辰，卫尉李延寿为御史大夫	戊辰，擢升卫尉李延寿当御史大夫
冬，使西域都护、骑都尉北地甘延寿、副校尉山阳陈汤共诛斩郅支单于于康居	冬季，命西域都护、骑都尉、北地郡人甘延寿，和副校尉、山阳郡人陈汤一同出兵，在康居王国斩杀郅支单于
春，三月，赦天下	春季，三月，大赦天下
夏，六月，庚申，复戾园	夏季，六月庚申恢复刘据的陵园戾园
壬申晦，日有食之	壬申晦，出现日食
是岁，徙济阳王康为山阳王	本年，元帝改封济阳王刘康为山阳王
皇太子冠	皇太子刘骜行加冠礼
二月，御史大夫李延寿卒	二月，御史大夫李延寿去世
河南太守九江召信臣为少府	河南郡太守九江人召信臣，被任命当少府
信臣先为南阳太守，后迁河南，治行常第一	召信臣原先是南阳郡太守，后来才调到河南郡，考绩在全国常常列于第一
视民如子，好为民兴利，躬劝耕稼，开通沟渎，户口增倍	他看待黎民跟看待儿女一样，热心为百姓谋求福利，亲自劝导人们务农，开凿疏通灌溉用的沟渠，使户口成倍增加
吏民亲爱，号曰召父	官员和平民都敬爱他，称他召父
癸卯，复孝惠皇帝寝庙园、孝文太后、孝昭太后寝园	三月癸卯，恢复孝惠皇帝祭庙陵园、孝文太后陵园、孝昭太后陵园
匡衡奏言：前以上体不平，故复诸所罢祠；卒不蒙福	丞相匡衡奏称：前些时，因为先帝身体不适，所以把废除的祭庙和陵园予以恢复，结果仍不能蒙受祖先的赐福
案卫思后、戾太子、戾后园，亲未尽	据查，卫思后陵园、戾太子陵园、戾后陵园，亲情未尽，不当撤除
孝惠、孝景庙，亲尽，宜毁	孝惠皇帝、孝景皇帝的祭庙，亲情已尽，应该撤除
及太上皇、孝文、孝昭太后、昭灵后、昭哀后、武哀王祠，请悉罢勿奉	至于太上皇、孝文帝、孝昭太后、昭灵后、昭哀王、武哀王的庙堂，也请一并撤除，不再奉祭
奏可	刘骜批准
六月，己未，太子即皇帝位，谒高庙	六月己未，太子刘骜即帝位，拜谒汉高祖的祭庙
尊皇太后曰太皇太后，皇后曰皇太后	尊祖母皇太后张氏太皇太后，尊母亲皇后王政君皇太后
以元舅侍中、卫尉、阳平侯王凤为大司马、大将军、领尚书事	任命大舅父侍中、卫尉、阳平侯王凤为大司马、大将军，主管尚书事务
秋，七月，丙戌，葬孝元皇帝于渭陵	秋季，七月丙戌，将元帝安葬于渭陵
大赦天下	大赦天下
春，正月，乙丑，悼考庙灾	春季，正月，乙丑，史皇孙刘进的祭庙发生火灾
立故河间王元弟上群库令良为河间王	汉成帝封已故河间王刘元的弟弟、上郡库令刘良为河间王
有星勃于营室	有异星出现于营、室二星旁
赦天下	大赦天下
八月，有两月相承，晨见东方	八月，清晨时，东方一上一下出现两个月亮
闰月，以渭城延陵亭部为初陵	闰正月，成帝下令在渭城延陵亭兴建自己的陵墓
三月，辛丑，上始祠后土于北郊	三月，辛丑，成帝初次在长安北郊祭祀后土
丙午，立皇后许氏	丙午，成帝立许氏为皇后
后，车骑将军嘉之女也	许后是车骑将军许嘉的女儿
元帝伤母恭哀后居位日浅而遭霍氏之辜，故选嘉女以配太子	汉元帝哀悼母亲恭哀后在位时间很短而惨遭霍氏毒手，因此特选许嘉之女婚配太子
夏，大旱	夏季，大旱
春，三月，赦天下徒	春季，三月，赦免天下囚犯
张谭坐选举不实，免	张谭因举荐人才不真实而获罪，被免去官职
冬，十月，光禄大夫尹忠为御史大夫	冬季，十月，擢升光禄大夫尹忠为御史大夫
越山崩	越发生山崩
丁丑，匡衡坐多取封邑四百顷，监临盗所主守直十金以上，免为庶人	丁丑，匡衡因多取封邑土地四百顷，及手下属官盗取所主管的财物价值十金以上而获罪，免官，贬为平民
	四年
春，正月，癸卯，陨石于亳四，陨于肥累二	春季，正月，癸卯，有四颗陨石在亳县坠落，有两颗陨石在肥累坠落
三月，甲申，以左将军乐昌侯王商为丞相	三月，甲申，任用左将军、乐昌侯王商为丞相
夏，四月，雨雪	夏季，四月，降雪
秋，桃、李实	秋季，桃树、李树结果
壬戌，以少府张忠为御史大夫	壬戌，任命少府张忠为御史大夫
上即位之初，丞相匡衡复奏：射声校尉陈汤以吏二千石奉使，颛命蛮夷中，不正身以先下，而盗所收康居财物，戒官属曰，绝域事不覆校	成帝即位初期，丞相匡衡再次上奏说：射声校尉陈汤，以二千石官员的身份出使西域，专门负责西域蛮夷事务，他不能持身以正，做部下的表率，反而盗取所没收的康居王国财物，并告诫下属官员说：远在外域发生的事，不会核察追究
虽在赦前，不宜处位	此事虽发生在大赦之前，但他已不适宜再担任官职
汤坐免	陈汤获罪被免官
春，杜钦荐犍为王延世于王凤，使塞决河	春季，杜钦向王凤推荐犍为人王延世，让他负责堵塞黄河决口的工程
凤以延世为河堤使者	王凤任命王延世为河堤使者
延世以竹落长四丈，大九围，盛以小石，两船夹载而下之	王延世命人用竹子编成长四丈，九人合抱那么大的竹笼，里面装上小石头，用两条船夹着搬运，沉入决口处
三十六日，河堤成	三十六天后，河堤修好
三月，诏以延世为光禄大夫，秩中二千石，赐爵关内侯、黄金百斤	三月，成帝下诏任命王延世为光禄大夫，官秩为中二千石，封为关内侯，赐黄金一百斤
给事中平陵平当上言：太上皇，汉之始祖，废其寝庙园，非是	给事中、平陵人平当上奏说：太上皇是汉王朝的始祖，废除他的祭庙墓园是不对的
上亦以无继嗣，遂纳当言	成帝也正在为没有继嗣而忧愁，就采纳了平当的建议
秋，九月，复太上皇寝庙园	秋季，九月，恢复了太上皇的墓园、祭庙
匈奴单于遣右皋林王伊邪莫演等奉献，朝正月	匈奴单于派右皋林王伊邪莫演等来朝进贡，并参加元旦的朝贺大典
	二年
夏，四月，楚国雨雹，大如釜	夏季，四月，楚国降下冰雹，大的如同饭锅
徙山阳王康为定陶王	改封山阳王刘康为定陶王
夜郎王兴、钩町王禹、漏卧侯俞更举兵相攻	夜郎王兴、钩町王禹、漏卧侯俞，先后起兵互相攻击
柯太守请发兵诛兴等	柯太守请求朝廷发兵讨伐兴等
议者以为道远不可击，乃遣太中大夫蜀郡张匡持节和解	朝廷会议时，发言的人认为路途太远，不可以动兵讨伐，于是派遣太中大夫、蜀郡人张匡持符节前往，劝说他们和解
兴等不从命，刻木象汉吏，立道旁，射之	兴等不听从命令，还用木头雕刻成汉朝官吏的形象，树立道旁，用箭射击
春，正月，楚王嚣来朝	春季，正月，楚王刘嚣到长安朝见
二月，乙亥，诏以嚣素行纯茂，特加显异，封其子勋为广戚侯	二月，乙亥，成帝下诏，因刘嚣一向行为良好，特意给予特殊奖赏，封他的儿子刘勋为广戚侯
丙戌，犍为地震，山崩，壅江水，水逆流	丙戌，犍为发生地震，引起山崩，壅塞了长江，使江水逆流
秋，八月，乙卯晦，日有食之	秋季，八月，乙卯晦，出现日食
上以中秘书颇散亡，使谒者陈农求遗书于天下	成帝因为皇宫藏书有许多已经散失，派谒者陈农到全国去搜求失传的书籍
诏光禄大夫刘向校经传、诸子、诗赋，步兵校尉任宏校兵书，太史令尹咸校数术，侍医李柱国校方技	诏令光禄大夫刘向校正经传、诸子、诗赋；步兵校尉任宏校正兵书；太史令尹咸校正占卜之书；侍医李柱国校正医药书
每一书已，向辄条其篇目，撮其指意，录而奏之	每一部书校正完毕，刘向就条列出它的篇目，写出内容摘要，呈报成帝
春，正月，匈奴单于来朝	春季，正月，匈奴单于来长安朝见
赦天下徒	赦免天下囚犯
三月，癸丑朔，日有食之	三月，癸丑朔，出现日食
上之为太子也	成帝当太子时，由莲勺人张禹教授《论语》，及至即位，赐张禹为关内侯，拜为诸吏、光禄大夫，官秩中二千石，兼任给事中，主管尚书事务
受《论语》于莲勺张禹，及即位，赐爵关内侯，拜为诸吏、光禄大夫，秩中二千石，给事中，领尚书事	张禹与王凤共同主管尚书事务，张禹内心不自安，多次称病，上书请求退休，想退让避开王凤
禹与王凤并领尚书，内不自安，数病，上书乞骸骨，欲退避凤；上不许，抚待愈厚	成帝不准，反而待他愈加优厚
六月，丙戌，以禹为丞相，封安昌侯	六月，丙戌，成帝任命张禹为丞相，封安昌侯
庚戌，楚孝王嚣薨	庚戌，楚孝王刘嚣去世
初，武帝通西域，宾自以绝远，汉兵不能至，独不服，数剽杀汉使	当初，汉武帝通西域，宾国自以为地处绝远，汉兵不能到达，因此只有宾一国不归顺汉朝，还多次劫杀汉使
久之，汉使者文忠与容屈王子阴末赴合谋攻杀其王；立阴末赴为宾王	很久以后，汉朝使者文忠与容屈国王的儿子阴末赴合谋攻杀了宾王，于是立阴末赴为宾王
后军候赵德使宾，与阴末赴相失；阴末赴锁琅当德，杀副已下七十余人，遣使者上书谢	后来，军候赵德出使宾国，与阴末赴失和，阴末赴用铁链把赵德锁起来，又诛杀汉副使及以下七十余人，然后派使者赴长安上书谢罪
孝元帝以其绝域，不录，放其使者于县度，绝而不通	孝元帝因宾远在域外，无法审核此案，就把使节放逐到县度，断绝与宾的来往
春，二月，丁未晦，日有食之	春季，二月，丁未晦，出现日食
三月，赦天下徒	三月，赦免天下囚犯
冬，京兆尹泰山王章下狱，死	冬季，京兆尹、泰山人王章被捕入狱，处死
春，三月，大赦天下	春季，三月，大赦天下
御史大夫张忠卒	御史大夫张忠去世
秋，关东大水	秋季，关东大水泛滥成灾
八月，甲申，定陶共王康薨	八月，甲申，定陶王刘康去世
春，三月，壬戌，陨石东郡八	春季，三月，壬戌，东郡坠落八块陨石
冬，十一月，丁卯，光禄勋于永为御史大夫	冬季，十一月，丁卯，任命光禄勋于永为御史大夫
永，定国之子也	于永是于定国的儿子
	四年
春，二月，赦天下	春季，二月，大赦天下
夏，四月，雨雪	夏季，四月，降雪
秋，九月，壬申，东平思王宇薨	秋季，九月，壬申，东平王刘宇去世
少府王骏为京兆尹	任命少府王骏为京兆尹
骏，吉之子也	王骏是王吉的儿子
先是，京兆有赵广汉、张敞、王尊、王章，至骏，皆有能名，故京师称曰：前有赵、张，后有三王	先前，担任过京兆尹的有赵广汉、张敞、王尊、王章，到王骏，全都以才干出名，因而京师人称赞说：前有赵、张，后有三王
闰月，壬戌，于永卒	闰十二月，壬戌，于永去世
春，正月，癸巳，以薛宣为御史大夫	春季，正月，癸巳，任命薛宣为御史大夫
三月，庚戌，张禹以老病罢，以列侯朝朔、望，位特进，见礼如丞相；赏赐前后数千万	三月，庚戌，张禹因年老多病免官，以列侯的身分，在每月一日、十五日朝见皇帝，并加位特进，朝见时的礼节一如丞相，前后赏赐数千万钱
冬，黄龙见真定	冬季，真定发现黄龙
春，上行幸云阳、甘泉	春季，成帝前往云阳、甘泉
五月，癸未，陨石于杜邮三	五月，癸未，杜邮坠落三颗陨石
六月，立中山宪王孙云客为广德王	六月，封中山宪王的孙子刘云客为广德王
是岁，城阳哀王云薨；无子，国除	本年，城阳王刘云去世，由于没有儿子，封国撤除
	三年
夏，四月，赦天下	夏季，四月，大赦天下
大旱	大旱
秋，八月，乙卯，孝景庙北阙灾	秋季，八月，乙卯，孝景帝祭庙北门失火
秋，勃海、清河、信都河水湓溢，灌县、邑三十一，败官亭、民舍四万余所	秋季，黄河在勃海、清河、信都泛滥成灾，淹没三十一个县、邑，冲毁官亭、民房四万余所
平陵李寻奏言：议者常欲求索九河故迹而穿之	平陵人李寻上奏说：讨论治河之策的人，总想寻找九河故道，按照故道挖掘治理
今因其自决，可且勿塞，以观水势；河欲居之，当稍自成川，跳出沙土	而今趁着黄河自己决口，可以暂时不堵塞缺口，以观察水的走势，要想让黄河有固定的水道，就应当让它自己逐渐形成河川，再沿河川挑出河床的沙土
然后顺天心而图之，必有成功，而用财力寡	然后按照上天的意愿加以规划治理，必能取得成功，而且所用财力、人力都可节省
于是遂止不塞	于是就停下来，不堵塞黄河缺口
朝臣数言百姓可哀，上遣使者处业振赡之	朝臣屡次提出灾区百姓处境悲惨，成帝派使者安置赈济灾区百姓
春，正月，癸丑，太官凌室火	春季，正月，癸丑，太官冰室发生火灾
戊午，戾后园南阙火	戊午，戾后陵园南门发生火灾
六月，丙寅，立皇后赵氏，大赦天下	六月，丙寅，成帝封赵飞燕为皇后，大赦天下
夏，大旱	夏季，大旱
四月，癸未，长乐临华殿、未央宫东司马门皆灾	四月，癸未，长乐宫临华殿和未央宫东司马门都发生火灾
六月，甲午，霸陵园门阙灾	六月，甲午，霸陵墓园门阙发生火灾
秋，七月，辛未晦，日有食之	秋季，七月，辛未晦，出现日食
冬，十一月，庚申，卫将军王商病免	冬季，十一月，庚申，卫将军王商因病免职
春，正月，己亥朔，日有食之	春季，正月，己亥朔，出现日食
壬戌，王商复为大司马、卫将军	壬戌，再次任命王商为大司马、卫将军
三月，上行幸雍，祠五	三月，成帝前往雍城，祭祀五
赦天下	大赦天下
秋，七月，有星孛于东井	秋季，七月，有异星出现于井宿
是岁，左将军辛庆忌卒	本年，左将军辛庆忌去世
庆忌为国虎臣，遭世承平，匈奴、西域亲附，敬其威信	辛庆忌是国家御敌的虎将，适逢天下承平之世，匈奴、西域都亲附中国，也都崇敬他的威信
	二年
夏，四月，立广陵孝王子守为王	夏季，四月，命广陵孝王的儿子刘守继承王位
二月，丙午，封淳于长为定陵侯	二月，丙午，封淳于长为定陵侯
三月，上行幸雍，祠五	三月，成帝前往雍城，在五祭祀
三月，上行幸河东，祠后土	三月，成帝前往河东，祭祀后土神
陨石于关东二	关东一带，坠落两颗陨石
春，正月，大赦天下	春季，正月，大赦天下
上行幸雍，祠五	成帝前往雍城，在五祭祀
秋，八月，庚戌，中山孝王兴薨	秋季，八月，庚戌，中山王刘兴去世
冬，十月，甲寅，王根病免	冬季，十月，甲寅，王根患病，被免去官职
丞相方进、大司空武奏言：《春秋》之义，用贵治贱，不以卑临尊	丞相翟方进、大司空何武奏称：《春秋》所昭示的大义，是用尊贵者治理卑贱者，而不是让卑贱者控制尊贵者
刺史位下大夫而临二千石，轻重不相准	刺史的职位是相当于下大夫的小官，却能够督察二千石官，轻重的标准不合
臣请罢刺史，更置州牧以应古制	我们请求撤销刺史，另行设置州牧，以合古制
十二月，罢刺史，更置州牧，秩二千石	十二月，下诏撤销刺史，改设州牧，官秩二千石
春，正月，上行幸甘泉，郊泰	春季，正月，成帝前往甘泉，在泰祭天
二月，壬子，丞相方进薨	二月，壬子，丞相翟方进去世
三月，上行幸河东，祠后土	三月，成帝前往河东，祭祀后土神
丙戌，帝崩于未央宫	丙戌，成帝在未央宫驾崩
是日，孔光于大行前拜受丞相、博山侯印绶	成帝驾崩当天，孔光在大行皇帝灵柩前，拜受丞相、博山侯印信、绶带
富平侯张放闻帝崩，思慕哭泣而死	富平侯张放听到成帝驾崩的消息，追思仰慕哭泣，悲痛而死
皇太后诏南、北郊长安如故	皇太后下诏：恢复长安南北郊祭祀天地大典
己卯，葬孝成皇帝于延陵	己卯，葬孝成皇帝于延陵
太皇太后令傅太后、丁姬十日一至未央宫	太皇太后下诏，命傅太后、丁姬每十天一次到未央宫探望皇帝
五月，丙戌，立皇后傅氏，傅太后从弟晏之子也	五月，丙戌，立傅氏为皇后，她是傅太后堂弟傅晏的女儿
春，正月，陨石于北地十六	春季，正月，北地坠落十六颗陨石
赦天下	大赦天下
司隶校尉解光奏言：臣闻许美人及故中宫史曹宫皆御幸孝成皇帝，产子；子隐不见	司隶校尉解光奏报说：我听说许美人和前中宫史曹宫，都曾蒙孝成皇帝召幸而生下儿子，而两个孩子下落不明
臣遣吏验问，皆得其状：元延元年，宫有身；其十月，宫乳掖庭牛官令舍	我派官员追查，他们都报告说：元延元年，曹宫怀孕，同年十月，在掖庭牛官令舍生下一个孩子
中黄门田客持诏记与掖庭狱丞籍武，令收置暴室狱	中黄门田客将皇帝手诏拿给掖庭狱丞籍武，命令他把曹宫关到暴室狱，并吩咐说：不许问她生的是男孩，还是女孩
毋问儿男、女，谁儿也	也不许问是谁的孩子
宫曰：善臧我儿胞	曹宫说：请把我儿子的胞衣好好藏起来，你知道我儿是什么人吗
丞知是何等儿也	三天后，田客又拿着皇帝手诏给籍武，并说：男孩死了没有
后三日，客持诏记与武，问：儿死未	籍武回答：没死
武对：未死	田客说：皇上和昭仪大怒，你为什么不动手杀掉
客曰：上与昭仪大怒，奈何不杀	籍武叩头大哭说：不杀这个男孩，自知难逃一死；杀了，也是死
武叩头啼曰：不杀儿，自知当死；杀之，亦死	便让田客代为呈递密封奏书，说：陛下还未有嗣子，儿子不分贵贱，请陛下留意三思
即因客奏封事曰：陛下未有继嗣，子无贵贱，唯留意	密奏呈上去后，田客又拿着皇帝的手诏来取走了孩子，把小孩交给中黄门王舜
奏入，客复持诏记取儿，付中黄门王舜	王舜接受手诏，把孩子带到宫中，为他挑选官婢张弃做乳娘，并告诉她说：好好喂养这个男孩，会有赏赐的
舜受诏，内儿殿中，为择乳母，告善养儿，且有赏，毋令漏泄	千万不可泄漏消息
舜择官婢张弃为乳母	三天后，田客又拿着皇帝的手诏和毒药，让曹宫自尽
后三日，客复持诏记并药以饮宫	曹宫说：果然，她姐妹俩想独擅天下
宫曰：果也欲姊弟擅天下	我的孩子，是个男孩，额上有壮发，跟他祖父孝元皇帝一样
我儿，男也，上有壮发，类孝元皇帝	现在我儿在哪里
今儿安在	她们会害他、杀他的
危杀之矣	怎样才能让太后知道呢
奈何令长信得闻之	遂饮毒药而死
遂饮药死	张弃喂养那个男孩，刚十一天，宫长李南就拿着皇帝的诏书，把孩子抱走了
弃所养儿，十一日，宫长李南以诏书取儿去，不知所置	此后就再不知下落
丁酉，光禄大夫傅喜为大司马，封高武侯	丁酉，任命光禄大夫傅喜为大司马，封高武侯
秋，九月，甲辰，陨石于虞二	秋季，九月，甲辰，虞地坠落两颗陨石
春，正月，有星孛于牵牛	春季，正月，有异星出现在牵牛星旁
秋，七月，以渭城西北原上永陵亭部为初陵，勿徙郡国民	秋季，七月，哀帝在渭城西北原上永陵亭一带修筑自己的陵墓，没有令郡国的百姓迁往陵区
春，正月，立广德夷王弟广汉为广平王	春季，正月，封广德夷王的弟弟刘广汉为广平王
帝太太后所居桂宫正殿火	帝太太后居住的桂宫正殿发生火灾
有星孛于河鼓	有异星出现于河鼓星旁
六月，立鲁顷王子部乡侯闵为王	六月，立鲁顷王的儿子部乡侯刘闵为王
春，正月，大旱	春季，正月，大旱
三月，诸吏、散骑、光禄勋贾延为御史大夫	三月，任命诸吏、散骑、光禄勋贾延为御史大夫
夏，六月，尊帝太太后为皇太太后	夏季，六月，尊帝太太后傅氏为皇太太后
秋，八月，辛卯，上下诏切责公卿曰：昔楚有子玉得臣，晋文公为之侧席而坐；近事，汲黯折淮南之谋	秋季，八月，辛卯，哀帝下诏严厉斥责公卿说：从前楚国有子玉得臣，晋文公为此忧愁得侧身而坐；近世有汲黯，挫败了淮南王的阴谋
今东平王云等至有图弑天子逆乱之谋者，是公卿股肱莫能悉心、务聪明以销厌未萌故也	而今东平王刘云等甚至有杀死天子反叛作乱的阴谋，这是身为国家栋梁的公卿们不能尽心职守、致力于察觉阴谋，以把祸患消灭在还未萌发阶段的缘故啊
赖宗庙之灵，侍中、驸马都尉贤等发觉以闻，咸伏厥辜	幸赖祖宗在天之灵的保，侍中、驸马都尉董贤等发觉以后报告了我，使奸人全部伏诛
《书》不云乎：用德章厥善	《书经》不是说吗，用恩德表彰善行
其封贤为高安侯，南阳太守宠为方阳侯，左曹、光禄大夫躬为宜陵侯，赐右师谭爵关内侯	现封董贤为高安侯，南阳太守孙宠为方阳侯，左曹、光禄大夫息夫躬为宜陵侯，赐右师谭爵位关内侯
又封傅太后同母弟郑恽子业为阳信侯	又封傅太后同母弟傅郑恽的儿子傅业为阳信侯
息夫躬既亲近，数进见言事，议论无所避，上疏历诋公卿大臣	息夫躬既蒙哀帝亲近，就频繁进见哀帝言事，议论无所避讳顾忌，上书逐个诋毁公卿大臣
众畏其口，见之仄目	百官畏其口舌，遇见他不敢正眼相看
春，正月，辛丑朔，诏将军、中二千石举明习兵法者各一人，因就拜孔乡侯傅晏为大司马、卫将军，阳安侯丁明为大司马、票骑将军	春季，正月，辛丑朔，哀帝下诏，要求将军、中二千石官员，各推举通晓军事、熟悉兵法者一人，借此授任孔乡侯傅晏为大司马、卫将军，阳安侯丁明为大司马、票骑将军
丁巳，皇太太后傅氏崩，合葬渭陵，称孝元傅皇后	丁巳，皇太太后傅氏驾崩，与元帝合葬渭陵，称为孝元傅皇后
八月，何武徙为前将军	八月，调任何武为前将军
辛卯，光禄大夫彭宣为御史大夫	辛卯，任命光禄大夫彭宣为御史大夫
司隶鲍宣坐摧辱丞相，拒闭使者，无人臣礼，减死髡钳	司隶鲍宣因折辱丞相，闭门拒绝使者，违背臣子之礼而获罪，被减免死罪，剃发，身带刑具服役
冬，十一月，壬午，以故定陶太傅、光禄大夫韦赏为大司马、车骑将军	冬季，十一月，壬午，任用前定陶国太傅、光禄大夫韦赏为大司马、车骑将军
己丑，赏卒	己丑，韦赏去世
夏，四月，壬辰晦，日有食之	夏季，四月，壬辰晦，出现日食
五月，甲子，正三公官分职	五月，甲子，正式确定三公官名和各自的分工职掌
大司马、卫将军董贤为大司马；丞相孔光为大司徒；彭宣为大司空，封长平侯	任命大司马、卫将军董贤为大司马；丞相孔光为大司徒；彭宣为大司空，封长平侯
六月，戊午，帝崩于未央宫	六月，戊午，哀帝在未央宫驾崩
八月，莽复白太复太后，废孝成皇后、孝哀皇后为庶人，就其园	八月，王莽再次上奏太皇太后，要求废黜孝成皇后、孝哀皇后，贬为平民，遣送到成帝和哀帝的陵园守墓
是日，皆自杀	当天，两位皇后都自杀子
戊午，右将军王崇为大司空，光禄勋东海马宫为右将军，左曹、中郎将甄丰为光禄勋	戊午，任命右将军王崇为大司空，光禄勋、东海人马宫为右将军，左曹、中郎将甄丰为光禄勋
九月，辛酉，中山王即皇帝位，大赦天下	九月，辛酉，中山王刘箕子即帝位，大赦天下
冬，十月，壬寅，葬孝哀皇帝于义陵	冬季，十月，壬寅，将孝哀皇帝安葬在义陵
	孝平皇帝上元始元年
置羲和官，秩二千石	设置羲和官，官秩为二千石
夏，五月，丁巳朔，日有食之	夏季，五月，丁巳朔，出现日食
大赦天下	大赦天下
公卿以下举敦厚能直言者各一人	让公卿及以下官员举荐：敦厚和直言各一名
秋，九月，赦天下徒	秋季，九月，赦免天下囚犯
	二年
春，黄支国献犀牛	春季，黄支国贡献犀牛
黄支在南海中，去京师三万里	黄支国在南海，距京师三万里
王莽欲威德，故厚遗其王，令遣使贡献	王莽想要炫耀他的威望和盛德，所以先向黄支国王赠送厚重的礼物，让国王派遣使节到长安贡献
帝更名	平帝改名为刘
三月，癸酉，大司空王崇谢病免，以避王莽	三月，癸酉，大司空王崇为了避开王莽，称病要求辞职，被免去官职
六月，陨石于钜鹿二	六月，两颗陨石坠落在钜鹿
光禄大夫楚国龚胜、太中大夫琅邪邴汉以王莽专政，皆乞骸骨	光禄大夫楚国人龚胜、太中大夫琅邪人邴汉，因为王莽专权，都请求辞职退休
莽令太后策诏之曰：朕愍以官职之事烦大夫，大夫其修身守道，以终高年	王莽教太后下策书诏令他们说：朕不忍心用官职上的事务烦扰两位大夫，你们就好自为之，修养品德，严守正道，以终高年吧
皆加优礼而遣之	对他们都给予优厚的待遇，遣送回家
梅福知王莽必篡汉祚，一朝弃妻子去，不知所之	梅福知道王莽必定要篡夺汉朝皇位，有一天，忽然抛弃妻子而走开，不知到什么地方去了
其后，人有见福于会稽者，变姓名为吴市门卒云	以后，有人在会稽看见了他，他已改换姓名，当吴城市场的守门卒了
秋，九月，戊申晦，日有食之，赦天下徒	秋季，九月，戊申晦，出现日食，赦免天下囚犯
遣执金吾候陈茂谕说江湖贼成重等二百余人皆自出，送家所在收事	派遣执金吾候陈茂，劝说江湖盗匪成重等二百余人投降，使盗匪全部出来自首，把他们送回各自家乡，为当地官府供应劳役
重徙云阳，赐公田宅	成重则迁移安顿在云阳，赐给他公田和屋宅
王莽欲悦太后以威德至盛，异于前，乃风单于令遣王昭君女须卜居次云入侍太后，所以赏赐之甚厚	王莽想显示太皇太后的威望和恩德已达至盛，超过了前代，以此取悦于太皇太后，就暗示单于，让单于派遣王昭君的女儿须卜居次云到长安侍奉太后，因此而给予单于的赏赐非常丰厚
大司徒司直陈崇使张敞孙竦草奏，盛称安汉公功德，以为：宜恢公国令如周公，建立公子令如伯禽，所赐之品亦皆如之，诸子之封皆如六子	大司徒司直陈崇，命张敞的孙儿张竦起草奏章，歌颂王莽的功德，说：应该扩大安汉公的封国，让他象周公一样；赐封安汉公的长子，让他象伯禽一样，赏赐的等级也完全相同
太后以示群公	其他儿子的封赏，都像周公的六个儿子一样
群公方议其事，会吕宽事起	太皇太后王政君把奏章交给大臣们看，大臣们正在讨论这件事，恰巧吕宽事件发生了
春，正月，郊祀高祖以配天，宗祀孝文以配上帝	春季，正月，平帝在长安郊外用祭祀天地之礼祭祀高祖，以配享上天；在明堂用祭祀祖宗之礼祭祀文帝，以配享上帝
改殷绍嘉公曰宋公，周承休公曰郑公	改封殷绍嘉公为宋公、周承休公为郑公
诏：妇女非身犯法，及男子年八十以上、七岁已下，家非坐不道、诏所名捕，他皆无得系；其当验者即验问	平帝下诏：妇女除非本人犯法，以男子八十岁以上、七岁以下，其家除非被指控为大逆不道，或朝廷指名逮捕，一概不准囚禁
定著令	必须调查时，官员应到妇女或老幼所住的地方调查，本诏书自即日起成为法律
二月，丁未，遣大司徒宫、大司空丰等奉乘舆法驾迎皇后于安汉公第，授皇后玺绂，入未央宫	二月丁未，派大司徒马宫、大司空甄丰等，带着御用车轿跟皇家仪仗队，前往安汉公王莽家宅，迎接王莽的女儿，呈上皇后印信，将她载回未央宫
大赦天下	大赦天下
遣太仆王恽等八人各置副，假节，分行天下，览观风俗	派太仆王恽等八人为使节，各人再设副手，持节，分别巡视全国各地，考察社会风俗
莽奏起明堂、辟雍、灵台，为学者筑舍万区，制度甚盛	王莽提议兴建明堂、辟雍和灵台，给学者建筑宿舍一万间，规模十分宏伟
立《乐经》；益博士员，经各五人	在太学设立《乐经》课程，并增加博士名额，每一经各五人
征天下通一艺、教授十一人以上，及有逸《礼》、古《书》、天文、图谶、钟律、《月令》、《兵法》、《史篇》文字，通知其意者，皆诣公车	征求全国精通一经，而且教授弟子十一人以上的经师，以及藏有散失的《礼经》、古文《尚书》、天文、图谶、音乐、《月令》、《兵法》、《史籀篇》文字，通晓它们意义的人，都前往公车衙门
网罗天下异能之士，前后至者千数，皆令记说廷中，将令正乖谬，壹异说云	收罗全国具有卓越才能的士人，来到京师的前后数以千计，都让他们到朝廷上记录他们的学说，打算让他们订正流传的错误，统一各种分歧的说法
分京师置前辉光、后丞烈二郡	分割京师长安，设置前辉光郡、后丞烈郡
更公卿、大夫、八十一元士官名、位次及十二州名、分界	更改公卿、大夫、八十一元士官名、等级以及十二州州名、分界
郡国所属，罢置改易，天下多事，吏不能纪矣	更改各郡、各封国的管辖区域，或取消，或新设，或变更，从此天下事端增多，官吏记不胜记
	五年
安汉公又奏复长安南、北郊	安汉公王莽再奏请：恢复长安南郊祭天，北郊祭地大典
三十余年间，天地之祠凡五徙焉	三十余年间，祭祀天地的地方已经变更了五次
莽又奏为市无二贾，官无狱讼，邑无盗贼，野无饥民，道不拾遗，男女异路之制；犯者象刑	王莽又奏报说，做买卖没有两样价格，官府没有诉讼案件，城市没有盗贼，乡野没有饥民，大路上没有人拾取丢下的财物，实行男女不一同走路的制度，对于违犯者处予象征性刑罚
莽以皇后有子孙瑞，通子午道，从杜陵直绝南山，径汉中	王莽因皇后有了生男育女的吉兆，修通子午道，从杜陵县穿过终南山，直通汉中郡
泉陵侯刘庆上书言：周成王幼小，周公居摄	泉陵侯刘庆上书：周成王年龄幼小，由周公居位摄政
今帝富于春秋，宜令安汉公行天子事，如周公	当今圣上年龄还轻，应当让安汉公代行天子的职务，象周公一样
郡臣皆曰：宜如庆言	群臣都说：应当照刘庆所说的办
以长乐少府平晏为大司徒	任命长乐少府平晏当大司徒
太后与群臣议立嗣	太皇太后与文武百官，商议遴选继任皇帝
时元帝世绝，而宣帝曾孙有见王五人，列侯四十八人，莽恶其长大，曰：兄弟不得相为后	这时元帝的后代断绝了，而宣帝的曾孙有为王的五人，为列侯的四十八人，王莽厌恶他们已经长大，便说：兄弟之间不能互相作为后代
乃悉征宣帝玄孙，选立之	于是全部征召宣帝玄孙，逐一选择
三月，己丑，立宣帝玄孙婴为皇太子，号曰孺子	三月己丑册立宣帝玄孙刘婴作皇太子，称号叫作孺子
婴，广戚侯显之子也	刘婴是广戚侯刘显的儿子，年仅二岁
年二岁；托以卜相最吉，立之	王莽声称，卜卦的结果，认为他最吉利，所以才册立
尊皇后曰皇太后	尊王皇后为皇太后
冬，十月，丙辰朔，日有食之	冬季，十月丙辰朔，出现日食
十二月，群臣奏请以安汉公庐为摄省，府为摄殿，第为摄宫	十二月，群臣上书，请把安汉公在皇宫中的处所称为摄省，官署称为摄殿，住宅称为摄宫
奏可	奏章被批准了
是岁，西羌庞恬、傅幡等怨莽夺其地，反攻西海太守程永；永莽走	这一年，西羌庞恬和傅幡等人怨恨王莽夺取他们的土地，反攻西海郡太守程永，程永逃跑
莽诛永，遣护羌校尉窦况击之	王莽处死了程永，派遣护羌校尉窦况进击西羌
	二年
春，窦况等击破西羌	春季，窦况等人打败了西羌
春，地震	春季，发生地震
大赦天下	大赦天下
九月，莽母功显君死	九月，王莽的母亲功显君去世
莽自以居摄践阼，奉汉大宗之后，为功显君缌弁而加麻环，如天子吊诸侯服	王莽自以为他代理皇位，登上宫廷的宝座，尊奉汉室大宗的后嗣，于是为功显君守五服中最轻的缌麻服，在细麻布帽上面加上用麻环绕而成的孝带，如同天子吊唁诸侯的丧服
凡壹吊再会；而令新都侯宗为主，服丧三年云	总共一次吊唁，两次会祭，让新都侯王宗为丧主，由他守三年的丧服
期门郎张充等六人谋共劫莽，立楚王	期门郎张充等六人策划一道劫持王莽，拥立楚王作皇帝
发觉，诛死	被发觉后处死
春，正月，朔，莽帅公侯卿士奉皇太后玺上太皇太后，顺符命，去汉号焉	春季，正月朔，王莽率领公侯卿士捧着新制的皇太后御玺，呈上太皇太后，遵从上天的符命，去掉汉朝的名号
莽又封黄帝、少昊、颛顼、帝喾、尧、舜、夏、商、周及皋陶、伊尹之后皆为公、侯，使各奉其祭祀	王莽又赐封黄帝、少昊、颛顼、帝喾、尧、舜、夏、商、周及皋陶、伊尹的后代都为公、侯，使他们各自奉行对自己祖先的祭祀
夏，四月，徐乡侯刘快结党数千人起兵于其国	夏季，四月间，徐乡侯刘快集结党羽几千人，在他的封国里起兵
快兄殷，故汉胶东王，时为扶崇公	刘快的哥哥刘殷，是原汉朝的胶东王，这时已经改为扶崇公
快举兵攻即墨，殷闭城门，自系狱	刘快集结兵力，进攻即墨城，刘殷关闭城门，自投监狱
吏民距快；快败走，至长广死	官民抵抗刘快，刘快失败逃跑，退到长广县死了
莽赦殷，益其国满万户，地方百里	王莽赦免刘殷，增加他的封国达一万户人家，面积方圆一百里
冬，雷，桐华	冬季，响雷，桐树开花
又遣谏大夫五十人分铸钱于郡国	王莽派遣又谏大夫五十人，分别到各郡、各封国铸钱
是岁，真定、常山大雨雹	这一年，真定、常山天降大冰雹
	二年
春，二月，赦天下	春季，二月，大赦天下
五威将帅七十二人还奏事，汉诸侯王为公者悉上玺绶为民，无违命者	五威将帅七十二人回来奏报，汉朝的诸侯王去掉王号改称为公的，全部缴上印信成为平民，没有违抗命令的
独故广阳王嘉以献符命，鲁王闵以献神书，中山王成都以献书言莽德，皆封列侯	只有原广阳王刘嘉因向王莽呈献符命，鲁王刘闵因向王莽呈献神书，中山王刘成都因向王莽呈书歌颂功德，都封为列侯
十二月，雷	十二月，响雷
莽以钱币讫不行，复下书曰：宝货皆重则小用不给，皆轻则僦载烦费；轻重大小各有差品，则用便而民乐	王莽因为钱币一直不流通，又下诏说：钱币都是大面额，则不能应付小额交易；钱币都是小面额，则运输装载就麻烦费事
于是更作金、银、龟、贝、钱、布之品，名曰宝货	轻重大小各有等级，那么使用方便，百姓就欢迎
钱货六品，金货一品，银货二品，龟货四品，贝货五品，布货十品，凡宝货五物、六名、二十八品	于是，更铸宝币六种：金币、银币、龟币、贝币、钱币、布币
铸作钱布	其中钱币六种，金币一种，银币二种，龟币四种，贝币五种，布币十种
皆用铜，淆以连、锡	总计，货币共有五类、六种名称，二十八个等级
百姓溃乱，其货不行	钱币、布币都用铜铸作，其中混杂铅锡
莽知民愁，乃但行小钱直一与大钱五十，二品并行；龟、贝、布属且寝	因为货币的种类太多，百姓生活陷于混乱，货币不能流通
盗铸钱者不可禁，乃重其法，一家铸钱，五家坐之，没入为奴婢	王莽了解人民的怨愁，于是只使用值一钱的小钱和值五十的大钱，两种并行，龟币、贝币、布币暂且停止使用
吏民出入持钱，以副符传，不持者厨传勿舍，关津苛留	私自铸钱的无法禁止，便加重那方面的刑罚，一家铸钱，邻居五家连坐，将这些人送到官府作奴婢
公卿皆持以入宫殿门，欲以重而行之	官吏和平民外出要携带钱币作为通行副证，不携带的人，旅舍不允许住宿，关卡和渡口要盘问留难，公卿大臣都要携带它才能进入宫殿大门，想要用这样的办法提高它的身价从而得以流通
是时百姓便安汉五铢钱，以莽钱大小两行，难知，又数变改，不信，皆私以五铢钱市买；讹言大钱当罢，莫肯挟	当时，百姓认为汉五铢钱方便适用，而王莽钱因有大有小，两种钱同时发行，难以分辨，并且不断变化，所以不信任它，都私下用五铢钱在市场上购买商品，并谣传说大钱会废除，没有人肯于挟带
莽患之，复下书：诸侠五铢钱、言大钱当罢者，比非井田制，投四裔	王莽深感烦恼，再下诏书：凡是挟带五铢钱，说大钱要废除的人，比照诽谤井田制罪状，放逐到四方边远地区
及坐卖买田宅、奴婢、铸钱，自诸侯、卿大夫至于庶民，抵罪者不可胜数	连同被指控买卖田宅、买卖奴婢、盗铸钱币的人，从封国国君、朝廷官员到平民，犯法的人不计其数
于是农商失业，食货俱废，民人至涕泣于市道	于是农民、商人失业，全国经济崩溃，百姓甚至在街市道路上哭泣
遣田禾将军赵并发戍卒屯田五原、北假，以助军粮	新朝朝廷派田禾将军赵并，征发边防兵士在五原、北假一带，开荒屯垦，补助军粮
太师王舜自莽篡位后，病悸剧，死	太师王舜自王莽篡夺皇位后，得了心悸病，渐渐加剧，终于病故
是岁，濒河郡蝗生	本年，濒临黄河的各郡，发生蝗虫灾害
河决魏郡，泛清河以东数郡	黄河在魏郡决口，在清河以东数郡泛滥成灾
先是，莽恐河决为元城冢墓害；及决东去，元城不忧水，故遂不堤塞	最初，王莽害怕黄河决口淹没元城王姓皇族祖宗坟墓，及至黄河决口向东泛滥，元城没有水患，所以决定不堵塞河堤
	四年
春，二月，赦天下	春季，二月，大赦天下
大司马甄邯死	大司马甄邯去世
十一月，彗星出；二十余日，不见	十一月间，彗星出现，经过二十多天，消失
是岁，以挟铜炭者多，除其法	这一年，由于私挟铜炭的人太多，废除了该项法令
凶奴乌珠留单于死，用事大臣右骨都侯须卜当，即王昭君女伊墨居次云之婿也	匈奴乌珠留若单于去世，当权大臣右骨都侯须卜当，正是王昭君的女儿伊墨居次栾提云的丈夫
云常欲与中国和亲，又素与伊栗置支侯咸厚善，见咸前后为莽所拜，故遂立咸为乌累若单于	栾提云时常打算跟中国和亲，又一向与栗置支侯栾提咸友善，看到栾提咸曾经被王莽封作孝单于，于是拥立栾提咸为乌累若单于
乌累单于咸立，以弟舆为右谷蠡王	乌累单于栾提咸即位后，封弟弟栾提舆当右谷蠡王
乌珠留单于子苏屠胡本为左贤王，后更谓之护于，欲传以国	乌留珠单于的儿子栾提苏屠胡，本封左贤王，后来把左贤王改称护于，打算把单于的宝座传给他
咸怨乌珠留单于贬己号，乃贬护于为左屠耆王	栾提咸怨恨乌留珠单于贬低自己的称号，就把护于栾提苏屠胡贬作左屠耆王
	天凤元年
春，正月，赦天下	春季，正月，大赦天下
夏，四月，陨霜杀草木，海濒尤甚	夏季，四月间，降了霜，冻死了草木，沿海尤其厉害
六月，黄雾四塞	六月间，黄雾弥漫
秋，七月，大风拔树，飞北阙直城门屋瓦	秋季七月间，大风拔起树木，刮走了北阙直城门屋上的瓦
雨雹，杀牛羊	落下冰雹，打死了牛羊
益州蛮夷愁扰，尽反，复杀益州大尹程降	益州蛮夷因忧愁而骚扰，同时叛乱，击杀益州大尹程降
莽遣平蛮将军冯茂发巴、蜀、犍为吏士，赋敛取足于民，以击之	王莽派遣平蛮将军冯茂调发巴郡、蜀郡、犍为郡等地方官兵，粮秣军饷直接向百姓征收，进击益州郡叛乱民众
春，二月，大赦天下	春季，二月，大赦天下
民讹言黄龙堕死黄山宫中，百姓奔走往观者有万数	民间谣传有黄龙摔死在黄山宫中，老百姓奔走前往看热闹的有一万人之多
莽恶之，捕系，问所从起；不能得	王莽讨厌这件事，拘捕了一些人讯问谣言从哪里传起，没能找到
邯郸以北大雨，水出，深者数丈，流杀数千人	邯郸以北地区降了大雨，地下水涌出，水深的地方有几丈深，冲走淹死几千人
春，二月，乙酉，地震，大雨雪；关东尤甚，深者一丈，竹柏或枯	春季，二月乙酉，发生地震，天降大雪，关东地区尤其厉害，雪深的地方有丈把深，竹子、柏树有的枯死了
大司空王邑上书，以地震乞骸骨	大司空王邑上书，以地震为由，请求退休
莽不许，曰：夫地有动有震，震者有害，动者不害	王莽不准，说：大地有震有动，震有害而动无害
《春秋》记地震，《易・系》坤动；动静辟翕，万物生焉	《春秋》记载地震，《易经・系辞上传》只说地动，动的时候就张开，静的时候就合拢，万物由此发生
其好自诬饰，皆此类也	王莽喜爱自我欺骗掩饰，都是此类
戊辰，长平馆西岸崩，壅泾水不流，毁而北行	戊辰，长平馆西岸坍塌，把泾河水流阻塞，河水决口向北流去
群臣上寿，以为《河图》所谓以土填水，匈双灭亡这祥也	群臣向王莽祝贺，认为这就是《河图》所说的用土去镇服水，是匈奴灭亡的好兆头
莽乃遣并州牧宋弘、游击都尉任萌等将兵击匈奴，至边止屯	于是王莽派遣并州牧宋弘和游击都尉任萌等人统率军队进击匈奴，到达边境驻扎下来
秋，七月，辛酉，霸城门灾	秋季，七月辛酉，霸城门发生火灾
戊子晦，日有食之	戊子晦出现日食
大赦天下	大赦天下
翟义党王孙庆捕得，莽使太医、尚方与巧屠共刳剥之，量度五臧，以竹筵导其脉，知所终始，云可以治病	翟义的党羽王孙庆被捉，王莽命太医、药剂师和高明的屠手一道解剖他，测量五脏，用竹签贯通他的经脉，弄清来龙去脉，说是可以用来治疗疾病
夏，六月，莽更授诸侯王茅土于明堂；亲设文石之平，陈菁茅四色之土，告于岱宗、泰社、后土、先祖、先妣以班授之	夏季六月间，王莽重新在明堂把象征封国的茅草与泥土授予诸侯王，亲自设置有文采的石制几案，陈列菁茅和四色泥土，祭告泰山、国家宗社、后土和先代的祖父祖母，然后进行封授
莽好空言，慕古法，多封爵人；性实吝啬，托以地理未定，故且先赋茅土，用慰喜封者	王莽喜好说空话，羡慕古代的制度，多给人赐封爵位，为人却实在吝啬小气，托辞土地规划没有确定，所以权且先授予象征封国的茅土，用来安慰喜欢封爵的人
春，正月，朔，北军南门灾	春季，正月初一，北军南营门失火
以大司马司允费兴为荆州牧；见，问到部方略，兴对曰：荆、扬之民，率依阻山泽，以渔采为业	王莽任命大司马司允费兴作荆州牧，接见并询问他到任后的施政方案，费兴回答说：荆州、扬州的百姓大都依靠山林湖沼，以捕捞、樵采为业
间者国张六管，税山泽，妨夺民之利，连年久旱，百姓饥穷，故为盗贼	前一段时间，国家推行六管制度，征收山林湖沼税，损害、剥夺了百姓的利益，加上连年久旱，百姓饥饿穷困，所以沦为盗贼
兴到部，欲令明晓告盗贼归田里，假贷犁牛、种食，阔其租赋，冀可以解释安集	我到任后，想要明令晓喻盗贼返回家园，贷放农具、耕牛、种子、粮食，减免他们的赋税，希望可以解散、安抚他们
莽怒，免兴官	王莽大怒，免掉了费兴的官职
天下吏以不得俸禄，并为奸利，郡尹、县宰家累千金	全国的官吏因为得不到俸禄，纷纷去牟取非法利益，郡尹、县宰家里积累上千斤黄金
莽乃考始建国二年胡虏猾夏以来诸军吏及缘边吏大夫以上为奸利增产致富者，收其家所有财产五分之四以助边急	王莽于是检查始建国二年匈奴扰乱中国以来，所有军官和边境官吏大夫以上牟取非法利益增加产业发了财的，没收他们家中所有财产的五分之四，用来资助边防急需
公府士驰传天下，考覆贪饕，开吏告其将、奴婢告其主，冀以禁奸，而奸愈甚	各公府官吏乘坐驿站快车跑遍全国，审查贪污案件，动员官吏告发他们的上级，奴婢告发他们的主人，希望用这样的办法来禁止奸邪，可是奸邪却越加厉害
莽孙功崇公宗坐自画容貌被服天子衣冠、刻三印，发觉，自杀	王莽的孙子功崇公王宗由于给自己画了一幅像，穿着天子的衣服，戴着天子的冠冕，刻了三枚印章，被发觉，王宗自杀
宗姊妨为卫将军王兴夫人，坐祝诅姑，杀婢以绝口，与兴皆自杀	王宗的姐姐王妨是卫将军王兴的夫人，被指控祈祷鬼神给她婆母降灾祸，为了灭口而杀死婢女，与王兴都自杀了
春，莽见盗贼多，乃令太史推三万六千岁历纪，六岁一改元，布	春季，王莽发现
初献《亲乐》于明堂、太庙	王莽第一次把《新乐》呈献于明堂、太庙
关东饥旱连年，刁子都等党众多，至六七万	函谷关以东连年饥馑、大旱，刁子都等党羽部众渐多，达六七万人
春，正月，乙未，赦天下；改元曰地皇，从三万六千岁历号也	春季，正月乙未，大赦天下，根据三万六千年日历，改年号为地皇
莽下书曰：方出军行师，敢有趋欢犯法者辄论斩，毋须时	王莽下文告说：正当出兵行军的时候，敢有奔跑吵闹触犯法律的，就判处杀头，不要等到行刑季节
于是春、夏斩人都市，百姓震惧，道路以目	于是春季、夏季都在都市里杀人，百姓震恐，路上相见只有以目示意，不敢交谈
是月，大雨六十余日	从本月开始，倾盆大雨下了六十余日
汝南邪恽明天文历数，以为汉必再受命，上书说莽曰：上天垂戒，欲悟陛下，令就臣位	汝南人郅恽深明天文星象与历法，认为汉王朝一定复兴，上书劝说王莽：上天所以发生异象，是在想使陛下觉悟，使你回到臣僚的位置上
取之以天，还之以天，可谓知命矣	取之于天，应该交还给天，才算是知道天命
莽大怒，系恽诏狱，逾冬，会赦得出	王莽大怒，逮捕郅恽，下入诏狱，过了冬天，逢到赦免，才从狱中出来
是月，新迁王安病死	本月，新迁王王安病故
初，莽为侯就国时，幸侍者增秩、怀能，生子兴、匡，皆留新都国，以其不明故也	当初，王莽为列侯去到封国的时候，宠爱侍女增秩、怀能，生下儿子王兴、王匡，都留在新都国，这是因为他们身份不明的缘故
及安死，莽乃以王车遣使者迎兴、匡，封兴为功公，匡为功建公	等到王安死了，王莽才派遣使者用王车把王兴、王匡接来，封王兴为功公，王匡为功建公
卜者王况谓魏成大尹李焉曰：汉家当复兴，李氏为辅	占卦先生王况对魏成大尹李焉说：汉会复兴，姓李的人将当辅佐大臣
因为焉作谶书，合十余万言	遂替李焉编写谶书共有十多万字
事发，莽皆杀之	事情败露，王莽把二人都杀了
莽遣太师羲仲景尚、更始将军护军王党将兵击青、徐贼，国师和仲曹放助郭兴击句町，皆不能克	王莽派遣太师羲仲景尚、更始将军护军王党，率领军队攻打青州和徐州的盗贼，国师和仲曹放帮助郭兴攻击句町，都不能够取胜
军师放纵，百姓重困	军队胡作非为，百姓更加困苦
莽又转天下谷帛诣西河、五原、朔方、渔阳，每一郡以百万数，欲以击匈奴	王莽又转运全国的粮食、丝帛前往西河郡、五原郡、朔方郡和渔阳郡，每一郡以百万计，想要用去攻打匈奴
须卜当病死，莽以庶女妻其子后安公奢，所以尊宠之甚厚，终欲为出兵立之者	这时须卜当因病去世，王莽把他的庶女嫁给须卜当的儿子后安公须卜奢，因为最终要用武力送他回匈奴即位，所以对他尊荣宠爱都很深厚
会莽败，云、奢亦死	当王莽败亡的时候，栾提云、须卜奢也在中原去世
秋，陨霜杀菽，关东大饥，蝗	秋季，严霜伤害豆类庄稼，函谷关以东发生大饥馑，蝗虫成灾
莽既轻私铸钱之法，犯者愈众，及伍人相坐，没入为官奴婢；其男子槛车，女子步，以铁琐琅当其颈，传诣钟官以十万数	王莽减轻私自铸钱的处罚后，犯法的就更多了，加上邻居连坐，都被收作官府的奴婢
到者易其夫妇	其中男子坐囚车，妇女步行，用铁锁链套住他们的脖子，前往铸钱的官府，以十万计
愁苦死者什六七	到达后拆散夫妻，另行改配，愁苦而死的十有六七
闰月，丙辰，大赦	闰八月，丙辰，大赦天下
郎阳成献符命，言继立民母；又曰：黄帝以百二十女致神仙	郎官阳成进献符命，说应当再立皇后，又说：黄帝靠着一百二十个女子成了神仙
莽于是遣中散大夫、谒者各四十五人，分行天下，博采乡里所高有淑女者上名	王莽于是派遣中散大夫和谒者各四十五人分别巡视全国，广泛选取被邻里所推崇的有淑女的人家，送上名册
莽恶汉高庙神灵，遣虎贲武士入高庙，四面提击，斧坏户牖，桃汤、赭鞭鞭洒屋壁，令轻车校尉居其中	王莽对汉高祖刘邦祭庙的神灵深为厌恶，派虎贲武士到刘邦祭庙，用武器四面掷击，用斧子砍坏门窗，用桃木汤浇洒墙壁，用土红色鞭子抽打墙壁，让轻车较尉住在里面
二月，樊崇等杀景尚	二月，樊崇等杀死了太师羲仲景尚
关东人相食	函谷关以东地区出现了人吃人的现象
夏，四月，遣太师王匡、更始将军廉丹东讨众贼	夏季，四月，王莽派遣太师王匡、更始将军廉丹东征讨伐众盗贼
初，樊崇等众既盛，乃相与为约：杀人者死，伤人者偿创	最初，樊崇等人的部众既然逐渐强盛，于是互相约定：杀人的抵命，伤人的养创
其中最尊号三老，次从事，次卒史	其中最尊贵的称号是三老，其次是从事，再其次是卒史
及闻太师、更始将讨之，恐其众与莽兵乱，乃皆朱其眉以相识别，由是号曰赤眉	等到听说太师与更始将军率军前来讨伐他们，恐怕部众跟王莽军队在混战时难于辨别，于是下令都用朱砂涂抹双眉，以便互相认识辨别，因此号称赤眉
匡、丹合将锐士十余万人，所过放纵	王匡、廉丹一起率领精兵十余万人，一路放任士兵，不加约束
东方为之语曰：守逢赤眉，不逢太师	东部地区为此出现民谣说：宁遇赤眉，不遇太师
太师尚可，更始杀我	太师尚可，更始杀我
卒如田况之言	确实象田况所说的一样
蝗从东方来，飞蔽天	蝗虫从东方飞来，铺天盖地
十一月，有星孛于张	十一月，有异星出现在张六星旁
莽赦天下，诏：王匡、哀章等讨青、徐盗贼，严尤、陈茂等讨前队丑虏，明告以生活、丹青之信；复迷惑不解散，将遣大司空、隆新公将百万之师绝之矣	王莽大赦天下，宣布诏命：王匡、哀章等讨伐青州、徐州地区的盗贼，严尤、陈茂等讨伐前队地区的盗贼，明白地向他们宣告来降者不杀、守约不变；如果仍然迷惑而不解散，即将派遣大司空、隆新公王邑带领百万大军剿灭他们
三月，王凤与太常偏将军刘秀等徇昆阳、定陵、郾，皆下之	三月，王凤和太常偏将军刘秀等率领汉军攻掠昆阳、定陵、郾等城，都予攻克
莽闻汉兵言莽鸩杀孝平皇帝，乃会公卿于王路堂，开所为平帝请命金之策，泣以示群臣	王莽听说汉军说他用鸩酒毒杀了汉平帝，便集合公卿到王路堂，打开收藏在金柜中的他替平帝请求解除疾病、愿以身代死的策书，流着泪出示给群臣看
王莽使太师王匡、国将哀章守洛阳	王莽命太师王匡、国将哀章守卫洛阳，更始皇帝派遣定国上公王匡进攻洛阳，西屏大将军申屠建、丞相司直李松进攻武关，三辅地区为之震动
更始遣定国上公王匡攻洛阳，西屏大将军申屠建、丞相司直李松攻武关，三辅震动	析县人邓晔和于匡在南乡起兵以响应汉军，进攻武关都尉朱萌，朱萌投降；进攻右队大夫宋纲，把宋纲杀掉；向西挺进，攻陷湖县
析人邓晔、于匡起兵南乡以应汉，攻武关都尉朱萌，萌降；进攻右队大夫宋纲，杀之；西拔湖	王莽更加忧虑，不知所措
莽愈忧，不知所出	崔发说：古时候国家有了大灾难，就用哭向上天告哀来战胜它
崔发言：古者国有大灾，则哭以厌之	应该祷告上天祈求救助
宜告天以求救	王莽于是率领群臣到南郊，陈述他承受符命的首尾经过，仰天大哭，声嘶气绝，伏地叩头
莽乃率群臣至南郊，陈其符命本末，仰天大哭，气尽，伏而叩头	众儒生和老百姓每天早晚会集起来哭，给他们准备了稀饭
诸生、小民旦夕会哭，为设餐粥；甚悲哀者，除以为郎，郎至五千余人	哭得非常悲哀的人，被任命作郎官，郎官达到五千多人
王莽庐江连率颍川李宪据郡自守，称淮南王	王莽朝中的庐江连率颍川人李宪占据本郡自守，自称淮南王
故梁王立之子永诣洛阳；更始封为梁王，都睢阳	前汉朝梁王刘立的儿子刘永到洛阳朝见刘玄，刘玄封刘永为梁王，首府设在睢阳
以大司徒赐为丞相，令先入关修宗庙、宫室	刘玄赐封大司徒刘赐当丞相，命令他先进入函谷关内，修建宗庙、宫室
春，正月，大司马秀以王郎新盛，乃北徇蓟	春季，正月，大司马刘秀因为王郎刚刚崛起，正处于兴盛状态，于是北向蓟州夺取土地
更始征隗嚣及其叔父崔、义等	刘玄征召隗嚣和他的叔父隗崔、隗义等人
嚣将行，方望以更始成败未可知，固止之；嚣不听，望以书辞谢而去	隗嚣将要出发，方望因为刘玄成败尚不可知道，坚决地制止他，隗嚣不听他的建议，方望留下一封书信，告辞而去
嚣等至长安，更始以嚣为右将军，崔、义皆即旧号	隗嚣等到达长安，刘玄任命隗嚣当右将军，对隗崔、隗义都按旧有的称号赐封
耿况遣其子奉奏诣长安，时年二十一	耿况派遣他的儿子耿带着上呈奏章到长安，耿当时二十一岁
行至宋子，会王郎起，从吏孙仓、卫包曰：刘子舆，成帝正统；舍此不归，远行安之	走到宋子，正值王郎起事，耿的从官孙仓、卫包说：刘子舆乃是汉成帝一脉相传的嫡子，舍弃他不归附，远行到哪里去
按剑曰：子舆弊贼，卒为降虏耳	耿用手握着剑柄说：刘子舆是个欺骗蒙混的贼子，最终要成为投降的俘虏
我至长安，与国家陈上谷、渔阳兵马，归发突骑，以辚乌合之众，如摧枯折腐耳	我到长安，向朝廷叙说上谷郡和渔阳郡的兵马状况，回去后征发能冲突军队的骑兵，用来践踏那些乌合之众，犹如摧枯拉朽一般
观公等不识去就，族灭不久也	看你等没有择主而从的眼光，灭族之祸不远了
仓、包遂亡，降王郎	孙仓、卫包于是逃亡，投降了王郎
蓟中之乱，耿与刘秀相失，北走昌平，就其父况，因说况击邯郸	蓟中之乱时，耿与刘秀失散，向北逃到昌平，回到他父亲耿况那里，趁机劝说耿况攻击邯郸
时王郎遣将徇渔阳、上谷，急发其兵，北州疑惑，多欲从之	而这时候，王郎派出的将领，正在渔阳、上谷夺取土地，并紧急征调那里的部队，北方沿边郡县疑惑，但多数都打算服从
上谷功曹寇恂、门下掾闵业说况曰：邯郸拔起，难可信向	上谷郡功曹寇恂、门下掾闵业向耿况建议说：邯郸仓猝崛起，前途难测
大司马，刘伯升母弟，尊贤下士，可以归之	而大司马刘秀，是刘的亲弟弟，礼贤下士，我们可以归附他
况曰：邯郸方盛，力不能独拒，如何	耿况说：邯郸的势力正兴盛，我们不能单独抵抗，应该怎么办
对曰：今上谷完实，控弦万骑，可以详择去就	寇恂说：现在上谷郡完好充实，拥有射箭骑兵一万人，可以认真选择自己的前途
恂请东约渔阳，齐心合众，邯郸不足图也	我愿意前往东方的渔阳，与彭宠约定，同心合力，就用不着把邯郸放在心上
况然之，遣恂东约彭宠，欲各发突骑二千匹、步兵千人诣大司马秀	耿况同意，派寇恂东行进见彭宠，互相约定，打算每郡出动骑兵突击队两千人、步兵一千人，到大司马刘秀那里去支援他
冬，更始遣中郎将归德侯飒、大司马护军陈遵使匈奴，授单于汉旧制玺绶，因送云、当余亲属、贵人、从者还匈奴	冬季，刘玄派中郎将归德侯刘飒、大司马护军陈遵出使匈奴，向单于颁发与汉朝旧制相同的印信，并就此把栾提云与他丈夫须卜当剩下的亲属、贵族、随从送回匈奴
单于舆骄，谓遵、飒曰：匈奴本与汉为兄弟；匈奴中乱，孝宣皇帝辅立呼韩邪单于，故称臣以尊汉	匈奴单于栾提舆态度傲慢，对陈遵、刘飒说：匈奴与汉朝本来是兄弟，匈奴中期发生内乱，孝宣皇帝帮助立呼韩邪单于，所以匈奴称臣，以尊敬汉朝
今汉亦大乱，为王莽所篡，匈奴亦出兵击莽，空其边境，令天下骚动思汉；莽卒以败而汉复兴，亦我力也，当复尊我	而今汉朝也有大乱，被王莽所篡夺，匈奴也曾出兵攻击王莽，使边境荡然一空，引起天下骚动，产生人心思汉的后果，王莽最终失败，汉王朝复兴，这也是靠我们匈奴的力量，汉朝应该反过来尊我
遵与相拒，单于终持此言	陈遵守住立场，进行辩驳，但单于始终坚持他的这种观点
人秦丰起兵于黎丘，攻得、宜城等十余县，有众万人，自号楚黎王	人秦丰在黎丘起兵，攻陷县、宜城等十余县，有部众一万人，自称楚黎王
汝南田戎攻陷夷陵，自称扫地大将军；转寇郡县，众数万人	汝南人田戎攻陷夷陵，自称扫地大将军，转战劫掠各郡县，有部众数万人
春，正月，方望与安陵人弓林共立前定安公婴为天子，聚党数千人，居临泾	春季，正月，方望和安陵人弓林共同拥立前定安公刘婴当皇帝，聚集党徒数千人，占据临泾
更始遣丞相松等击破，皆斩之	更始皇帝刘玄派遣丞相李松讨伐方望等，将他们全部斩杀
邓禹至箕关，击破河东都尉，进围安邑	邓禹的军队进抵箕关，打败了河东郡都尉的军队，进军包围了安邑县
赤眉二部俱会弘农	赤眉军的两支队伍在弘农会师
更始遣讨难将军苏茂拒之；茂军大败	更始皇帝刘玄派遣讨难将军苏茂抵挡，苏茂的军队大败
赤眉众遂大集，乃分万人为一营，凡三十营	赤眉军于是大为集结，分成一万人为一营，共计三十营
三月，更始遣丞相松与赤眉战于乡，松等大败，死者三万余人；赤眉遂转北至湖	三月，刘玄派遣丞相李松同赤眉军在乡展开大战，李松等大败，死三万余人，于是赤眉军向北推进到湖城
李松自引兵还，从更始与赵萌共攻王匡、张于长安	更始朝宰相李松从城领兵返回，跟从刘玄与赵萌一同进攻王匡、张，战于长安
连战月余，匡等败走，更始徙居长信宫	一连打了一个多月，王匡等败逃，刘玄迁居到长信宫
上遣岑彭击荆州群贼，下、叶等十余城	刘秀派岑彭攻打荆州一带的众贼军，攻下、叶等十余城
十一月，甲午，上幸怀	十一月甲午，刘秀到达怀地
梁王永称帝于睢阳	梁王刘永在睢阳称帝
十二月，丙戌，上还洛阳	十二月丙戌，刘秀返回洛阳
初，更始以王闳为琅邪太守，张步据群拒之	当初，刘玄任命王闳当琅邪太守，张步占据琅邪郡抗拒王闳
闳谕降，得赣榆等六县；收兵与步战，不胜	王闳劝谕招降，先后获取赣榆等六个县
步既受刘永官号，治兵于剧，遣将徇泰山、东莱、城阳、胶东、北海、济南、齐郡，皆下之	他聚集兵力同张步作战，不能取胜
闳力不敌，乃诣步相见	张步接受了刘永任命的官职以后，就在剧县训练军队，派出将领攻打泰山、东莱、城阳、胶东、北海、济南、齐郡，全部陷落
步大陈兵而见之，怒曰：步有何罪，君前见攻之甚	王闳的力量不能和他对抗，于是到张步的驻地见张步
闳按剑曰：太守奉朝命，而文公拥兵相拒	张步安排大军列队，迎见王闳，发怒说：我有什么罪，你先前攻打我那么厉害
闳攻贼耳，何谓甚邪	王闳手按着剑柄说：我奉朝廷的命令到任，而阁下领兵抗拒，我只是攻打贼寇罢了，叫做厉害呢
步起跪谢，与之宴饮，待为上宾，令闳关掌郡事	张步起身跪拜谢罪，设宴和王闳一起喝酒，待他为尊贵的客人，并由他掌管本郡事务
春，正月，甲子朔，日有食之	春季，正月，甲子朔，出现日食
二月，己酉，车驾幸武	二月己酉，刘秀前往武
辛卯，上还洛阳	辛卯，刘秀返回洛阳
三月，乙未，大赦	三月乙未，刘秀实行大赦
五月，庚辰，封族父歙为泗水王	五月庚辰，刘秀封族父刘歙为泗水王
丙午，封泗水王子终为淄川王	丙午，刘秀封泗水王的儿子刘终为淄川王
吴汉徇南阳诸县，所过多侵暴	吴汉夺取南阳各县，在经过的地方，多有侵暴行为
破虏将军邓奉谒归新野，怒汉掠其乡里，遂反，击破汉军，屯据阳，与诸贼合从	破虏将军邓奉请求回新野省亲，他对吴汉抢劫他的乡里十分愤怒，于是叛变，击溃吴汉的军队，在阳屯据，同各路贼寇联合起来
九月，壬戌，帝自内黄还	九月壬戌，刘秀从内黄返回洛阳
冬，十一月，以廷尉岑彭为征南大将军	冬季，十一月，刘秀任命廷尉岑彭当征南大将军
帝于大会中指王常谓群臣曰：此家率下江诸将辅翼汉室，心如金石，真忠臣也	刘秀在大会群臣时，指着王常对群臣说：此人率领下江将领辅佐保卫汉朝，心像金石一般坚硬，真是忠臣呵
即日，拜常为汉忠将军，使与岑彭率建义大将军朱祜等七将军讨邓奉、董	当天，任命王常为汉忠将军，派他和岑彭率领建义大将军朱祜等七位将军征讨邓奉、董
彭等先击堵乡，邓奉救之	岑彭等先攻打堵乡的董，邓奉出兵援救董
朱祜军败，为奉所获	朱祜战败，被邓奉俘获
铜马、青犊、尤来余贼共立孙登为天子	铜马、青犊、尤来等贼军残部共同拥立孙登当皇帝
登将乐玄杀登，以其众五万余人降	孙登的部将乐玄杀死孙登，率领部众五万多人投降刘秀
十二月，戊午，诏宗室列侯为王莽所绝者，皆复故国	十二月戊午，刘秀发布诏令：凡被王莽新朝废除的刘氏皇族列侯，全都恢复原来的封国
壬午，大赦	壬午，大赦天下
帝幸怀	刘秀到达怀县
吴汉率耿、盖延击青犊于轵西，大破降之	吴汉率领耿、盖延在轵县西攻打青犊军，大破青犊军并使之归降
三月，壬寅，以司直伏湛为大司徒	三月壬寅，刘秀提拔司直伏湛当大司徒
乙卯晦，日有食之	乙卯晦，出现日食
六月，壬戌，大赦	六月壬戌，大赦天下
冬，十月，壬申，上幸舂陵，祠园庙	冬季，十月壬申，刘秀到达故乡舂陵，祭祀祖先的陵园祭庙
耿从容言于帝，自请北收上谷兵未发者，定彭宠于渔阳，取张丰于涿郡，还收富平、获索，东攻张步，以平齐地	耿从容地向刘秀说，他请求北上招收上谷郡还没有调动的士兵，在渔阳铲除彭宠，在涿郡打败张丰；返回洛阳时消灭富平、获索军；向东攻击张步，从而平定齐地
帝壮其意，许之	刘秀认为他很有雄心壮志，答应了他的要求
十一月，乙未，帝还自舂陵	十一月乙未，刘秀从舂陵返回
是岁，李宪称帝，置百官，拥九城，众十余万	这一年，李宪在庐江称帝，设置百官，拥有九座城，部众十余万人
正月，甲申，大赦	正月甲申，刘秀实行大赦
六月，辛亥，车驾还宫	六月辛亥，刘秀返回洛阳
太傅卓茂薨	太傅卓茂去世
泰山豪杰多与张步连兵	泰山郡的豪强大多和张步的军队联合
吴汉荐强弩大将军陈俊为泰山太守，击破步兵，遂定泰山	吴汉举荐强弩大将军陈俊做泰山太守，击败张步的军队，因而平定了泰山郡
春，正月，癸巳，车驾还宫	春季，正月癸巳，刘秀回到洛阳
二月，丙午，大赦	二月丙午，刘秀实行大赦
乙丑，上行幸魏郡	乙丑，刘秀前往魏郡
帝使光禄大夫樊宏持节迎耿况于上谷，曰：边郡寒苦，不足久居	刘秀命光禄大夫樊宏持符节在上谷郡迎接耿况，说：边疆郡县，寒冷贫穷，不能长期居住
况至京师，赐甲第，奉朝请，封牟平侯	耿况到达洛阳，被赐予上等住宅，有权参加朝会封他为牟平侯
平敌将军庞萌，为人逊顺，帝信爱之，常称曰：可以托六尺之孤，寄百里之命者，庞萌是也	平敌将军庞萌为人谦逊和顺，刘秀信任并喜爱他，常常称赞他说：可以托付六尺高的孤儿，托付一县百里土地的是庞萌
使与盖延共击董宪	派他和盖延共同攻打董宪
时诏书独下延而不及萌，萌以为延谮己，自疑，遂反袭延军，破之；与董宪连和，自号东平王，屯桃乡之北	当时诏书只颁给盖延而没有颁给庞萌，庞萌以为是盖延在刘秀面前说了自己的坏话，起了疑心，于是叛变，袭击盖延军，打败盖延和董宪联合起来，自称东平王，在桃乡以北驻扎军队
帝闻之，大怒，自将讨萌，与诸将书曰：吾尝以庞萌为社稷之臣，将军得无笑其言乎	刘秀听到庞萌叛变的消息，大怒，亲率军队讨伐庞萌，他给将领们写信说：我曾经以为庞萌是可以把国家托付给他的重臣，将军们恐怕要笑我说的话吧
老贼当族，其各厉兵马，会睢阳	庞萌这个老贼应当灭族，你们加紧操练军队，在睢阳会师
夏，四月，旱，蝗	夏季，四月，天旱，出现蝗灾
冬，十月，帝幸鲁	冬季，十月，刘秀到达鲁城
十一月，大司徒伏湛免，以侯霸为大司徒	十一月，免去大司徒伏湛的职务，任命侯霸当大司徒
霸闻太原闵仲叔之名而辟之，既至，霸不及政事，徒劳苦而已	侯霸听说太原人闵仲叔的名声，征召他到洛阳
仲叔恨曰：始蒙嘉命，且喜且惧	闵仲叔到洛阳后，侯霸不与他谈国家大事，只是慰劳他旅途的辛苦
今见明公，喜惧皆去	闵仲叔不满地说：刚刚接到征召的命令时，又高兴又害怕
以仲叔为不足问邪	今天见到您，高兴和害怕全都消失了
不当辟也	如果认为我不值得您发问，那么就不应征召我
辟而不问，是失人也	您征召我而不询问我，是失去人才
遂辞出，投劾而去	于是告辞出来，递送自责的辞呈然后离去
春，正月，丙辰，以舂陵乡为章陵县，世世复摇役，比丰、沛	春季，正月丙辰，东汉把舂陵乡改为章陵县，按照刘邦祖籍丰县和沛县的作法，世世代代免除赋税徭役
吴汉等拔朐，斩董宪、庞萌，江、淮、山东悉平	吴汉等攻下朐县，斩杀董宪、庞萌，长江、淮河、崤山以东全部平定
诸将还京师，置酒赏赐	将领们返回洛阳，刘秀设酒宴赏赐
冯异自长安入朝，帝谓公卿曰：是我起兵时主簿也，为吾披荆棘，定关中	冯异从长安到洛阳入朝晋见
既罢，赐珍宝、钱帛，诏曰：仓卒芜蒌亭豆粥，呼沱河麦饭，厚意久不报	刘秀对公卿说：冯异是我当初起兵时的主簿，为我披荆斩棘，平定关中
异稽首谢曰：臣闻管仲谓桓公曰：愿君无忘射钩，臣无忘槛车	晋见已毕，赏赐珍宝、钱、帛，颁下诏书说：当初在仓猝之时，你在芜蒌亭进献豆粥，在滹沱河进献麦饭，深情厚意，长时间未能回报
齐国赖之	冯异叩头拜谢说：我听说管仲对齐桓公说：愿君王不忘我射您带钩的事，我不忘被装入囚车的事
臣今亦愿国家无忘河北之难，小臣不敢忘巾车之恩	齐国依靠这两个人强盛起来，我今天也愿陛下勿忘河北的苦难，我不会忘记在巾车乡您对我的恩德
留十余日，令与妻子还西	冯异在洛阳逗留十余天，刘秀命他和妻子儿女西行返回任所
申屠刚、杜林自隗嚣所来，帝皆拜侍御史	申屠刚、杜林从隗嚣那里来到洛阳，刘秀任命二人当侍御史
以郑兴为太中大夫	任命郑兴当太中大夫
十二月，壬辰，大司空宋弘免	十二月壬辰，免去大司空宋弘的职务
癸巳，诏曰：顷者师旅未解，用度不足，故行十一之税	癸巳，刘秀下诏：前些时战事不息，国家经费不足，所以按十分之一收税
今粮储差积，其令郡国收见田租，三十税一，如旧制	如今粮食储备增多，从现在起，各郡、各封国收取现有田地的田租，按三十分之一征税，恢复原来的制度
窦融复遣其弟友上书曰：臣幸得托先后末属，累世二千石，臣复假历将帅，守持一隅，故遣刘钧口陈肝胆，自以底里上露，长无纤介	窦融又派弟弟窦友前往洛阳，向刘秀上书说：我很幸运，能够成为先皇后亲属的后代，好几代都是二千石俸禄
而玺书盛称蜀、汉二主三分鼎足之权，任嚣、尉佗之谋；窃自痛伤	我又暂任将帅，镇守一方
臣融虽无识无知，利害之际，顺逆之分，岂可背真旧之主，事奸伪之人，废忠贞之节，为倾覆之事，弃已成之基，求无冀之利	所以派遣刘钧，向您口头表达我的赤胆忠心，从内心深处对您没有丝毫隐瞒
此三者，虽问狂夫，犹知去就，而臣独何以用心	而您的诏书却称赞公孙述、隗嚣两位君主三分天下、形成鼎足之势的权力，提到任嚣、尉佗的谋划，我深感忧伤悲痛
谨遣弟友诣阙，口陈至诚	我窦融虽然无知无识，但在利与害之际、顺与逆之间，岂能背叛真主旧主，去事奉奸恶、假冒的人
友至高平，会隗嚣反，道不通，乃遣司马席封间道通书	岂能废弃忠贞的节操，去做颠覆国家的坏事
帝复遣封赐融、友书，所以尉藉之甚厚	岂能抛弃已经成就的基础，去追求并无希望的利益
	就此三项，即使去问一个疯子
匈奴与卢芳为寇不息，帝令归德侯飒使匈奴以修旧好	匈奴和卢芳不断侵扰，刘秀命归德侯刘飒出使匈奴，谋求恢复以前的良好关系
单于骄倨，虽遣使报命，而寇暴如故	匈奴单于骄横傲慢，虽然也派使节到洛阳回报，但侵扰如故
春，三月，罢郡国轻车、骑士、材官，令还复民伍	春季，三月，免去郡县、封国的轻车、骑士、材官，命他们回归为民
公孙述立隗嚣为朔宁王，遣兵往来，为之援势	公孙述封隗嚣为朔宁王，让他派出军队往来造声势，作为援助
夏，四月，壬午，大赦	夏季，四月壬午，刘秀实行大赦
五月，戊戌，以前将军李通为大司空	五月戊戌，刘秀任命前将军李通做大司空
帝好图谶，与郑兴议郊祀事，曰：吾欲以谶断之，何如	刘秀喜好运用隐语或预言占验吉凶的图谶，和郑兴讨论到郊外祭祀的事，说：我想用图谶来推断，怎么样
对曰：臣不为谶	郑兴回答：我不从事预言
帝怒曰：卿不为谶，非之邪	刘秀发怒说：你不从事预言，是认为它不对吗
兴惶恐曰：臣于书有所未学，而无所非也	郑兴惶惧，说：我未学过图谶之书，并没有认为它不对
帝意乃解	刘秀的怒气才消
南阳太守杜诗政治清平，兴利除害，百姓便之	南阳太守杜诗，为政清廉公正，兴利除害，百姓安逸无忧
又修治陂池，广拓土田，郡内比室殷足，时人方于召信臣	杜诗又兴修水利，大量开垦荒地，南阳郡内家家户户殷实富足
南阳为之语曰：前有召父，后有杜母	当时的人们把他比作汉元帝时的召信臣，南阳流传着称颂他的歌谣：从前有召父，现在有杜母
春，来歙将二千余人伐山开道，从番须、回中径袭略阳，斩隗嚣守将金梁	春季，来歙率领两千余人伐山开路，从番须、回中径直袭击略阳县，斩隗嚣的守将金梁
嚣大惊曰：何其神也	隗嚣大为震惊，说：怎么这么神速
帝闻得略阳，甚喜，曰：略阳，嚣所依阻，心腹已坏，则制其支体易矣	刘秀听说攻取略阳，非常高兴，说：略阳是隗嚣所依据的屏障，心脏腹部已坏，那么制服他的肢体就容易了
十二月，高句丽王遣使朝贡，帝复其王号	十二月，高句丽王派使者朝贡，刘秀恢复了他的王号
是岁，大水	这一年，发生水灾
隗嚣病且饿，餐糗，恚愤而卒	隗嚣患病，又赶上饥荒，只能吃到黄豆干饭，愤恨而死
王元、周宗立嚣少子纯为王，总兵据冀	王元、周宗拥立隗嚣的幼子隗纯为王，统兵据守冀县
公孙述遣将赵匡、田助纯	公孙述派遣将领赵匡、田协助隗纯
帝使冯异击之	刘秀派遣冯异攻击
夏，六月，丙戌，帝幸缑氏，登辕	夏季，六月丙戌，刘秀到缑氏县，登上辕山
骠骑将军杜茂与贾览战于繁，茂军败绩	骠骑将军杜茂同贾览在繁县交战，杜茂的军队失败
帝召寇恂还，以渔阳太守郭为颍川太守	刘秀征召寇恂回洛阳，任命渔阳太守郭当颍川太守
招降山贼赵宏、召吴等数百人，皆遣归附农；因自劾专命，帝不以咎之	郭招降山贼赵宏、召吴等数百人，全都遣送回乡务农，他因此弹劾自己擅自放回降贼，刘秀没有怪罪他
后宏、吴等党与闻威信，远自江南，或从幽、冀，不期俱降，骆驿不绝	后来，赵宏、召吴等人的同党听到郭的威望和信誉，从遥远的江南，或从幽州、冀州，不约而同都来投降，路途上络绎不绝
莎车王康卒，弟贤立，攻杀拘弥、西夜王，而使康两子王之	莎车王康去世，弟弟贤继位，攻打诛杀拘弥国王、西夜国王，而让康的两个儿子分别担任两国国王
秋，八月，己亥，上幸长安	秋季，八月己亥，刘秀到达长安
庚寅，车驾还宫	庚寅，刘秀回到洛阳
帝还自长安	刘秀从长安返回洛阳
十二月，吴汉自夷陵将三万人溯江而上，伐公孙述	十二月，吴汉从夷陵率领三万大军，逆长江而上，讨伐公孙述
郭为并州牧，过京师，帝问以得失，曰：选补众职，当简天下贤俊，不宜专用南阳人	郭担任并州牧，经过京城洛阳，刘秀询问他为政的得失，郭说：选拔补充各级官吏，应当从全国这个大范围选取贤能和俊杰，不应专用陛下的那些南阳郡同乡
是时在位多乡曲故旧，故言及之	这时担任官职的很多都是刘秀的同乡或故旧，所以郭谈到这一点
秋，七月，冯骏拔江州，获田戎	秋季，七月，东汉将军冯骏攻陷江州，俘获田戎
十二月，辛卯，杨武将军马成行大司空事	十二月辛卯，杨武将军马成代理大司空职务
诏：边吏力不足战则守，追虏料敌，不拘以逗留法	刘秀下诏：边疆官吏如果没有力量交战就采取守势；追击敌人时要估量敌人的情况，或远或近，不要拘泥于军法中的逗留法
春，正月，庚申，大司徒侯霸薨	春季，正月庚申，大司徒侯霸去世
二月，遣捕虏将军马武屯呼沱河以备匈奴	二月，刘秀派遣捕虏将军马武屯军滹沱河，以防备匈奴
庚午，以绍嘉公孔安为宋公，承休公姬常为卫公	庚午，封绍嘉公孔安为宋公，承休公姬常为卫公
三月，辛未，以沛郡太守韩歆为大司徒	三月辛未，刘秀任命沛郡太守韩歆当大司徒
丙子，行大司空马成复为杨武将军	丙子，代理大司空职务的马成又担任杨武将军
益州传送公孙述瞽师、效庙乐器、葆车、舆辇，于是法物始备	益州把公孙述的盲人乐师、祭祀用的乐器、用五采羽毛编成篷盖的车，以及帝王后妃专用的各种车辆等，送到洛阳，于是帝王仪伏所用的器物才开始完备
时兵革既息，天下少事，文书调役，务从简寡，至乃十存一焉	当时战事已经平息，天下少事，各种公文的往来和差役的调遣，力求从简从少，只有从前的十分之一
五月，匈奴寇河东	五月，匈奴侵犯河东郡
秋，会稽大疫	秋季，会稽郡瘟疫流行
丁未，有星孛于昴	丁未，有异星出现在昂宿
以汝南太守欧阳歙为大司徒	刘秀任命汝南太守欧阳歙当大司徒
匈奴寇钞日盛，州郡不能禁	匈奴的侵扰掠夺一天比一天厉害，州、郡无力禁止
二月，遣吴汉率马成、马武等北击匈奴，徙雁门、代郡、上谷吏民六万余口置居庸、常山关以东，以避胡寇	二月，派遣吴汉率领马成、马武等北上打击匈奴
匈奴左部遂复转居塞内，朝廷患之，增缘边兵，部数千人	迁徙雁门郡、代郡、上谷郡的官民六万余人，安置到居庸关、常山关以东，以避开匈奴的骚扰
	匈奴左部于是又转移到边
帝以天下垦田多不以实自占，又户口、年纪互有增减，乃诏下州郡检核	刘秀因为全国的耕地面积自行申报，多不据实，并且户口、年龄都有增减，于是下诏，令各州郡进行检查核实
于是刺史、太守多为诈巧，苟以度田为名，聚民田中，并度庐屋、里落，民遮道啼呼；或优饶豪右，侵刻羸弱	当时州刺史、郡太守多行诡诈，投机取巧，他们胡乱地以丈量土地为名，把农民聚集到田中，连房屋、乡里村落也一并丈量，百姓挡在道路上啼哭呼喊；有的官吏优待豪强，侵害苛待贫弱的百姓
十二月，庚午，以关内侯戴涉为大司徒	十二月庚午，刘秀任命关内侯戴涉当大司徒
卢芳自匈奴复入居高柳	卢芳从匈奴地区又返回内地，住在高柳
是岁，骠骑大将军杜茂坐使军吏杀人，免	这年，骠骑大将军杜茂因指使军官杀人而被免职
使杨武将军马成代茂，缮治障塞，十里一候，以备匈奴	命杨武将军马成代替杜茂的职务
使骑都尉张堪领杜茂营，击破匈奴于高柳	马成修缮要塞，每隔十里有一个烽燧，以防备匈奴进犯
拜堪渔阳太守	刘秀命骑都尉张堪率领杜茂的部队，在高柳击败匈奴
堪视事八年，匈奴不敢犯塞，劝民耕稼，以致殷富	任命张堪为渔阳太守
百姓歌曰：桑无附枝，麦秀两岐	张堪任职八年，匈奴不敢进犯边塞
张君为政	他鼓励百姓从事农业生产，使他们生活富足
乐不可支	百姓用歌颂他：桑树无繁枝，麦子两穗多，张君当太守，百姓真安乐
安平侯盖延薨	安平侯盖延去世
三月，辛丑晦，日有食之	三月，辛丑晦，出现日食
二月，乙未晦，日有食之	二月乙未晦，出现日食
六月，癸巳，临淮怀公衡薨	六月癸巳，临淮怀公刘衡去世
征侧等寇乱连年，诏长沙、合浦、交趾具车船，修道桥，通障溪，储粮谷	征侧等连年为寇作乱，朝廷命长沙、合浦、交趾等郡准备车辆船只，修筑道路、桥梁，打通山间溪谷的道路，储备粮食
拜马援为伏波将军，以扶乐侯刘隆为副，南击交趾	任命马援当伏波将军、扶乐侯刘隆当副统帅，南征交趾
夏，四月，甲戌，车驾还宫	夏季，四月甲戌，刘秀返回洛阳
五月，旱	五月，发生旱灾
卢芳自昌平还，内自疑惧，遂复反，与闵堪相攻连月	卢芳从昌平返回后，内心疑虑恐惧，于是再度反叛，同闵堪互相攻击，连战数月
匈奴遣数百骑迎芳出塞	匈奴派数百名骑兵接卢芳到塞外
芳留匈奴中十余年，病死	卢芳留在匈奴，十余年后，病死
是岁，罢州牧，置刺史	这一年，撤销州牧，设置刺史
五官中郎将张纯与太仆朱浮奏议：礼，为人子，事大宗，降其私亲	五官中郎将张纯和太仆朱浮上奏上建议：按照礼制，既做某人的儿子，就应尊奉大宗，降低自己父母亲的地位
当除今亲庙四，以先帝四庙代之	应当撤除现在章陵的四座父祖祭庙，用陛下即位前四位先帝的祭庙代替
大司徒涉等奏立元、成、哀、平四庙	大司徒戴涉等上奏：请建立元帝、成帝、哀帝、平帝四座祭庙
上自以昭穆次第，当为元帝后	刘秀认为，按照宗族的辈份，他应是元帝刘的后代
马援斩征侧、征贰	马援诛斩征侧、征贰姐妹
闰月，戊申，进赵、齐、鲁三公爵皆为王	闰四月戊申，赵公刘栩、齐公刘章、鲁公刘兴都晋封为王
春，二月，戊子，车驾还宫	春季，二月戊子，刘秀返回洛阳皇宫
夏，四月，庚辰，大司徒戴涉坐入故太仓令奚涉罪，下狱死	夏季，四月庚辰大司徒戴涉被指控陷害前太仓令奚涉，被逮捕入狱，处死
帝以三公连职，策免大司空窦融	刘秀认为三公的职务相连，颁策书免去大司空窦融的职务
匈奴寇上党、天水，遂至扶风	匈奴入侵上党郡、天水郡，到达扶风进犯
冬，十月，甲午，上行幸鲁、东海、楚、沛国	冬季，十月甲午，刘秀前往鲁国、东海国、楚国、沛国
十二月，匈奴寇天水、扶风、上党	十二月，匈奴入侵天水、扶风、上党
壬寅，车驾还宫	壬寅，刘秀返回洛阳皇宫
刘尚进兵与栋蚕等连战，皆破之	刘尚进兵和栋蚕等交战，连战连捷
冬，匈奴寇上谷、中山	冬季，匈奴进犯上谷、中山
夏，五月，乙未晦，日有食之	夏季，五月乙未晦，出现日食
秋，九月，戊辰，地震	秋季，九月戊辰，发生地震
是岁，青州蝗	这一年，青州发生蝗灾
夏，五月，丁卯，大司徒蔡茂薨	夏季，五月丁卯，大司徒蔡茂去世
秋，八月，丙戌，大司空杜林薨	秋季，八月丙戌，大司空杜林去世
九月，辛未，以陈留玉况为大司徒	九月辛未，任命陈留人玉况为大司徒
冬，十月，丙申，以太仆张纯为大司空	冬季，十月丙申，任命太仆张纯为大司空
是岁，鬲侯朱祜卒	同年，鬲侯朱祜去世
祜为人质直，尚儒学；为将多受降，以克定城邑为本，不存首级之功	朱祜为人质朴正直，崇尚儒学，身为将领，他愿意接受敌人投降，以夺取城池为目的，而不贪图用人头报功
又禁制士卒不得虏掠百姓，军人乐放纵，多以此怨之	他还禁止士卒掳掠百姓，而军人喜欢自由放纵，因此对朱祜多怀怨恨
春，正月，乙亥，赦天下	春季，正月乙亥，大赦天下
匈奴八部大人共议立日逐王比为呼韩邪单于，款五原塞，愿永为藩蔽，捍御北虏	匈奴八大部落首领共同议定，拥立日逐王比为呼韩邪单于，派使者前往五原塞，表示愿永远做汉王朝的藩属屏障，抵御北方敌人
事下公卿，议者皆以为天下初定，中国空虚，夷狄情伪难知，不可许	光武帝将此事交付公卿商议
五官中郎将耿国	大家都认为：天下方才安定，中原空虚，而夷狄意图真假难辨，不可应许
独以为宜如孝宣故事，受之，令东捍鲜卑，北拒匈奴，率厉四夷，完复边郡	唯独五官中郎将耿国认为：应当依照孝宣皇帝的先例，接受归附，命他们在东面抵御鲜卑，在北面抗拒匈奴，做四方蛮夷的表率，修复沿边诸郡
帝从之	光武帝听从了耿国的意见
春，正月，辽东徼外貊人寇边，太守祭肜招降之	春季，正月，辽东郡塞外的貊人侵犯边境，太守祭肜招诱他们归降
肜又双财利抚纳鲜卑大都护偏何，使招致异种，骆驿款塞	祭肜还用财物来安抚结纳鲜卑首领偏何，让他招集其他外族部落，陆续到边塞归降
肜曰：审欲立功，当归击匈奴，斩送头首，乃信耳	祭肜说：你们要是真想立功，就应当回去打匈奴，斩下匈奴首领的头送来，我才会信任你们
偏何等即击匈奴，斩首二千余级，持头诣郡	偏何等就去攻打匈奴，斩杀二千余人，将人头献到辽东郡官府
其后岁岁相攻，辄送首级，受赏赐	此后，他们每年都去打匈奴，送来人头，接受赏赐
自是匈奴衰弱，边无寇警，鲜卑、乌桓并入朝贡	匈奴势力从此衰落，而汉王朝边境不再有敌侵的警报，鲜卑、乌桓一同入朝进贡
肜为人质厚重毅，抚夷狄以恩信，故皆畏而爱之，得其死力	祭肜为人质朴敦厚，沉着坚毅，用恩惠和信义招抚外族，因此外族对他既怕又爱，拼死效力
戊申晦，日有食之	三月戊申晦，出现日食
马援军至临乡，击破蛮兵，斩获二千余人	马援的军队到达临乡，攻破蛮兵，斩杀、俘获二千余人
初作寿陵	开始兴建皇陵
帝曰：古者帝王之葬，皆陶人、瓦器、木车、茅马，使后世之人不知其处	光武帝说：古代帝王的随葬之物，全都是陶人、瓦器、木制之车、茅编之马，使后世的人不知道陵墓所在
太宗识终始之义，景帝能述遵孝道，遭天下反覆，而霸陵独完受其福，岂不美哉	文帝明了生死的真义，景帝能够遵从孝道，所以经历了天下大乱的变故之后，霸陵唯独有幸保全，这岂不是美事吗
今所制地不过二三顷，无山陵陂池，裁令流水而已	现在设计的陵墓，占地不过二三顷，不起山陵，不修池，只令不积水而已
使迭兴之后，与丘陇同体	使陵墓在改朝换代之后，能与丘陇泥土成为一体
夏，四月，戊午，大司徒玉况薨	夏季，四月戊午，大司徒玉况去世
五月，丁丑，诏司徒、司空并去大名，改大司马为太尉	五月丁丑，光武帝下诏，命将大司徒、大司空的大字全都去掉，并将大司马改为太慰
骠骑大将军行大司马刘隆即日罢，以太仆赵熹为太尉，大司农冯勤为司徒	将骠骑大将军、代理大司马刘隆即日罢免，任命太仆赵熹为太尉，大司农冯勤为司徒
春，正月，己巳，徙鲁王兴为北海王；以鲁益东海	春季，正月己巳，改封鲁王刘兴为北海王，将鲁国并入东海国
帝以东海王强去就有礼，故优以大封，食二十九县，赐虎贲、旄头，设钟之乐，拟于乘舆	光武帝认为东海王刘强去就有礼，所以对他特别优待，加大封国，食封二十九县，并赐予虎贲武士、骑兵仪仗，以木架钟磬设礼乐，同帝王相仿
夏，六月，丁卯，沛太后郭氏薨	夏季，六月丁卯，沛太后郭氏去世
初，马援兄子婿王磐，平阿侯仁之子也	当初，马援的侄婿王磐是平阿侯王仁的儿子
王莽败，磐拥富赀为游侠，有名江、淮间	王莽败亡之后，王磐拥有巨额资产而成为游侠，闻名于长江、淮河之间
后游京师，与诸贵戚友善，援谓姊子曹训曰：王氏，废姓也，子石当屏居自守，而反游京师长者，用气自行，多所陵折，其败必也	后来他前往京城，与皇亲国戚结为好友
后岁馀，磐坐事死；磐子肃复出入王侯邸第	马援对姐姐的儿子曹训说：王姓是败落之家，王磐本应深居自保，可他反而与京城显贵交往，又意气用事，得罪了很多人，他必遭祸事
时禁罔尚疏，诸王皆在京师，竞修名誉，招游士	过了一年多，王磐获罪被杀，而他的儿子王肃却重新出入王侯府第
马援谓司马吕种曰：建武之元，名为天下重开，自今以往，海内日当安耳	当时禁令还不严密，诸侯王全在京城，竞相博取声誉，招揽宾客
但忧国家诸子并壮而旧防未立，若多通宾客，则大狱起矣	马援对司马吕种说：建武开国，重建天下，从今以后，海内当日益安定
卿曹戒慎之	我只是忧虑皇子们同时长大，而旧有的禁令未能恢复，如果广纳宾客，那么将会大狱兴起了
至是，有上书告肃等受诛之家，为诸王宾客，虑因事生乱	你们要警戒小心
会更始之子寿光侯鲤得幸于沛王，怨刘盆子，结客杀故式侯恭	在这时，有人上书控告王肃等人出身受诛之家，却成为诸侯王们的宾客，恐怕会寻找机会，制造变乱
帝怒，沛王坐系诏狱，三日乃得出	恰巧刘玄之子、寿光侯刘鲤受到沛王宠信，而刘鲤对刘盆子心怀怨恨，纠结宾客杀死了刘盆子之兄、前式侯刘恭
因诏郡县收捕诸王宾客，更相牵引，死者以千数；吕种亦与其祸，临命叹曰：马将军诚神人也	光武帝大怒，沛王因此获罪，囚禁诏狱，三天后才被释放
	于是下诏在全国各郡县搜捕诸
春，二月，丁巳朔，日有食之	春季，二月丁巳朔，发生日食
有星孛于紫宫	紫宫星座出现异星
夏，四月，戊子，徙左翊王焉为中山王	夏季，四月戊子，改封左翊王刘焉为中山王
五月，大水	五月，发生水灾
胶东刚侯贾复薨	胶东刚侯贾复去世
复从征伐，未尝丧败，数与诸将溃围解急，身被十二创	贾复从军征战，从未打过败仗，曾多次同将领们冲破敌围解救急难，身受创伤达十二处
帝以复敢深入，希令远征，而壮其勇节，常自从之，故复少方面之勋	光武帝由于贾复敢于冲锋陷阵，勇猛过度，很少命他出征远行，但赞赏贾复的忠勇，常让他跟随自己，所以贾复少有独当一面的功勋
诸将每论功伐，复未尝有言	每当将领们议论战功，贾复从不开口
帝辄曰：贾君之功，我自知之	光武帝便说：贾君的功劳，我自己知道
夏，五月，大水	夏季，五月，发生水灾
癸酉晦，日有食之	癸酉晦，出现日食
蝗	发生蝗灾
京兆掾第五伦领长安市，公平廉介，市无奸枉	京兆掾第五伦负责管理长安的市，他公平正直，清廉耿介，市中奸邪冤枉之事绝迹
每读诏书，常叹息曰：此圣主也，一见决矣	第五伦每次阅读诏书，总叹息道：这是一位圣明的君主，见一次面便可以决定大事
等辈笑之曰：尔说将尚不能下，安能动万乘乎	同辈们嘲笑他道：你连地方长官都不能说动，又怎能说动皇上
伦曰：未遇知己，道不同故耳	第五伦道：只因没有遇到知己，道不同不能与谋罢了
后举孝廉，补淮阳王医工长	后来，他被推举为孝廉，任淮阳王医工长
三月，戊辰，司空张纯薨	三月戊辰，司空张纯去世
六月，辛卯，以太仆冯鲂为司空	六月辛卯，任命太仆冯鲂为司空
乙未，司徒冯勤薨	六月乙未，司徒冯勤去世
京师醴泉涌出，又有赤草生于水崖，郡国频上甘露	京城有甘泉涌出，又有朱红之草生在水畔，各郡、各封国也纷纷上报天降甘露
群臣奏言：灵物仍降，宜令太史撰集，以传来世	百官奏称：祥瑞频繁降临，应当命令太史予以收集，载入史册，以流传后世
帝不纳	光武帝不采纳这个建议
帝自谦无德，于郡国所上，辄抑而不当，故史官罕得记焉	他谦虚地认为自己并无多少德行，对各郡各封国所上关于祥瑞的奏报，每每表示退让而不敢当，因此史官很少得以记录
秋，郡国三蝗	秋季，有三个郡和封国发生蝗灾
冬，十月，辛未，以司隶校尉东莱李为司徒	冬季，十月辛未，任命司隶校尉、东莱人李为司徒
甲申，使司空告祠高庙，上薄太后尊号曰高皇后，配食地祗	十月甲申，命令司空在汉高祖庙祭祀禀告：尊称薄太后为高太后，在地神之旁配享祭飨
迁吕太后庙主于园，四时上祭	将吕太后的牌位迁到墓园，保留四季的祭祀
十一月，甲子晦，日有食之	十一月甲子晦，出现日食
春，正月，辛未，初立北郊，祀后土	春季，正月辛未，在京城北郊始立社坛，祭祀后土神
太子即皇帝位，尊皇后曰皇太后	皇太子刘庄即帝位，将阴皇后尊称为皇太后
三月，丁卯，葬光武皇帝于原陵	三月丁卯，将光武帝葬在原陵
是岁，南单于莫死，弟汗立，为伊伐於虑单于	本年，南匈奴单于莫去世，他的弟弟汗继位，此即伊伐於虑单于
夏，五月，高密元侯邓禹薨	夏季，五月，高密元侯邓禹去世
好愍侯耿薨	好愍侯耿去世
是岁，初迎气于五郊	本年，第一次举行五郊迎气典礼
新阳侯阴就子丰尚郦邑公主	新阳侯阴就之子阴丰娶郦邑公主为妻，公主骄横嫉妒，阴丰将她杀死，因此获罪被诛
公主骄妒，丰杀之，被诛，父母皆自杀	他的父母阴就夫妇自杀
南单于汗死，单于比之子适立，为僮尸逐侯单于	南匈奴单于汗去世，前单于比的儿子适继位，此即僮尸逐侯单于
春，二月，甲寅，太尉赵熹、司徒李免	春季，二月甲寅，将太尉赵熹、司徒李免职
丙辰，以左冯郭丹为司徒	二月丙辰，任命左冯翊郭丹为司徒
己未，以南阳太守虞延为太尉	二月己未，任命南阳太守虞延为太尉
甲子，立贵人马氏为皇后，皇子为太子	二月甲子，将贵人马氏立为皇后，皇子刘立为太子
夏，四月，辛酉，封皇子建为千乘王，羡为广平王	夏季，四月辛酉，将皇子刘建封为千乘王，刘羡封为广平王
六月，丁卯，有星孛于天船北	六月丁卯，天船星座北方出现异星
秋，八月，戊辰，诏改太乐官曰太予，用谶文也	秋季，八月戊辰，明帝下诏：依照谶文，将太乐官改称为太予
壬申晦，日有食之	壬申晦，出现日食，明帝下诏：从前楚庄王因本国无灾而生怕上天遗忘了自己，以至生出警戒恐惧之心；鲁哀公昏庸乱政，但因无可挽救，上天也没有降下灾异进行谴责
诏曰：昔楚庄无灾，以致戒惧，鲁哀祸大，天不降谴	如今出现了日食，表示我们或许还可以救药
今之动变，傥尚可救，有司勉思厥职，以匡无德	各部门主管官员要努力尽心于职责，以助我完成天子的重任
是岁，京师及郡国七大水	本年，京城洛阳及七个郡和封国发生水灾
冬，十月，乙卯，司徒郭丹、司空冯鲂免，以河南尹沛国范迁为司徒，太仆伏恭为司空	冬季，十月乙卯，将司徒郭丹、司空冯鲂免职，将河南尹、沛国人范迁任命为司徒，太仆伏恭任命为司空
恭，湛之兄子也	伏恭是伏湛哥哥的儿子
陵乡侯梁松坐怨望、县飞书诽谤，下狱死	陵乡侯梁松因怨恨朝廷、悬挂匿名书进行诽谤而被捕入狱，处以死刑
十一月，北匈奴寇五原；十二月，寇云中，南单于击却之	十一月，北匈奴侵犯五原郡；十二月，侵犯云中郡，被南匈奴单于击退
是岁，发遣边民在内郡者，赐装钱，人二万	本年，征发遣返迁到内地的边疆居民，赏赐治装费，每人二万钱
春，正月，癸卯，皇太后阴氏崩	春季，正月癸卯，皇太后阴氏驾崩
二月，庚申，葬光烈皇后	二月庚申，光烈皇后阴氏入葬
春，正月，己卯，司徒范迁薨	春季，正月己卯，司徒范迁去世
三月，辛卯，以太尉虞延为司徒，卫尉赵熹行太尉事	三月辛卯，将太尉虞延任命为司徒，命卫尉赵熹代理太尉职务
秋，郡国十四大水	秋季，十四个郡和封国发生水灾
冬，十月，北宫成	冬季，十月，北宫落成
壬寅晦，日有食之，既	十月壬寅晦，出现日全食
诏群司勉修职事，极言无讳	明帝下诏，勉励百官各尽职守，用最直率的态度批评朝政而无所忌讳
于是在位者皆上封事，各言得失；帝览章，深自引咎，以所上班示百官	于是官员们全都呈上密封的奏章，各自议论朝政的得失
诏曰：群僚所言，皆朕之过	明帝观看奏章，深自责备，便将这些奏章向百官公布，并下诏说：群臣指摘之事，都是朕的过错
民冤不能理，吏黠不能禁；而轻用民力，缮修宫宇，出入无节，喜怒过差	人民冤屈不能申雪，贪官污吏不能查禁，却轻率地使用民力，营建宫室，开支与征税无节制，而且喜怒无常
永览前戒，竦然兢惧；徒恐薄德，久而致怠耳	回顾古人的鉴戒，十分恐惧，只怕朕品德寡薄，日久生怠
是岁，大有年	本年，粮食大丰收
赐皇子恭号曰灵寿王，党号曰重熹王，未有国邑	明帝将皇子刘恭赐号为灵寿王，皇子刘党赐号为重熹王，都没有封国
帝崇尚儒学，自皇太子诸王侯及大臣子弟、功臣子孙，莫不受经	明帝尊崇儒学，上自太子、诸王、侯爵，下至高官的子弟、功臣的子孙，无人不学习儒家经典
又为外戚樊氏、郭氏、阴氏、马氏诸子立学于南宫，号国姓小侯	明帝还为外戚樊氏、郭氏、阴氏、马氏的儿子们在南宫设立学校，这些学生号称四姓小侯
置《五经》师，搜选高能以授其业	明帝给他们安排讲解儒家《五经》的老师，寻找选拔学问高超的贤才授课
自期门、羽林之士，悉令通《孝经》章句	即便是期门、羽林等禁卫武官，也都命令通晓《孝经》章句的含义
匈奴亦遣子入学	匈奴也派出贵族子弟到汉朝学习
春，二月，广陵思王荆自杀，国除	春季，二月，广陵王刘荆自杀，封国撤除
夏，四月，戊子，赦天下	夏季，四月戊子，大赦天下
是时，天下安平，人无徭役，岁比登稔，百姓殷富，粟斛三十，牛羊被野	此时，天下太平，无人服事徭役，粮食连年丰收，百姓殷实富裕，谷价每斛三十钱，牛羊遍野
	十三年
冬，十月，壬辰晦，日有食之	冬季，十月壬辰晦，出现日食
楚王英至丹阳，自杀	楚王刘英抵达丹阳郡后自杀
诏以诸侯礼葬于泾	明帝下诏，命令以诸侯之礼将他葬在泾县
封燕广为折奸侯	将燕广封为折奸侯
夏，五月，对故广陵王荆子元寿为广陵侯，食六县	夏季，五月，将已故广陵王刘荆的儿子刘元寿封为广陵侯，享有六县食邑
又封窦融孙嘉为安丰侯	又将窦融的孙子窦嘉封为安丰侯
乙巳，赦天下	四月乙巳，大赦天下
戊午晦，日有食之	五月戊午晦，出现日食
六月，丙寅，以大司农西河王敏为司徒	六月丙寅，将大司农西河人王敏任命为司徒
二月，乙巳，司徒王敏薨	二月乙巳，司徒王敏去世
三月，癸丑，以汝南太守鲍昱为司徒	三月癸丑，将汝南太守鲍昱任命为司徒
昱，永之子也	鲍昱是鲍永之子
春，二月，诏窦固等罢兵还京师	春季，二月，明帝下诏，命令窦固等解散部队，返回京城洛阳
夏，六月，己未，有星孛于太微	夏季，六月己未，太微星处出现异星
八月，壬子，帝崩于东宫前殿，年四十八	八月壬子，明帝在东宫前殿驾崩，年四十八岁
遣诏：无起寝庙，藏主于光烈皇后更衣别室	遣诏说：不要为我兴建寝殿祭庙，可将牌位放在阴太后陵寝的便殿中
太子即位，年十八	太子即帝位，年十八岁
尊皇后曰皇太后	将马皇后尊称为皇太后
壬戌，葬孝明皇帝于显节陵	八月壬戌，将明帝安葬在显节陵
冬，十月，丁未，赦天下	冬季，十月丁未，大赦天下
诏以行太尉事节乡侯熹为太傅，司空融为太尉，并录尚书事	章帝下诏，将代理太尉职务的节乡侯赵熹任命为太傅，将司空牟融任命为太尉，一同主管尚书事务
十一月，戊戌，以蜀郡太守第五伦为司空	十一月戊戌，将蜀郡太守第五伦任命为司空
伦在郡公清，所举吏多得其人，故帝自远郡用之	第五伦在蜀郡时，为官公正清廉，所举荐的官吏多能称职胜任，所以章帝将他从边远之郡调到朝廷任用
甲辰晦，日有食之	十一月甲辰晦，出现日食
是岁，京师及兖、豫、徐州大旱	本年，京城及兖州、豫州、徐州出现大旱
春，正月，诏兖、豫、徐三州禀赡饥民	春季，正月，章帝下诏，命令兖州、豫州、徐州等三州官府开仓赈济饥饿的难民
上问司徒鲍昱：何以消复旱灾	章帝问司徒鲍昱：怎样消除旱灾
对曰：陛下始践天位，虽有失得，未能致异	鲍昱答道：陛下刚即位，即使有失当之处，也不会导致灾异出现
臣前为汝南太守，典治楚事，系者千余人，恐未能尽当其罪	我先前曾任汝南太守，负责审理楚王之案，在当地拘禁了一千多人，这些囚犯恐怕不是全都有罪
夫大狱一起，冤者过半	大案一发，被冤枉者往往超过半数
又，诸徙者骨肉离分，孤魂不祀	此外，由于被流放的人和亲属分离，死后的孤魂得不到祭祀
宜一切还诸徙家，蠲除禁锢，使死生获所，则和气可致	我建议，让流放者全都返回家乡，除去不准作官的禁令，使死者生者各得其所，这样便可召致祥和之气，消除旱象
帝纳其言	章帝采纳了他的建议
甲寅，山阳、东平地震	三月甲寅，山阳、东平两地发生地震
秋，八月，庚寅，有星孛于天市	秋季，八月庚寅，天市星座出现异星
永昌、越、益州三郡兵及昆明夷卤承等击哀牢王类牢于博南，大破，斩之	永昌、越、益州三郡郡兵及昆明夷人卤承等在博南进攻哀牢王类牢，大败哀牢军，斩杀类牢
夏，四月，戊子，诏还坐楚、淮阳事徙者四百余家	夏季，四月戊子，章帝下诏，准许因楚王之案、淮阳王之案而被流放的四百余户返回故乡
十二月，戊寅，有星孛于紫宫	十二月戊寅，紫宫星座出现异星
帝纳窦勋女为贵人，有宠	章帝将窦勋的女儿选为贵人，十分宠幸
贵人母，即东海恭王女阳公主也	窦贵人的母亲，就是东海恭王刘强的女儿阳公主
三月，癸巳，立贵人窦氏为皇后	三月癸巳，将贵人窦氏立为皇后
闰月，西域假司马班超率疏勒、康居、于、拘弥兵一万人攻姑墨石城，破之，斩首七百级	闰九月，西域副司马班超率领疏勒、康居、于阗、拘弥等国军队，共一万人，进攻姑墨国石城，将石城攻破，斩杀七百人
冬，十二月，丁酉，以马防为车骑将军	冬季，十二月丁酉，任命马防为车骑将军
武陵中蛮反	武陵郡中蛮人反叛
春，二月，庚寅，太尉牟融薨	春季，二月庚寅，太尉牟融去世
夏，四月，戊子，立皇子庆为太子	夏季，四月戊子，将皇子刘庆立为太子
己丑，徙钜鹿王恭为江陵王，汝南王畅为梁王，常山王为淮阳王	四月己丑，章帝将钜鹿王刘恭改封为江陵王，汝南王刘畅改封为梁王，常山王刘改封为淮阳王
辛卯，封皇子伉为千乘王，全为平春王	四月辛卯，章帝将皇子刘伉封为千乘王，皇子刘全封为平春王
甲戌，以司徒鲍昱为太尉，南阳太守桓虞为司徒	五月甲戌，将司徒鲍昱任命为太尉，将南阳太守桓虞任命为司徒
六月，癸丑，皇太后马氏崩	六月癸丑，皇太后马氏驾崩
帝既为太后所养，专以马氏为外家，故贾贵人不登极位，贾氏亲族无受宠荣者	章帝被马太后抱养以后，只认马氏家族为外家，所以章帝的生母贾贵人不能登御太后之位，贾氏家族没有一人蒙受恩宠荣耀
及太后崩，但加贵人王赤绶，安车一驷，永巷宫人二百，御府杂帛二万匹，大司农黄金千斤，钱二千万而已	及至太后驾崩，章帝只将贾贵人的绿色绶带改为与诸侯王同级的红色绶带，并赐四马牵拉的座车一辆，永巷宫女二百人，御府各色丝绸二万匹，大司农所藏黄金一千斤，钱两千万，如此而已
秋，七月，壬戌，葬明德皇后	秋季，七月壬戌，安葬马太后
荆、豫诸郡兵讨中蛮，破之	荆州、豫州诸郡郡兵讨伐中蛮人，打败蛮人叛军
戊辰，太傅赵熹薨	五月戊辰，太傅赵熹去世
春，二月，辛卯，琅邪孝王京薨	春季，二月辛卯，琅邪王刘京去世
夏，六月，丙辰，太尉鲍昱薨	夏季，六月丙辰，太尉鲍昱去世
辛未晦，日有食之	六月辛未晦，出现日食
秋，七月，癸巳，以大司农邓彪为太尉	秋季，七月癸巳，将大司农邓彪任命为太尉
己未，徙广平王羡为西平王	六月己未，将广平王刘羡改封为西平王
春，正月，壬辰，王薨	春季，正月壬辰，东平王刘苍去世
诏告中傅封上王自建武以来章奏，并集览焉	章帝下诏，命令东平国中傅：将东平王自建武以来的奏章加封上送，我要集中阅览
遣大鸿胪持节监丧，令四姓小侯、诸国王、主悉会葬	并派大鸿胪持符节主持治丧，命令樊、阴、郭、马四姓小侯和各封国的亲王、公主都去参加葬礼
夏，六月，北匈奴三木楼訾大人稽留斯等率三万余人款五原塞降	夏季，六月，北匈奴三木楼訾大人稽留斯等，率三万余人到五原塞归降
春，闰正月，辛丑，济阴悼王长薨	春季，闰正月辛丑，济阴悼王刘长去世
夏，四月，己卯，分东平国，封献王子尚为任城王	夏季，四月己卯，分出东平国部分封土，将前东平王刘苍之子刘尚封为任城王
六月，辛酉，沛献王辅薨	六月辛酉，沛献王刘辅去世
八月，甲子，太尉邓彪罢，以大司农郑弘为太尉	八月甲子，将太尉邓彪免官，任命大司农郑弘为太尉
癸酉，诏改元	八月癸酉，下诏改变年号
丁酉，车驾南巡	八月丁酉，章帝到南方巡视
诏：所经道上州县，毋得设储	下诏说：沿途所经各州、各县，不得事先积蓄用品
命司空自将徒支拄桥梁	命司空自带工人修架桥梁
有遣使奉迎，探知起居，二千石当坐	若有派遣使者接驾，打探行踪动静的，要向郡太守问罪
十二月，壬子，诏：前以妖恶禁锢三属者，一皆蠲除之，但不得在宿卫而已	十二月壬子，章帝下诏：以往因犯有妖言惑众之罪，而父族、母族、妻族遭到禁锢而不准做官的，一律解除禁锢，只是不准到宫廷值宿警卫
南单于长死，单于汗之宣立，为伊屠于闾单于	南匈奴单于长去世，前单于汗的儿子宣继位，此即伊屠於闾单于
五月，徙江陵王恭为六安王	五月，章帝将江陵王刘恭改封为六安王
春，正月，丙申，帝北巡；辛丑，耕于怀；二月，乙丑，敕侍御史、司空曰：方春，所过毋得有所伐杀；车可以引避，引避之，马可辍解，辍解之	春季，正月丙申，章帝到北方巡视
戊辰，进幸中山，出长城；癸酉，还，幸元氏；三月，己卯，进幸赵；辛卯，还宫	正月辛丑，在怀县举行耕藉之礼
	二月乙丑
以大司农宋由为太尉	将大司农宋由任命为太尉
秋，八月，乙丑，帝幸安邑，观盐池	秋季，八月乙丑，章帝临幸安邑，视察盐池
九月，还宫	九月，返回京城皇宫
楚许太后薨	楚国许太后去世
诏改葬楚王英，追爵谥曰楚厉侯	章帝下诏，改建楚王刘英之墓，将他追封为楚厉侯
博士鲁国曹褒上疏，以为宜定文制，著成汉礼	博士鲁国人曹褒上书指出：应当建立典章制度，编写汉朝礼仪大典
太常巢堪以为一世大典，非褒所定，不可许	太常巢堪认为：这是一代大典，非曹褒这样地位的人所能制定，不可应许
帝知诸儒拘挛，难与图始，朝廷礼宪，宜以时立，乃拜褒侍中	章帝知道儒生拘谨，难以一同创新，而朝廷的礼仪规章，却应当及时确立，于是就任命曹褒为侍中
玄武司马班固以为宜广集诸儒，共议得失	玄武司马班固认为：应当广招儒家各派学者，综合不同的意见，共同讨论
帝曰：谚言：作舍道边，三年不成	章帝说：俗话说：路边建房，三年不成
会礼之家，名为聚讼，互生疑异，笔不得下	众人会商讨论礼仪制度，就像在一起吵架，相互生出各种疑问和分歧，无法下笔
昔尧作《大章》，一夔足矣	从前舜帝作《大章》时，有夔一人就足够了
春，正月，帝召褒，受以叔孙通《汉仪》十二篇，曰：此制散略，多不合经，今宜依礼修正，使可施行	春季，正月，章帝召见曹褒，将叔孙通制定的《汉仪》十二篇交给他，说道：这套制度松散精略，多与儒家经义不合，现在应当依据正规礼仪一一订正，使它能够颁布实施
夏，六月，戊辰，司徒桓虞免	夏季，六月戊辰，将司徒桓虞免官
癸卯，以司空袁安为司徒，光禄勋任隗为司空	六月癸卯，将司空袁安任命为司徒，将光禄勋任隗任命为司空
隗，光之子也	任隗是任光之子
齐王晃及弟利侯刚，与母太姬更相诬告	齐王刘晃和弟弟利侯刘刚，与他们的母亲太姬互相诬告
秋，七月，癸卯，诏贬晃爵为芜湖侯，削刚户三千，收太姬玺绶	秋季，七月癸卯，章帝下诏，将刘晃的爵位贬为芜湖侯，将刘刚的封地削减三千户，收回太姬的玺印绶带
壬子，淮阳顷王薨	七月壬子，淮阳顷王刘去世
鲜卑入左地，击北匈奴，大破之，斩优留单于而还	鲜卑部族进入北匈奴东部地区，并发动攻击，大败北匈奴，斩杀优留单于后返回故地
北匈奴大乱，屈兰储等五十八部、口二十八万诣云中、五原、朔方、北地降	北匈奴发生大乱，屈兰储等五十八个部落、人口二十八万，到云中、五原、朔方、北地归降
曹褒依准旧典，杂以《五经》、《谶记》之文，撰次天子至于庶人冠、婚、吉、凶终始制度凡百五十篇，奏之	曹褒以旧典为基础，加入儒家《五经》和《谶记》上的记载，依次编写由皇帝到平民的成年加冠礼、婚嫁礼、祭祀礼、丧葬凶灾礼等仪程，共一百五十篇，奏报章帝
帝以众论难一，故但纳之，不复令有司平奏	章帝认为众人的意见很难统一，所以就接受了曹褒制定的典章，不再命有关部门进行评议
三月，用遗诏徙西平王羡为陈王，六安王恭为彭城王	三月，根据章帝遗诏，将西平王刘羡改封为陈王，将六安王刘恭改封为彭城王
癸卯，葬孝章皇帝于敬陵	三月癸卯，将章帝安葬于敬陵
南单于宣死，单于长之弟屯屠何立，为休兰尸逐侯单于	南匈奴单于宣去世，前单于长的弟弟屯屠何继位，此即休兰尸逐侯单于
癸亥，陈王羡、彭城王恭、乐成王党、下邳王衍、梁王畅始就国	癸亥，陈王刘羡、彭城王刘恭、乐成王刘党、下邳王刘衍、梁王刘畅开始前往封国就位
夏，四月，戊寅，以遗诏罢郡国盐铁之禁，纵民煮铸	夏季，四月戊寅，根据章帝遗诏，撤销各郡各封国盐铁专卖的规定，允许民间煮盐铸铁，自由经营
五月，京师旱	五月，京城发生旱灾
秋，七月，乙未，会稽山崩	秋季，七月乙未，会稽发生山崩
冬，十月，庚子，阜陵质王延薨	冬季，十月庚子，阜陵质王刘延去世
是岁，郡国九大水	本年，九个郡和封国发生水灾
	二年
春，正月，丁丑，赦天下	春季，正月丁丑，大赦天下
二月，壬午，日有食之	二月壬午，出现日食
窦宪遣副校尉阎砻将二千余骑掩击北匈奴之守伊吾者，复取其地	窦宪派副校尉阎砻率领骑兵二千余人袭击北匈奴在伊吾的守军，重新占领该地
车师震慑，前、后王各遣子入侍	车师深感震恐，前后王国的国王都分别派遣王子到汉朝充当人质
冬，十月，癸未，上行幸长安，诏求萧、曹近亲宜为嗣者，绍其封邑	冬季，十月癸未，和帝出行，临幸长安，下诏在萧何、曹参的近亲中寻访适合做后嗣的人，继承萧、曹的封土
春，正月，遣大将军左校尉耿夔授于除印绶，使中郎将任尚持节卫护屯伊吾，如南单于故事	春季，正月，派遣大将军左校尉耿夔授予北匈奴于除印信绶带，命中郎将任尚持符节护卫，屯驻伊吾，一如南匈奴单于先例
三月，癸丑，司徒袁安薨	三月癸丑，司徒袁安去世
闰月，丁丑，以太常丁鸿为司徒	闰三月丁丑，将太常丁鸿任命为司徒
夏，四月，丙辰，窦宪还至京师	夏季，四月丙辰，窦宪回到京城洛阳
丙辰，郡国十三地震	丙辰，有十三个郡和封国发生地震
旱，蝗	发生旱灾和蝗灾
八月，辛亥，司空任隗薨	八月辛亥，司空任隗去世
冬，十月，以宗正刘方为司空	冬季，十月，将宗正刘方任命为司空
武陵、零陵、澧中蛮叛	武陵、零陵、澧中蛮人反叛
戊子，千乘贞王伉薨	戊子，千乘贞王刘伉去世
辛卯，封皇弟万岁为广宗王	辛卯，将皇弟刘万岁封为广宗王
甲寅，太傅邓彪薨	甲寅，太傅邓彪去世
戊午，陇西地震	戊午，陇西郡发生地震
夏，四月，壬子，绍封阜陵殇王兄鲂为阜陵王	夏季，四月壬子，将已故阜陵殇王刘冲的哥哥刘鲂封为阜陵王
九月，辛酉，广宗殇王万岁薨	九月辛酉，广宗王刘万岁去世
无子，国除	因无子嗣，封国撤除
冬，十月，辛未，太尉尹睦薨	冬季，十月辛未，太尉尹睦去世
是岁，武陵郡兵破叛蛮，降之	本年，武陵郡郡兵打败叛乱的蛮人，接受蛮人投降
护羌校尉贯友遣译使构离诸羌，诱以财货，由是解散	护羌校尉贯友派翻译官做使者，离间羌人诸部落，并用财物进行引诱，羌人诸部落联盟因此瓦解
乃遣兵出塞，攻迷唐于大、小榆谷，获首虏八百余人，收麦数万斛，遂夹逢留大河筑城坞，作大航，造河桥，欲度兵击迷唐	于是贯友派兵出塞，在大、小榆谷对迷唐展开进攻，斩杀及俘虏八百余人，缴获小麦数万斛，然后又在逢留大河两岸修筑城堡，制造大船，兴建河桥，打算派兵渡河去追击迷唐
迷唐率部落远徙，依赐支河曲	迷唐率领部落向远方迁徙，到达赐支河曲
己卯，司徒丁鸿薨	正月己卯，司徒丁鸿去世
二月，丁未，以司空刘方为司徒，太常张奋为司空	二月丁未，将司空刘方任命为司徒，将太常张奋任命为司空
秋，七月，京师旱	秋季，七月，京城发生旱灾
夏，四月，辛亥朔，日有食之	夏季，四月辛刻朔，出现日食
秋，七月，乙巳，易阳地裂	秋季，七月乙巳，易阳发生地裂
九月，癸卯，京师地震	九月癸卯，京城洛阳发生地震
乐成王党坐贼杀人，削东光、二县	乐成王刘党被指控有杀人之罪，削去封国的东光、县二县
	八年
五月，河内、陈留蝗	五月，河内、陈留两郡发生蝗灾
南匈奴右温禺犊王乌居战畔出塞	南匈奴右温禺犊王乌居战反叛出塞
秋，七月，度辽将军庞奋、越骑校尉冯柱追击破之，徙其余众及诸降胡二万余人于安定、北地	秋季，七月，度辽将军庞奋、越骑校尉冯柱出兵追击，打败乌居战，将他的残余部众及归降的匈奴部落二万余人迁徙到安定、北地二郡
车师后部王涿反，击前王尉毕大，获其妻子	车师后部王涿反叛，攻击车师前王尉毕大，俘虏了尉毕大的妻子儿女
九月，京师蝗	九月，京城洛阳发生蝗灾
冬，十月，乙丑，北海王威以非敬王子，又坐诽谤，自杀	冬季，十月乙丑，北海王刘威由于不是前北海王刘睦的亲子，并被指控犯有诽谤之罪，因而自杀
十二月，辛亥，陈敬王羡薨	十二月辛亥，陈敬王刘羡去世
丁巳，南宫宣室殿火	丁巳，南宫宣室殿失火
春，三月，庚辰，陇西地震	春季，三月庚辰，陇西郡发生地震
癸巳，济南安王康薨	癸巳，济南安王刘康去世
西域长史王林击车师后王，斩之	西域长史王林进攻车师后王，将他斩杀
夏，四月，丁卯，封乐成王党子巡为乐成王	夏季，四月丁卯，将乐成王刘党的儿子刘巡封为乐成王
五月，封皇后父屯骑校尉阴纲为吴房侯，以特进就第	五月，将皇后的父亲、屯骑校尉阴纲封为吴房侯，阴纲以特进身份离开官位，前往邸第
六月，旱，蝗	六月，发生旱灾和蝗灾
十一月，癸卯，以光禄勋河南吕盖为司徒	十一月癸卯，将光禄勋、河南人吕盖任命为司徒
十二月，丙寅，司空张奋罢	十二月丙寅，将司空张奋免官
壬申，以太仆韩棱为司空	十二月壬申，将太仆韩棱任命为司空
夏，五月，京师大水	夏季，五月，京城洛阳发生水灾
秋，七月，己巳，司空韩棱薨	秋季，七月己巳，司空韩棱去世
八月，丙子，以太常太山巢堪为司空	八月丙子，将太常太山人巢堪任命为司空
冬，十月，五州雨水	冬季，十月，有五个州大雨成灾
戊寅，梁节王畅薨	戊寅，梁节王刘畅去世
南单于师子死，单于长之子檀立，为万氏尸逐单于	南匈奴单于师子去世，前单于长的儿子檀继位，此即万氏尸逐单于
	十一年
夏，四月，丙寅，赦天下	夏季，四月丙寅，大赦天下
夏，四月，戊辰，秭归山崩	夏季，四月戊辰，秭归山发生山崩
秋，七月，辛亥朔，日有食之	秋季，七月辛亥朔，出现日食
九月，戊午，太尉张免	九月戊午，将太尉张免职
丙寅，以大司农张禹为太尉	丙寅，将大司农张禹任命为太尉
秋，八月，己亥，北宫盛馔门阁火	秋季，八月己亥，洛阳北宫盛馔门楼失火
迷唐复还赐支河曲，将兵向塞	迷唐又回到赐支河曲，率兵接近汉朝边塞
护羌校尉周鲔与金城太守侯霸及诸郡兵、属国羌、胡合三万人至允川	护羌校尉周鲔和金城太守侯霸，率领各郡郡兵、附属国的羌兵、胡兵，共三万人，到达允川
侯霸击破迷唐，种人瓦解，降者六千余口，分徙汉阳、安定、陇西	侯霸打败迷唐，烧当部落瓦解，六千余人投降，将他们分别迁徙到汉阳、安定和陇西
迷唐遂弱，远逾赐支河首，依发羌居	迷唐从此势力衰弱，他越过赐支河源头远逃，投靠到发羌部落定居
久之，病死，其子来降，户不满数十	多年以后，迷唐病死，他的儿子前来归降，部众已不足数十户
荆州雨水	荆州大雨成灾
戊辰，司徒吕盖以老病致仕	戊辰，司徒吕盖因年老患病退休
三州大水	有三个州发生水灾
丁酉，司空巢堪罢	十月丁酉，和帝将司空巢堪罢免
是岁，初封大长秋郑众为乡侯	本年，和帝打破常例，首次将大长秋郑众封为乡侯
	十五年
四州雨水	有四个州大雨成灾
是岁，初令郡国以日北至按薄刑	本年，首次命令各郡、各封国从夏至日开始审理轻刑案件
	十六年
秋，七月，旱	秋季，七月，发生旱灾
辛酉，司徒鲁恭免	辛酉，将司徒鲁恭免职
十一月，己丑，帝行幸缑氏，登百山	十一月己丑，和帝出行，临幸缑氏，登上百山
北匈奴遣使称臣贡献，愿和亲，修呼韩邪故约	北匈奴派遣使者称臣进贡，愿意和亲通好，请求重新修订呼韩邪单于00时代的旧约
帝以其旧礼不备，未许；而厚加赏赐，不答其使	和帝认为北匈奴不具备呼韩邪单于的礼数，没有接受请求，只给厚重的赏赐，不派使者回报
	元兴元年
夏，四月，庚午，赦天下，改元	夏季，四月庚午，大赦天下，改年号
秋，九月，辽东太守耿夔击高句骊，破之	秋季，九月，辽东郡太守耿夔进攻高句丽，将高句丽军打败
北匈奴重遣使诣敦煌贡献，辞以国贫未能备礼，愿请大使，当遣子入侍	北匈奴再次派遣使者到敦煌进贡，解释说：由于我国贫穷，不能礼数周全，希望能请汉朝使者前来，北匈奴将派遣王子到汉朝充当人质
太后亦不答其使，加赐而已	邓太后也没有派使者回报，只给予赏赐而已
封皇兄胜为平原王	将皇兄刘胜封为平原王
癸卯，以光禄勋梁鲔为司徒	正月癸卯，将光禄勋梁鲔任命为司徒
三月，甲申，葬孝和皇帝于慎陵，庙曰穆宗	三月甲申，将和帝安葬在慎陵，庙号称为穆宗
丙寅，以虎贲中郎将邓骘为车骑将军、仪同三司	丙寅，将虎贲中郎将邓骘任命为车骑将军、仪同三司，待遇与三公相同
骘弟黄门侍郎悝为虎贲中郎将，弘、阊皆侍中	将邓骘的弟弟、黄门侍郎邓悝任命为虎贲中郎将，邓弘、邓阊二人皆为侍中
司空陈宠薨	司空陈宠去世
五月，辛卯，赦天下	五月辛卯，大赦天下
壬辰，河东垣山崩	壬辰，河东郡垣山发生山崩
六月，丁未，以太常尹勤为司空	六月丁未，将太常尹勤任命为司空
郡国三十七雨水	有三十七个郡和封国大雨成灾
丁卯，诏免遣掖庭宫人及宗室没入者皆为庶民	六月丁卯，下诏遣散掖庭部分宫人，并将罚入掖庭当奴婢的皇族成员一律免罪，使他们成为平民
秋，七月，庚寅，敕司隶校尉、部刺史曰：间者郡国或有水灾，妨害秋稼，朝廷惟咎，忧惶悼惧	秋季，七月庚寅，敕令司隶校尉和部刺史：近来有些郡和封国发生水灾，伤害了秋天的庄稼，朝廷思考自己的过失，深为忧虑惶恐
而郡国欲获丰穰虚饰之誉，遂覆蔽灾害，多张垦田，不揣流亡，竞增户口，掩匿盗贼，令奸恶无惩，署用非次，选举乖宜，贪苛惨毒，延及平民	然而各地方官府为了要得到丰产的虚名假誉，便隐瞒灾情，夸大垦田面积；不去统计逃亡人数，却竞相增加户口；掩盖盗匪活动情况，使罪犯得不到惩处；不依照规定次序任用官吏，举荐人才不当，将贪婪苛刻的祸害，加在人民的身上
刺史垂头塞耳，阿私下比，不畏于天，不愧于人	而刺史却低头塞耳，循私包庇，在下面互相勾结，不知畏惧上天，也不知愧对于人
假贷之恩，不可数恃，自今以后，将纠其罚	不能让他们一再地仗恃朝廷的宽容恩典，从今以后，将加重对不法官员的处罚
二千石长吏其各实核所伤害，为除田租刍稿	现命令二千石官员各自核查百姓受灾情况，免除他们应向国家交付的田赋禾秆
九月，六州大水	九月，有六个州发生水灾
丙寅，葬孝殇皇帝于康陵	丙寅，将殇帝安葬于康陵
以连遭大水，百姓苦役，方中秘藏及诸工作事，减约十分居一	因国家接连遭受水灾，人民苦于徭役，所以陵墓中的随葬之物及各项工程都予以裁减，只留十分之一
乙亥，殒石于陈留	乙亥，陈留郡天降陨石
冬，十月，四州大水，雨雹	冬季，十月，有四个州发生水灾和雹灾
清河孝王庆病笃，上书求葬樊濯宋贵人冢旁	清河王刘庆病重，上书请求死后葬在樊濯宋贵人墓旁
十二月，甲子，王薨	十二月甲子，刘庆去世
乙酉，罢鱼龙曼延戏	十二月乙酉，废止杂戏鱼龙曼延
春，正月，癸酉朔，赦天下	春季，正月癸酉朔，大赦天下
蜀郡徼外羌内属	蜀郡边境外的羌人归附汉朝
二月，丁卯，分清河国封帝弟常保为广川王	二月丁卯，分割清河国部分封土，将安帝的弟弟刘常保封为广川王
庚午，司徒梁鲔薨	庚午，司徒梁鲔去世
三月，癸酉，日有食之	三月癸酉，出现日食
已卯，永昌徼外僬侥种夷陆类等举种内附	已卯，永昌郡边境外夷人僬侥部落的首领陆类等人，率领全体部众归附汉朝
甲申，葬清河孝王于广丘，司空、宗正护丧事，仪比东海恭王	三月甲申，将清河孝王刘庆安葬在广丘，由司空、宗正负责治丧，礼仪比照东海恭王刘强
丁丑，诏封北海王睦孙寿光侯普为北海王	丁丑，邓太后下诏，将前北海王刘睦的孙子、寿光侯刘普封为北海王
九真徼外、夜郎蛮夷，举土内属	九真郡边境外的蛮夷及夜郎国蛮夷，以全部领土归属汉朝
西域都护段禧等虽保龟兹，而道路隔塞，檄书不通	西域都护段禧等虽然保住了龟兹，但通往中原的道路已被堵塞，命令、文件无法传递
公卿议者以为西域阻远，数有背叛，吏士屯田，其费无已	公卿中议论此事的人认为：西域阻碍重重而距离遥远，又屡次反叛；官兵在那里屯戍垦田，经费消耗没有止境
六月，壬戌，罢西域都护，遣骑都尉王弘发关中兵迎禧及梁、赵博，伊吾卢、柳中屯田吏士而还	六月壬戌东汉朝廷撤销西域都护，派遣骑都尉王弘征调关中兵，将段禧和梁、赵博以及伊吾庐和柳中的屯田官兵接回汉朝本土
秋，九月，庚午，太尉徐防以灾异、寇贼策免	秋季，九月庚午，太尉徐防因天灾、天象异常和叛匪作乱而被颁策罢免
三公以灾异免，自防始	太尉、司徒、司空三公由于天灾或天象异常而遭罢免，徐防乃是首例
辛未，司空尹勤以水雨漂流策免	辛未，司空尹勤因大雨水灾被颁策罢免
壬午，诏：太仆、少府减黄门鼓吹以补羽林士；厩马非乘舆常所御者，皆减半食；诸所造作，非供宗庙园陵之用，皆且止	九月壬午，诏书命令：太仆、少府裁减黄门乐队，用来增补羽林武士的名额；厩苑中的官马，凡不是皇上经常使用的，一律将食料减半；各项工程，凡不是用来供应皇家宗庙和陵园的，一律暂停
庚寅，以太傅张禹为太尉，太常周章为司空	庚寅，将太傅张禹任命为太尉，将太常周章任命为司空
戊子，敕司隶校尉、冀、并二州刺史，民讹言相惊，弃捐旧居，老弱相携，穷困道路	十一月戊子，太后训令司隶校尉及冀州、并州两州刺史：人民受到谣言的惊扰，抛弃了旧居，扶老携幼，在路上贫困交加
其各敕所部长吏躬亲晓喻：若欲归本郡，在所为封长檄；不欲，勿强	司隶校尉及冀州、并州两位刺史，要命令下属官员亲自对百姓进行劝导，说明情况：如果他们愿意返回原郡，由当地官府为他们出县公文；如果不愿返回，也不勉强
十二月，乙卯，以颍川太守张敏为司空	十二月乙卯，将颍川太守张敏任命为司空
诏车骑将军邓骘、征西校尉任尚将五营及诸郡兵五万人，屯汉阳以备羌	诏书命令车骑将军邓骘和征西校尉任尚，率领屯骑、步兵、越骑、长水、射声等五营兵及各郡郡兵，共五万人，进驻汉阳，以防备羌军进攻
是岁，郡国十八地震，四十一大水，二十八大风，雨雹	本年，有十八个郡和封国发生地震，四十一个郡和封国大水成灾，二十八个郡和封国发生风灾和雹灾
鲜卑大人燕荔阳诣阙朝贺	鲜卑首领燕荔阳到汉朝宫廷朝贺
太后赐燕荔阳王印绶、赤车、参驾，令止乌桓校尉所居宁城下，通胡市，因筑南、北两部质馆	邓太后将王爵印信绶带和三匹马驾驶的赤车赐给燕荔阳，命他定居在乌桓校尉的驻地宁城附近，开通边塞贸易，还特地修建了南北两个宾馆，用来接待人质
鲜卑邑落百二十部各遣入质	鲜卑一百二十个部落分别将人质送到汉朝
御史中丞樊准以郡国连年水旱，民多饥困，上疏：请令太官、尚方、考功、上林池诸官，实减无事之物；五府调省中都官吏、京师作者	御史中丞樊准因各地连年水旱成灾，许多百姓饥饿贫困，上书说：请命令太官、尚方、考工、上林等各官署，核实裁撤无用之物；太傅、太尉、司徒、司空、车骑将军等五府，调整削减中央官吏及在京城营造建筑的工匠
又，被灾之郡，百姓凋残，恐非赈给所能胜赡，虽有其名，终无其实	再者，受灾各郡的百姓凋零残破，恐怕官府的赈济不能拯救他们，虽然有赈济之名，却最终收不到赈济之实
可依征和元年故事，遣使持节慰安，尤困乏者徙置荆、扬孰郡	建议依照汉武帝征和元年的先例，派遣使者持符节前往灾区进行慰问，将特别贫困的灾民迁徙安置到荆州、扬州所属的丰产郡
今虽有西屯之役，宜先东州之急	目前虽然西方有战事，也应先解救东方的急难
太后从之，悉以公田赋与贫民，即擢准与议郎吕仓并守光禄大夫	邓太后听从了樊准的建议，将国家所有的公田全部交给贫民使用，并随即擢升樊准，将他和议郎吕仓一同任命为代理光禄大夫
二月，乙丑，遣准使冀州、仓使兖州禀贷，流民咸得苏息	二月乙丑，派遣樊准为使者前往冀州，派遣吕仓为使者前往兖州，对灾民进行赈济，流亡的百姓全都得以复苏
六月，京师及郡国四十大水，大风，雨雹	六月，京城及四十个郡和封国出现水灾、风灾和雹灾
秋，七月，太白入北斗	秋季，七月，金星进入北斗星座
癸未，蜀郡徼外羌举土内属	癸未，蜀郡边境外的羌人以全部土地归属汉朝
十二月，广汉塞外参狼羌降	十二月，广汉郡边塞外的羌人参狼部落归降
是岁，郡国十二地震	本年，有十二个郡和封国发生地震
甲申，清河愍王虎威薨，无子	四月甲申，清河愍王刘虎威去世，没有子嗣
五月，丙申，封乐安王宠子延平为清河王，奉孝王后	五月丙申将乐安王刘宠的儿子刘延平封为清河王，作为清河孝王刘庆的后嗣
六月，渔阳乌桓与右北平胡千余寇代郡、上谷	六月，渔阳郡的乌桓部落与右北平的胡人部落，共一千余人，进攻代郡、上谷
九月，雁门乌桓率众王无何允与鲜卑大人丘伦等及南匈奴骨都合七千骑寇五原，与太守战于高渠谷，汉兵大败	九月，雁门郡的乌桓率众王无何允与鲜卑大人丘伦等，联合南匈奴的骨都，共七千骑兵，进攻五原郡，与五原郡太守在高渠谷交战，汉军大败
十二月，辛酉，郡国九地震	十二月辛酉，有九个郡和封国发生地震
乙亥，有星孛于天苑	十二月乙亥，天苑星座出现异星
是岁，京师及郡国四十一雨水，并、凉二州大饥，人相食	本年，京城洛阳和四十一个郡和封国大雨成灾，并州、凉州发生严重饥荒，出现人吃人的现象
春，正月，元会，撤乐，不陈充庭车	春季，正月，在举行元旦朝会时，取消奏乐和在庭中陈列御用车驾的仪式
丙午，诏减百官及州郡县奉各有差	正月丙午，下诏削减文武百官及州郡县各级官吏的俸禄，依照等级，各有差别
二月，南匈奴寇常山	二月，南匈奴军进攻常山
戊子，杜陵园火	戊子，汉宣帝陵园杜陵园失火
癸巳，郡国九地震	癸巳，有九个郡和封国发生地震
夏，四月，六州蝗	夏季，四月，有六个州发生蝗灾
丁丑，赦天下	四月丁丑，大赦天下
秋，七月，乙酉，三郡大水	秋季，七月乙酉，有三个郡发生水灾
九月，甲申，益州郡地震	九月甲申，益州郡发生地震
太后诏阴后家属皆归故郡，还其资财五百余万	邓太后下诏，准许被贬逐的阴皇后的家属全部返回原郡，发还被官府没收的资产五百余万
	五年
春，正月，庚辰朔，日有食之	春季，正月庚辰朔，出现日食
丙戌，郡国十地震	丙戌，有十个郡和封国发生地震
已丑，太尉张禹免	已丑，将太尉张禹免职
甲申，以光禄勋颍川李修为太尉	甲申，将光禄勋颍川人李任命为太尉
夫馀王寇乐浪	夫馀国国王进攻乐浪郡
高句骊王宫与秽貊寇玄菟	高句骊国国王宫和貊部落进攻玄菟郡
夏，闰四月，丁酉，赦凉州、河西四郡	夏季，闰四月丁酉，在凉州与河西四郡实行大赦
是岁，九州蝗，郡国八雨水	本年，有九个州发生蝗灾，有八个郡和封国大雨成灾
	六年
三月，十州蝗	三月，有十个州发生蝗灾
夏，四月，乙丑，司空张敏罢	夏季，四月乙丑，将司空张敏罢免
已卯，以太常刘恺为司空	四月己卯，将太常刘恺任命为司空
诏建武元功二十八将皆绍封	诏书宣布，光武帝建武时期的元勋&#0;&#0;二十八将的封爵，无论曾否撤销，一律由其后裔继承
五月，旱	五月，发生旱灾
丙寅，诏令中二千石下至黄绶，一切复秩	丙寅，诏书命令全国官员，上自中二千石，下至黄绶&#0;&#0;四百石到二百石的小吏，一律恢复原来的俸禄
六月，壬辰，豫章员溪原山崩	六月壬辰，豫章郡员溪原山发生山崩
辛巳，赦天下	辛巳，大赦天下
春，二月，丙午，郡国十八地震	春季，二月丙午，有十八个郡和封国发生地震
丙申晦，日有食之	丙申晦，出现日食
秋，护羌校尉侯霸、骑都尉马贤击先零别部牢羌于安定，获首虏千人	秋季，护羌校尉侯霸、骑都尉马贤在安定郡进攻羌人先零部落的分支牢羌，斩首俘获一千人
蝗	发生蝗灾
	元初元年
春，正月，甲子，改元	春季，正月甲子，改年号
二月，乙卯，日南地坼，长百余里	二月乙卯，日南郡发生地裂，长一百余里
三月，癸亥，日有食之	三月癸亥，出现日食
诏遣兵屯河内通谷冲要三十六所，皆作坞壁，设鸣鼓，以备羌寇	朝廷下诏，派兵驻守河内郡关隘要冲三十六处，各处全都修筑堡寨，设置传警之鼓，以防备羌人进攻
夏，四月，丁酉，赦天下	夏季，四月丁酉，大赦天下
京师及郡国五旱，蝗	京城洛阳及五个郡和封国发生旱灾、蝗灾
五月，先零羌寇雍城	五月，羌人先零部落进攻雍城
蜀郡夷寇蚕陵，杀县令	罗郡夷人进攻蚕陵县，杀死县令
九月，乙丑，太尉李罢	九月乙丑，将太尉李罢免
辛未，以大司农山阳司马苞为太尉	九月辛未，将大司农山阳人司马苞任命为太尉
冬，十月，戊子朔，日有食之	冬季，十月戊子朔，出现日食
凉州刺史皮杨击羌于狄道，大败，死者八百余人	凉州刺史皮杨在狄道与羌军交战，皮杨大败，八百余人战死
是岁，郡国十五地震	本年，有十五个郡和封国发生地震
	二年
零昌分兵寇益州，遣中郎将尹就讨之	零昌分兵攻打益州，朝廷派遣中郎将尹就进行讨伐
夏，四月，丙午，立贵人荥阳阎氏为皇后	夏季，四月丙午，将贵人荥阳人阎氏立为皇后
后性妒忌，后宫李氏生皇子保，后鸩杀李氏	阎皇后生性忌妒，宫女李氏生下皇子刘保，阎皇后便将她毒死
六月，丙戌，太尉司马苞薨	六月丙戌，太尉司马苞去世
秋，七月，辛巳，以太仆泰山马英为太尉	秋季，七月辛巳，将太仆泰山人马英任命为太尉
壬午晦，日有食之	九月壬午晦，出现日食
十一月，庚申，郡国十地震	十一月庚申，有十个郡和封国发生地震
十二月，武陵澧中蛮反，州郡讨平之	十二月，武陵郡澧中蛮人反叛，被州郡官府剿平
已酉，司徒夏勤罢	己酉，将司徒夏勤罢免
庚戌，以司空刘恺为司徒，光禄勋袁敞为司空	庚戌，将司空刘恺任命为司徒，将光禄勋袁敞任命为司空
敞，安之子也	袁敞是袁安之子
郡国十地震	有十个郡和封国发生地震
三月，辛亥，日有食之	三月辛亥，出现日食
夏，四月，京师旱	夏季，四月，京城洛阳发生旱灾
五月，武陵蛮反，州郡讨破之	五月，武陵郡蛮人反叛，州郡官府进行讨伐，打败叛军
癸酉，度辽将军邓遵率南单于击零昌于灵州，斩首八百余级	癸酉，度辽将军邓遵率领南匈奴单于，在灵州进攻零昌，斩杀八百余人
越徼外夷举种内属	越边境外的夷人，整个部落归附汉朝
六月，中郎将任尚遣兵击破先零羌于丁奚城	六月，中郎将任尚派兵在丁奚城打败羌人先零部落
秋，七月，武陵蛮复反，州郡讨平之	秋季，七月，武陵蛮人再次反叛，被州郡官府剿平
九月，筑冯翊北界候坞五百所以备羌	九月，在冯翊北部边界修筑堡寨五百处，防备羌军
冬，十一月，苍梧、郁林、合浦蛮夷降	冬季，十一月，苍梧、郁林、合浦三郡蛮夷投降
癸卯，郡国九地震	十一月癸卯，有九个郡和封国发生地震
十二月，丁巳，任尚遣兵击零昌于北地，杀其妻子，烧其庐舍，斩首七百余级	十二月丁巳，任尚派兵在北地进攻零昌，杀死零昌的妻子儿女，焚烧他们的住舍，将七百余人斩首
春，二月，乙巳朔，日有食之	春季，二月乙巳朔，出现日食
乙卯，赦天下	二月乙卯，大赦天下
壬戌，武库灾	二月壬戌，武库失火
六月，戊辰，三郡雨雹	六月戊辰，有三个郡发生雹灾
秋，七月，京师及郡国十雨水	秋季，七月，京城洛阳及十个郡和封国大雨成灾
冬，十一月，已卯，彭城靖王恭薨	冬季，十一月已卯，彭城靖王刘恭去世
越夷以郡县赋敛烦数，十二月，大牛种封离等反，杀遂久令	赵夷人因郡县官府征收赋税繁重，十二月，大牛部落封离等人反叛，杀死遂久县令
是岁，郡国十三地震	本年，有十三个郡和封国发生地震
春，三月，京师及郡国五旱	春季，三月，京城洛阳及五个郡和封国发生旱灾
夏，六月，高句骊与秽貊寇玄菟	夏季，六月，高句丽国与貊部落一同进攻玄菟郡
秋，八月，丙申朔，日有食之	秋季，八月丙申朔，出现日食
邓遵募上郡全无种羌雕何刺杀狼莫；封雕何为羌侯	度辽将军邓遵收买上郡羌人全无部落的雕何刺杀了狼莫，朝廷将雕何封为羌侯
自羌叛十余年间，军旅之费，凡用二百四十余亿，府帑空竭，边民及内郡死者不可胜数，并、凉二州遂至虚耗	自从羌人反叛，十余年间，军费开支共计二百四十多亿，国库枯竭，边疆及内地百姓的死亡人数多得无法统计，并州、凉州两州因此而空虚衰败
及零昌、狼莫死，诸羌瓦解，三辅、益州无复寇警	及至零昌、狼莫死后，羌人各部落瓦解，三辅和益州不再有战争的警报
诏封邓遵为武阳侯，邑三千户	朝廷将邓遵封为武阳侯，享有三千户食邑
遵以太后从弟，故爵封优大	因邓遵是邓太后的堂弟，所以封赐优厚
任尚与遵争功，又坐诈增首级、受赇枉法赃千万已上，十二月，槛车徵尚，弃市，没入财物	任尚与邓遵争功，又被指控虚报斩杀敌人数量、枉法贪赃一千万钱以上，十二月，将他用囚车押回京城，在闹市斩首，尸体暴露街头，财产没收
邓骘子侍中凤尝受尚马，骘髡妻及凤以谢罪	邓骘的儿子、侍中邓凤曾接受过任尚的赠马，于是邓骘用剃发的髡刑来惩罚自己的妻子和邓凤，向朝廷谢罪
是岁，郡国十四地震	本年，有十四个郡和封国发生地震
春，二月，乙巳，京师及郡国四十二地震	春季，二月乙巳，京城洛阳及四十二个郡和封国发生地震
夏，四月，沛国、勃海大风，雨雹	夏季，四月，沛国、勃海刮大风，下冰雹
五月，京师旱	五月，京城洛阳发生旱灾
六月，丙戌，平原哀王得薨，无子	六月丙戌，平原哀王刘得去世，没有子嗣
冬，十二月，戊午朔，日有食之，既	冬季，十二月戊午朔，出现日全食
郡国八地震	有八个郡和封国发生地震
是岁，太后征和帝弟济北王寿、河间王开子男女年五岁以上四十余人，及邓氏近亲子孙三十余人，并为开邸第，教学经书，躬自监试	本年，邓太后征召和帝的弟弟、济北王刘寿和河间王刘开五岁以上的子女，共四十余人，以及邓氏家族的近亲子孙三十余人，为他们建立官舍，教学儒家经书，邓太后亲自监督考试
诏从兄河南尹豹、越骑校尉康等曰：末世贵戚食禄之家，温衣美饭，乘坚驱良，而面墙术学，不识臧否，斯故祸败之所从来也	她下诏给堂兄、河南尹邓豹和越骑校尉邓康等人说：处于末世的皇亲国戚和官宦人家，穿暖衣，吃美食，乘坚车，驱良马，但对待学术，却如面向墙壁而目无所见，不知道善恶得失，这就是灾祸与败亡的由来
初，西域诸国既绝于汉，北匈奴复以兵威役属之，与共为边寇	起初，西域各国同汉朝断绝关系以后，北匈奴重新以武力相威胁，驱使西域各国向自己臣服，并一同侵犯汉朝边境
敦煌太守曹宗患之，乃上遣行长史索班将千余人屯伊吾以招抚之	敦煌太守曹宗对此感到忧虑，便请示朝廷，派遣代理长史索班率领一千余人驻扎伊吾，对西域各国进行招抚
于是车师前王及鄯善王复来降	于是车师前王及鄯善王再度前来归降
春，三月，丁酉，济北惠王寿薨	春季，三月丁酉，济北惠王刘寿去世
沈氐羌寇张掖	羌人沈氐部落攻打张掖郡
秋，七月，乙酉朔，日有食之	秋季，七月乙酉朔，出现日食
冬，十月，已巳，司空李免	冬季，十月己巳，将司空李免官
癸酉，以卫尉庐江陈褒为司空	癸酉，将卫尉、庐江人陈褒任命为司空
京师及郡国三十三大水	京城洛阳及三十三个郡和封国发生水灾
十二月，永昌徼外掸国王雍曲调遣使者献乐及幻人	十二月，永昌郡边境外的掸国国王雍曲调派遣使者进献乐队和魔术艺人
戊辰，司徒刘恺请致仕；许之，以千石禄归养	戊辰，司徒刘恺请求退休，获得批准，被赐予每年一千石的终身俸禄，回乡养老
辽西鲜卑大人乌伦、其至各以其众诣度辽将军邓遵降	辽西郡的鲜卑大人乌伦和其至，各自率领部众向度辽将军邓遵投降
癸酉，以太常杨震为司徒	癸酉，将太常杨震任命为司徒
是岁，郡国二十三地震	本年，有二十三个郡和封国发生地震
初，当煎种饥五同种大豪卢、忍良等千余户别留允街，而首施两端	当初，与饥五同族的当煎部落首领卢、忍良等一千余户单独居住在允街，而摇摆不定
幽州刺史巴郡冯焕、玄菟太守姚光、辽东太守蔡讽等将兵击高句丽，高句丽王宫遣子遂成诈降而袭玄菟、辽东，杀伤二千余人	幽州刺史巴郡人冯焕、玄菟郡太守姚光、辽东郡太守蔡讽等率兵进攻高句丽，高句丽国王宫派遣他的儿子遂成诈降而袭击玄菟郡和辽东郡，杀伤二千余人
丁巳，尊帝嫡母耿姬为甘陵大贵人	四月丁巳，安帝将嫡母耿姬尊为甘陵大贵人
甲子，乐成王苌坐骄淫不法，贬为芜湖侯	四月甲子，乐城王刘苌因骄奢淫逸，触犯法律，被贬为芜湖侯
壬寅，太尉马英薨	七月壬寅，太尉马英去世
京师及郡国二十七雨水	京城洛阳及二十七个郡和封国大雨成灾
冬，十一月，已丑，郡国三十五地震	冬季，十一月已丑，有三十五个郡和封国发生地震
鲜卑寇玄菟	鲜卑军进攻玄菟郡
护羌校尉马贤追击麻奴，到湟中，破之，种众散遁	护羌校尉马贤追击羌人烧当部落首领麻奴，到达湟中地区，打败羌军，麻奴的部众纷纷逃散
癸巳，司空陈褒免	癸巳，将司空陈褒免官
五月，庚戌，宗正彭城刘授为司空	五月庚戌，将宗正、彭城人刘授任命为司空
已巳，封河间孝王子德为安平王，嗣乐成靖王后	己巳，将河间孝王刘开的儿子刘德封为安平王，作为乐成靖王刘党的继承人
六月，郡国蝗	六月，各郡和封国普遍发生蝗灾
秋，七月，癸卯，京师及郡国十三地震	秋季，七月癸卯，京城洛阳及十三个郡和封国发生地震
虔人羌与上郡胡反，度辽将军耿夔击破之	羌族虔人部落与上郡的胡人一同反叛，被度辽将军耿夔击败
八月，阳陵园寝火	八月，汉景帝的陵墓阳陵的陵园及寝庙失火
九月，甲戌，郡国二十七地震	九月甲戌，有二十七个郡和封国发生地震
烧当羌麻奴饥困，将种众诣汉阳太守耿种降	羌人烧当部落首领麻奴饥饿困窘，率领部众向汉阳太守耿种投降
是岁，京师及郡国二十七雨水	本年，京城洛阳及二十七个郡和封国大雨成灾
春，正月，旄牛夷反，益州刺史张乔击破之	春季，正月，旄牛夷人反叛，被益州刺史张乔击败
夏，四月，戊子，爵乳母王圣为野王君	夏季，四月戊子，将奶娘王圣封为野王君
秋，七月，丹阳山崩	秋季，七月，丹阳郡发生山崩
九月，郡国五雨水	九月，有五个郡和封国大雨成灾
十二月，戊辰，京师及郡国三地震	十二月戊辰，京城洛阳和三个郡和封国发生地震
二月，丙子，车驾东巡	二月丙子，安帝到东方巡视
辛卯，幸泰山	二月辛卯，临幸泰山
三月，戊戌，幸鲁；还，幸东平，至东郡，历魏郡、河内而还	三月戊戌，临幸鲁，归途中临幸东平，后到达东郡，经过魏郡、河内而返回京城
夏，四月，乙丑，车驾入宫	夏季，四月乙丑，安帝入宫
戊辰，以光禄勋冯石为太尉	戊辰，将光禄勋冯石任命为太尉
南单于檀死，弟拔立，为乌稽侯尸逐单于	南匈奴单于檀去世，他的弟弟拔继位，此即乌稽侯尸逐单于
时鲜卑数寇边，度辽将军耿夔与温禺犊王呼尤徽将新降者连年出塞击之，还使屯列冲要	当时，鲜卑屡次侵犯边境，度辽将军耿夔与南匈奴温禺犊王呼尤徽率领新归降的部落连年出塞作战，返回后，则让他们到各要塞驻守
耿夔征发烦剧，新降者皆怨恨，大人阿族等遂反，胁呼尤徽欲与俱去	耿夔的征调频繁而辛苦，新归降的人都十分怨恨，其首领阿族等人于是反叛，胁迫呼尤徽，要呼尤徽与他们一同离去
呼尤徽曰：我老矣，受汉家恩，宁死，不能相随	呼尤徽说：我老了，身受汉朝之恩，宁可死，也不能跟随你们
众欲杀之，有救者，得免	阿族等要把他杀掉，因有人相救，才得免一死
阿族等遂将其众亡去	阿族等便率领部众逃走
中郎将马翼与胡骑追击，破之，斩获殆尽	中郎将马翼率胡人骑兵进行追击，打败叛军，叛变者几乎全部被斩杀、俘获
日南徼外蛮夷内属	日南郡边境外的蛮夷之人归附汉朝
六月，鲜卑寇玄菟	六月，鲜卑军侵犯玄菟郡
庚午，阆中山崩	六月庚午，阆中县发生山崩
秋，七月，辛巳，以大鸿胪耿宝为大将军	秋季，七月辛巳，将大鸿胪耿宝任命为大将军
陇西郡始还狄道	陇西郡官府开始迁回狄道
烧当羌豪麻奴死，弟犀苦立	羌人烧当部落首领麻奴去世，他的弟弟犀苦继位
庚申晦，日有食之	庚申晦，出现日食
是岁，京师及诸郡国二十三地震，三十六大水、雨雹	本年，京城洛阳与二十三个郡和封国发生地震，有三十六个郡和封国发大水、下冰雹
春，二月，乙亥，下邳惠王衍薨	春季，二月乙亥，下邳惠王刘衍去世
甲辰，车驾南巡	甲辰，安帝去南方巡视
三月，戊午朔，日有食之	三月戊午朔，出现日食
甲戌，济南孝王香薨，无子，国绝	甲戌，济南孝王刘香去世，无子继承，封国撤除
乙酉，北乡侯即皇帝位	乙酉，北乡侯刘懿即皇帝位
已酉，葬孝安皇帝于恭陵，庙曰恭宗	已酉，将安帝埋葬在恭陵，庙号恭宗
六月，乙巳，赦天下	六月乙巳，大赦天下
秋，七月，西域长史班勇发敦煌、张掖、酒泉六千骑及鄯善、疏勒、车师前部兵击后部王军就，大破之，获首虏八千余人，生得军就及匈奴持节使者，将至索班没处斩之，传首京师	秋季，七月，西域长史班勇征发敦煌、张掖、洒泉等郡六千骑兵和鄯善、疏勒、车师前王国的军队，进击车师后王国国王军就，大捷，斩首八千余人，生擒军就和匈奴持节使者，将其带到索班阵亡处斩首，把人头传送到京都洛阳
冬，十月，丙午，越山崩	冬季，十月丙午，越郡发生山崩
已卯，以诸王礼葬北乡侯	已卯，用诸侯王礼仪埋葬北乡侯
司空刘授以阿附恶逆，辟召非其人，策免	司空刘授因阿附叛逆，所征聘的官吏也不是适当人选，被免官
十二月，甲申，以少府河南陶敦为司空	十二月甲申，擢升少府、河南郡人陶敦为司空
春，正月，帝朝太后于东宫，太后意乃安	春季，正月，汉顺帝前往东宫朝见阎太后，太后的心情才安定下来
甲寅，赦天下	甲寅，大赦天下
辛未，皇太后阎氏崩	辛未，阎太后去世
辛巳，太傅冯石、太尉刘熹以阿党权贵免	辛巳，太傅冯石和太尉刘熹因巴结权贵被免职
司徒李罢	同日，司徒李也被罢官
丙戌，以太常桓焉为太傅；大鸿胪朱宠为太尉，参录尚书事；长乐少府朱伥为司徒	丙戌，擢升太常桓焉为太傅；大鸿胪朱宠为太尉，参与主管尚书事务；长乐少府朱伥为司徒
封尚书郭镇为定颍侯	封尚书郭镇为定颍侯
六月，已亥，封济南简王错子显为济南王	六月己亥，封济南简王刘错的儿子刘显为济南王
秋，七月，庚午，以卫尉来历为车骑将军	秋季，七月庚午，任命卫尉来历为车骑将军
八月，鲜卑寇代郡，太守李超战殁	八月，鲜卑攻打代郡，太守李超阵亡
冬，十月，丁亥，司空陶敦免	冬季，十月丁亥，将司空陶敦免官
以廷尉张皓为司空	擢升廷尉张皓为司空
春，正月，中郎将张国以南单于兵击鲜卑其至，破之	春季，正月，中郎将张国率领南单于军队进击鲜卑首领其至，将其击破
二月，辽东鲜卑寇辽东玄菟；乌桓校尉耿晔发缘边诸郡兵及乌桓出塞击之，斩获甚众；鲜卑三万人诣辽东降	二月，辽东鲜卑攻打辽东玄菟，乌桓校尉耿晔征发沿边各郡郡兵和乌桓的军队出塞讨伐，斩杀和俘虏甚多，鲜卑三万人到辽东郡投降
三月，旱	三月，发生旱灾
秋，七月，甲戌朔，日有食之	秋季，七月甲戌朔，出现日食
春，正月，丙子，京师地震	春季，正月丙子，京都洛阳发生地震
夏，六月，旱	夏季，六月，发生旱灾
秋，七月，茂陵园寝灾	秋季，七月，汉武帝陵园茂陵寝殿发生火灾
九月，鲜卑寇渔阳	九月，鲜卑侵犯渔阳郡
冬，十二月，己亥，太傅桓焉免	冬季，十二月己亥，太傅桓焉被免官
车骑将军来历罢	车骑将军来历被罢官
南单于拔死，弟休利立，为去特若尸逐就单于	南单于栾提拔去世，他的弟栾提休利继位，号为去特若尸逐就单于
帝悉召孙程等还京师	顺帝将孙程等十九侯，全都召回京都洛阳
春，正月，丙寅，赦天下	春季，正月丙寅，大赦天下
丙子，帝加元服	丙子，顺帝行成年加冠礼
五州雨水	五个州下了大雨
秋，八月，丁巳，太尉刘光、司空张皓免	秋季，八月丁巳，太尉刘光和司空张皓，都被免官
癸酉，以大鸿胪庞参为太尉、录尚书事	癸酉，擢升大鸿胪庞参为太尉，主管尚书事务
太常王龚为司空	太常王龚为司空
冬，十一月，庚辰，司徒许敬免	冬季，十一月庚辰，司徒许敬被免官
鲜卑寇朔方	鲜卑侵犯朔方郡
十二月，乙卯，以宗正弘农刘崎为司徒	十二月乙卯，擢升宗正、弘农郡人刘崎为司徒
夏，四月，京师旱	夏季，四月，京都洛阳发生旱灾
京师及郡国十二蝗	京都洛阳和十二个郡国蝗虫成灾
定远侯班超之孙始尚帝姑阴城公主	定远侯班超的孙子班始，娶顺帝的姑姑阴城公主为妻
主骄淫无道；始积忿怒，伏刃杀主	因公主骄横荒淫，班始久积愤怒，于是，用刀剑杀死公主
冬，十月，乙亥，始坐腰斩，同产皆弃市	冬季，十月乙亥，班始因坐罪被腰斩，他的同母兄弟姊妹，都在闹市处死，陈尸示众
初，安帝薄于艺文，博士不复讲习，朋徒相视怠散，学舍颓敝，鞠为园蔬，或牧儿、荛竖薪刈其下	当初，由于安帝轻视典籍，博士不再讲习，门徒学生互相看着学业荒怠，人员离散，太学的房舍倒塌敝旧，破败得成为菜园，牧童、樵夫在附近砍柴割草
将作大匠翟上疏请修缮，诱进后学，帝从之	将作大匠翟上奏，请求加以修缮，诱导后生求学，顺帝采纳了他的建议
秋，九月缮起太学，凡所造构二百四十房，千八百二十室	秋季，九月，重新修缮太学，共建房二百四十幢，一千八百五十间
护乌桓校尉耿晔遣兵击鲜卑，破之	护乌桓校尉耿晔派兵攻击鲜卑，将其击破
春，正月，乙巳，立贵人梁氏为皇后	春季，正月乙巳，封贵人梁为皇后
京师旱	京都洛阳发生旱灾
三月，扬州六郡妖贼章河等寇四十九县，杀伤长吏	三月，扬州六郡妖贼章何等，攻打四十九个县，杀伤地方官吏
庚寅，赦天下，改元	庚寅，大赦天下，改年号
冬，耿晔遣乌桓戎末魔等钞击鲜卑，大获而还	冬季，耿晔派乌桓酋长戎末魔等攻击鲜卑，大胜而回
鲜卑复寇辽东属国，耿晔移屯辽东无虑城以拒之	鲜卑部落遂反攻辽东属国，耿晔移兵屯驻辽东郡所属的无虑城，以抵御鲜卑的进攻
闰月，庚子，恭陵百丈庑灾	闰月庚子，安帝陵园恭陵寝殿百丈庑，发生火灾
上闻北海郎精于阴阳之学	顺帝听说北海国人郎精通阴阳之学
	二年
三月，使匈奴中郎将赵稠遣从事将南匈奴兵出塞击鲜卑，破之	三月，使匈奴中郎将赵稠派从事率南匈奴军队，出塞攻击鲜卑部落，将其击破
戊午，司空王龚免	戊午，司空王龚被免官
六月，辛未，以太常鲁国孔扶为司空	六月辛未，擢升太常、鲁国人孔扶为司空
八月，已巳，以大鸿胪施延为太尉	八月已巳，擢升大鸿胪施延为太尉
鲜卑寇马城，代郡太守击之，不克	鲜卑进犯马城，代郡太守率军讨伐，未能取胜
顷之，其至犍死	不久，鲜卑首领其至犍去世
鲜卑由是抄盗差稀	从此以后，鲜卑对内地的抢劫和骚扰，较以前减少
夏，四月，车师后部司马率后王加特奴掩击北匈奴于阊吾陆谷，大破之；获单于母	夏季，四月，汉朝驻车师后王国的车师后部司马，率领后王国国王加特奴，在阊吾陆谷向北匈奴发动突然袭击，大破北匈奴，俘虏了单于的母亲
秋，七月，钟羌良封等复寇陇西、汉阳	秋季，七月，钟羌种首领良封等再次进犯陇西郡和汉阳郡
诏拜前校尉马贤为谒者，镇抚诸种	顺帝下诏，任命前任护羌校尉马贤为谒者，负责镇压和安抚诸种羌人
冬，十月，护羌校尉马续遣兵击良封，破之	冬季，十月，护羌校尉马续派兵进击良封，将其击破
十一月，壬寅，司徒刘崎、司空孔扶免，用周举之言也	十一月壬寅，司徒刘崎和司空孔扶，均被免职，这是由于顺帝采纳周举谏言的结果
乙巳，以大司农黄尚为司徒，光禄勋河东王卓为司空	乙巳，擢升大司农黄尚为司徒，光禄勋、河东郡人王卓为司空
耿贵人数为耿氏请，帝乃绍封耿宝子箕为牟平侯	因耿贵人多次为她的娘家向顺帝说情，于是，顺帝封耿宝的儿子耿箕继承其父为牟平侯
	四年
旱	发生旱灾
谒者马贤击钟羌，大破之	谒者马贤进击并大破钟羌种人
夏，四月，甲子，太尉施延免	夏季，四月甲子，术尉施延被免官
戊寅，以执金吾梁商为大将军，故太尉庞参为太尉	戊寅，擢升执金吾梁商为大将军，任命前任太尉庞参为太尉
秋，闰八月，丁亥朔，日有食之	秋季，闰八月丁亥朔，出现日食
十二月，丙寅，京师地震	十二月丙寅，京都洛阳发生地震
	永和元年
冬，十月，丁亥，承福殿火	冬季，十月丁亥，承福殿发生火灾
十一月，丙子，太尉宠参罢	十一月丙子，太尉庞参被免职
十二月，象林蛮夷反	十二月，象林县蛮夷起兵反叛
春，武陵蛮二万人围充城，八千人寇夷道	春季，武陵郡蛮族二万人包围充城，八千人攻打夷道
二月，广汉属国都尉击破白马羌	二月，广汉属国都尉击破白马羌
帝遣武陵太守李进击叛蛮，破平之	顺帝派武陵郡太守李进率军进击反叛的蛮人，将其击破平定
进乃简选良吏，抚循蛮夷，郡境遂安	于是，李进选用贤良的官吏，安抚蛮人，郡境之内方告安宁
三月，司空王卓薨	三月，司空王卓去世
丁丑，以光禄勋郭虔为司空	丁丑，擢升光禄勋郭虔为司空
夏，四月，丙申，京师地震	夏季，四月丙申，京都洛阳发生地震
五月，癸丑，山阳君宋娥坐构奸诬罔，收印绶，归里舍	五月癸丑，山阳君宋娥因勾结奸佞，以不实之辞诬陷他人而坐罪，顺帝下令收缴她的印信，并将她遣送回乡
黄龙、杨佗、孟叔、李建、张贤、史泛、王道、李元、李刚等九侯坐与宋娥更相赂遗，求高官增邑，并遣就国，减租四分之一	黄龙、杨佗、孟叔、李建、张贤、史、王道、李元、李刚等九侯，因与宋娥互相贿赂，谋求高官和增加食邑，一律遣回他们的封国，减少所享用的封国租税的四分之一
冬，十月，甲申，上行幸长安	冬季，十月甲申，顺帝巡视长安
扶风田弱荐同郡法真博通内、外学，隐居不仕，宜就加兖职	扶风人田弱向顺帝推荐同郡人法真，称法真精通儒家的内学和外学，即《七纬》和《六经》，隐居乡里，不肯出来做官，应就地任命他为三公
帝虚心欲致之，前后四徵，终不屈	顺帝非常虚心地想请到他，前后四次征召，但法真始终不肯屈从
友人郭正称之曰：法真名可得闻，身难得而见	他的朋友郭正称赞说：法真，可以听见他的名，却很难见到他这个人
逃名而名我随，避名而名我追，可谓百世之师者矣	他越是逃避名声，名声越是随着他，越是躲开名声，名声越是追着他，他这个人真可以说是百世之师了
真，雄之子也	法真，即法雄的儿子
丁卯，京师地震	丁卯，京都洛阳发生地震
太尉王龚以中常侍张等专弄国权，欲奏诛之	太尉王龚因中常侍张等独揽朝廷大权，打算提出弹劾，要求皇帝诛杀他们
宗亲有以杨震行事谏之者，龚乃止	后由于宗族和亲戚中有人用杨震的遭遇进行劝阻，王龚这才作罢
十二月，乙亥，上还自长安	十二月乙亥，顺帝从长安返回京都洛阳
	三年
春，二月，乙亥，京师及金城、陇西地震，二郡山崩	春季，二月乙亥，京都洛阳及金城郡、陇西郡发生地震，二郡发生山崩
夏，闰四月，已酉，京师地震	夏季，闰四月已酉，京都洛阳发生地震
秋，八月，己未，司徒黄尚免	秋季，八月己未，司徒黄尚被免官
九月，己酉，以光禄勋长沙刘寿为司徒	九月己酉，擢升光禄勋、长沙人刘寿为司徒
丙戌，令大将军、三公举刚毅、武猛、谋谟任将帅者各二人，特进、卿、校尉各一人	丙戌，顺帝命大将军、三公向朝廷举荐刚毅、武猛、有谋略，可以担任将帅的人才，每人推荐二人；特进、九卿、校尉，每人推荐一人
冬，十月，烧当羌那离等三千余骑寇金城，校尉马贤击破之	冬季，十月，烧当羌人首领那离等，率领三千余骑兵，侵犯金城郡，护羌校尉马贤将其击破
三月，乙亥，京师地震	三月乙亥，京都洛阳发生地震
烧当羌那离等复反；夏，四月，癸卯，护羌校尉马贤讨斩之	烧当羌人首领那离等再次反叛
获首虏千二百余级	夏季，四月癸卯，护羌校尉马贤率军进行讨伐，将那离斩首，并斩杀和俘虏一千二百余人
戊午，赦天下	戊午，大赦天下
五月，戊辰，封故济北惠王寿子安为济北王	五月戊辰，将已故济北惠王刘寿的儿子刘安封为济北王
秋，八月，太原旱	秋季，八月，太原郡发生旱灾
春，二月，戊申，京师地震	春季，二月戊申，京都洛阳发生地震
己丑晦，日有食之	己丑晦，出现日食
辛未，太尉王龚以老病罢	辛未，太尉王龚因年老有病被罢官
且冻羌寇武都，烧陇关	且冻羌人攻打武都，焚烧陇关
壬午，以太常桓焉为太尉	壬午，擢升太常桓焉为太尉
匈奴句龙王吾斯等立车纽为单于，东引乌桓，西收羌、胡等数万人攻破京兆虎牙营，杀上郡都尉及军司马，遂寇掠并、凉、幽、冀四州	南匈奴句龙王吾斯等，拥立车纽为单于，东方和乌桓联合，西方集结羌人、胡人，约数万人，攻破京兆虎牙大营，杀死上郡都尉和军司马，于是劫掠并州、凉州、幽州和冀州
乃徙西河治离石，上郡治夏阳，朔方治五原	东汉朝廷便将西河郡太守府迁往离石，上郡太守府迁往夏阳，朔方郡太守府迁往五原
十二月，遣使匈奴中郎将张耽将幽州、乌桓诸郡营兵击车纽等，战于马邑，斩首三千级，获生口甚众	十二月，派遣使匈奴中郎将张耽率领幽州乌桓部众及各郡的地方军，进击车纽等，在马邑会战，斩杀匈奴军三千人，俘虏了很多人
车纽乞降，而吾斯犹率其部曲与乌桓寇钞	车纽请求投降，而吾期仍率领其部众跟乌桓结合，继续劫掠
二月，丁巳，有星孛于营室	二月丁巳，有异星出现在营室星座
武都太守赵冲追击巩唐羌，斩首四百余级，降二千余人	武都郡太守赵冲追击巩唐羌人，斩杀四百余人，招降二千余人
诏冲督河西四郡兵为节度	顺帝下诏，命赵冲督率河西四郡的地方军队，负责节制
庚子，司空郭虔免	庚子，司空郭虔被免官
丙午，以太仆赵戒为司空	丙午，擢升太仆赵戒为司空
夏，使匈奴中郎将张耽、度辽将军马续率鲜卑到城，击乌桓于通天山，大破之	夏季，使匈奴中郎将张耽、度辽将军马续率领鲜卑部众到达城，在通天山进击乌桓，乌桓大败
秋，八月，乘氏忠侯梁商病笃，敕子冀等曰：吾生无以辅益朝廷，死何可耗费帑藏	秋季，八月，乘氏侯梁商病重，告诫他的儿子梁冀等人说：我活着的时候，没能辅佐朝廷，死后怎可耗费国家库藏
衣衾、饭含、玉匣、珠贝之属，何益朽骨	装殓的衣服单被，放在口中的含饭含玉，用作葬服的金缕玉衣，以及珠宝贝壳之类东西，对死人又有什么益处
百僚劳扰，纷华道路，祗增尘垢耳	劳累和骚扰文武百官，一路上弄得繁华盛丽，只是增加尘土和污垢罢了，应该都加以谢绝
宜皆辞之	丙辰，梁商去世，顺帝亲来吊丧
丙辰，薨；帝亲临丧	他的儿子们准备遵照遗嘱来办理丧事，朝廷不许，赏赐东园制作的葬具一副，棺用白银雕花，椁用黄心柏木，以及玉衣一件
诸子欲从其诲，朝廷不听，赐以东园秘器、银镂、黄肠、玉匣	等到安葬时，又派武装士兵驾兵车护送
及葬，赐轻车、介士，中宫亲送	皇后梁亲自送灵
帝至宣阳亭，瞻望车骑	顺帝到宣阳亭，遥望丧葬车队
壬戌，以河南尹、乘氏侯梁冀为大将军，冀弟侍中不疑为河南尹	壬戌，擢升河南尹、乘氏侯梁冀为大将军；梁冀的弟弟梁不疑为河南尹
初，梁商病笃，帝亲临幸，问以遗言	当初，梁商病重，顺帝亲自到梁家探望，问他遗言
对曰：臣从事中郎周举，清高忠正，可重任也	梁商回答说：我的从事中郎周举，清廉高洁，忠良正直，可以委以重任
由是拜举谏议大夫	因此，顺帝任命周举为谏议大夫
九月，诸羌寇武威	九月，羌人诸种攻打武威郡
辛亥晦，日有食之	辛亥晦，出现日食
冬，十月，癸丑，以羌寇充斥，凉部震恐，复徙安定居扶风，北地居冯翊	冬季，十月癸丑，因处处有羌人劫掠，凉州震动惊恐，又把安定郡太守府迁到右扶风，把北地郡太守府迁到左冯翊
十一月，庚子，以执金吾张乔行车骑将军事，将兵万五千人屯三辅	十一月庚子，擢升执金吾张乔代理车骑将军事务，率军一万五千人，驻守三辅
秋，八月，南匈奴句龙吾斯与、台耆等复反，寇掠并部	秋季，八月，南匈奴句龙王吾斯和、台耆等再次反叛，攻打劫掠并州
冬，十月，辛未，太尉桓焉、司徒刘寿免	冬季，十月辛未，太尉桓焉和司徒刘寿均被免官
罕羌邑落五千余户诣赵冲降，唯烧何种据参未下	罕羌村落五千余户，都向赵冲投降，唯有烧何种羌人，仍据守参，不肯归附
甲戌，罢张乔军屯	甲戌，撤销张乔在三辅地区的军事防御
十一月，壬午，以司隶校尉下邳赵峻为太尉，大司农胡广为司徒	十一月壬午，擢升司隶校尉、下邳人赵峻为太尉，大司农胡广为司徒
	二年
夏，四月，庚戌，护羌校尉赵冲与汉阳太守张贡击烧当羌于参，破之	夏季，四月庚戌，护羌校尉赵冲和汉阳郡太守张贡，对据守在参的烧当种羌人发动攻击，将其击破
冬，闰十月，赵冲击烧当羌于阿阳，破之	冬季，闰十月，赵冲率军在汉阳郡的阿阳县，进击烧当种羌人，将其击破
十一月，使匈奴中郎将扶风马实遣人刺杀句龙吾斯	十一月，使匈奴中郎将右扶风人马，派人刺杀了句龙王吾斯
夏，四月，使匈奴中郎将马击南匈奴左部，破之	夏季，四月，使匈奴中郎将马攻击南匈奴左部，将其击破
于是胡、羌、乌桓悉诣降	于是，胡人、羌人、乌桓人全向马归降
庚午，帝崩于玉堂前殿	庚午，顺帝在玉堂前殿驾崩
太子即皇帝位，年二岁	太子刘炳即皇帝位，年仅二岁
尊皇后曰皇太后	尊皇后梁为皇太后
太后临朝	皇太后临朝主管朝政
丁丑，以太尉赵峻为太傅，大司农李固为太尉，参录尚书事	丁丑，任命太尉赵峻为太傅，大司农李固为太尉，参与主持尚书事务
九月，丙午，葬孝顺皇帝于宪陵，庙曰敬宗	九月丙午，将顺帝安葬在宪陵，庙号敬宗
是日，京师及太原、雁门地震	当日，京都洛阳，以及太原郡、雁门郡，均发生地震
扬州刺史尹耀、九江太守邓显讨范容等于历阳，败殁	扬州刺史尹耀和九江郡太守邓显在历阳讨伐范容等人，兵败被杀
冬，十月，日南蛮夷复反，攻烧县邑	冬季，十月，日南郡的蛮夷再次起兵反叛，攻打焚烧县城和村落
交趾刺史九江夏方招诱降之	交趾刺史九江郡人夏方招诱他们归降
十二月，九江贼黄虎等攻合肥	十二月，九江郡盗贼黄虎等攻打合肥县
是岁，群盗发宪陵	本年，一群盗贼发掘了安葬顺帝的宪陵
	孝冲皇帝永嘉元年
广陵贼张婴复聚众数千人反，据广陵	广陵郡盗贼张婴又聚众数千人反叛，攻占广陵郡
二月，乙酉，赦天下	二月乙酉，大赦天下
西羌叛乱积年，费用八十余亿	西羌诸种连年起兵反叛，东汉朝廷支出的军事费用达八十多亿
诸将多断盗牢禀，私自润入，皆以珍宝货赂左右	将领们多数都控制并盗取军饷，以饱私囊，又都用珍宝贿赂左右
上下放纵，不恤军事，士卒不得其死者，白骨相望于野	上下放纵，不忧虑军事，士卒不应死而死的，白骨相望，堆积旷野
左冯翊梁并以恩信招诱叛羌；离、狐奴等五万余户皆诣并降，陇右复平	左冯翊梁并用朝廷恩德和信义招揽引诱叛变的羌人，于是离、狐奴等五万余户，都向梁并投降，陇石恢复安宁
太后以徐、扬盗贼益炽，博求将帅	梁太后因为徐州、扬州的盗贼日益炽烈，广泛征求可以胜任将帅的人才
三公举涿令北海滕抚有文武才；诏拜抚九江都尉，与中郎将赵序助冯绲，合州郡兵数万人共讨之	三公举荐涿县县令、北海人滕抚，称他有文武全才
又广开赏募，钱、邑各有差	梁太后下诏，任命滕扶为九江郡都尉，和中郎将赵序一道协助御史中丞冯绲，汇合州郡地方军队数万人，共同征剿
又议遣太尉李固，未及行	又公开悬出赏格，按照剿灭盗贼功劳的高下赏赐金钱或食邑
三月，抚等进击众贼，大破之，斩马勉、范容、周生等千五百级	还商议派太尉李固出征，还没有来得及动身，三月，滕抚等进击众盗贼，将其击破，斩杀贼帅马勉、范容、周生等一千五百人
徐凤以余众烧东城县	贼帅徐凤率领残余部众焚烧东城县
夏，五月，下邳人谢安应募，率其宗亲设伏击凤，斩之	夏季，五月，下邳国人谢安响应朝廷的悬赏招募，率领他的宗族和亲戚设下埋伏，击斩徐凤
封安为平乡侯	封谢安为平乡侯
拜滕抚中郎将，督扬、徐二州事	擢升滕抚为中郎将，督率扬州和徐州二州的事务
六月，鲜卑寇代郡	六月，鲜卑攻打代郡
秋，庐江盗贼攻寻阳，又攻盱台	秋季，庐江郡的盗贼攻打寻阳县，其后，又攻打盱台县
滕抚遣司马王章击破之	滕抚派遣司马王章将其击破
九月，庚戌，太傅赵峻薨	九月庚戌，太傅赵峻去世
五月，庚寅，徙乐安王鸿为勃海王	五月庚寅，改封乐安王刘鸿为勃海王
海水溢，漂没民居	海水倒灌，淹没人民的住宅
六月，丁巳，赦天下	六月丁巳，大赦天下
秋，七月，乙卯，葬孝质皇帝于静陵	秋季，七月乙卯，将质帝安葬于静陵
九月，戊戌，追尊河间孝王为孝穆皇，夫人赵氏曰孝穆后，庙曰清庙，陵曰乐成陵；蠡吾先侯曰孝崇皇，庙曰烈庙，陵曰博陵；皆置令、丞，使司徒持节奉策书玺绶，祠以太牢	九月戊戌，桓帝刘志追尊其祖父河间孝王刘开为孝穆皇，祖母赵氏为孝穆后，祭庙名为清庙，陵园名为乐成陵；追尊其父蠡吾侯刘翼为孝崇皇，祭庙名为烈庙，陵园名为博陵；都设置令、丞掌管，并派司徒持节，捧着皇帝颁发的策书和玺印绶带前往，用牛、羊、猪各一头的太牢之礼进行祭祀
冬，十月，甲午，尊帝母氏为博园贵人	冬季，十月甲行，桓帝尊母亲氏为博园贵人
春，正月，辛亥朔，日有食之	春季，正月辛亥朔，出现日食
戊午，赦天下	戊午，大赦天下
三月，龙见谯	三月，龙在谯县显现
夏，四月，庚寅，京师地震	夏季，四月庚寅，京都洛阳发生地震
六阜陵王代兄勃遒亭侯便为阜陵王	封阜陵王刘代的哥哥勃遒亭侯刘便为阜陵王
诏以定策功，益封梁冀万三千户，封冀弟不疑为颍阳侯，蒙为西平侯，冀子胤为襄邑侯，胡广为安乐侯，赵戒为厨亭侯，袁汤为安国侯	桓帝下诏，因拥立皇帝决策有功，增封梁冀食邑一万三千户，封梁冀的弟弟梁不疑为颍阳侯，梁蒙为西平侯，梁冀的儿子梁胤为襄邑侯，胡广为安乐侯，赵戒为厨亭侯，袁汤为安国侯
又封中常侍刘广等皆为列侯	又将中常侍刘广等人，都封为列侯
八月，乙未，立皇后梁氏	八月乙未，桓帝册封梁太后和梁冀的妹妹梁女莹为皇后
梁冀欲以厚礼迎之，杜乔据执旧典，不听	梁冀打算用厚礼迎亲，杜乔根据旧有的典章，予以反对
冀属乔举汜宫为尚书，乔以宫为臧罪，不用	梁冀又嘱托杜乔推荐宫担任尚书，杜乔因宫曾经犯过贪污罪，不肯答应
由是日忤于冀	从此，杜乔越来越为梁冀所忌恨
九月，丁卯，京师地震	九月丁卯，京都洛阳发生地震
乔以灾异策免	杜乔因天降灾异而被免官
冬，十月，以司徒赵戒为太尉，司空袁汤为司徒，前太尉胡广为司空	冬季，十月，任命司徒赵戒为太尉，司空袁汤为司徒，前任太尉胡广为司空
宦者唐衡、左共谮杜乔于帝曰：陛下前当即位，乔与李固抗议，以为不堪奉汉宗祀	宦官唐衡、左一道向桓帝诬陷杜乔说：陛下先前将即位时，杜乔和李固反对，认为您不能胜任侍奉汉朝宗庙的祭祀
帝亦怨之	因此桓帝对杜乔和李固也心生怨恨
是岁，南单于兜楼储死，伊陵尸逐就单于车儿立	同年，南匈奴单于兜楼储去世，车儿继位，号为伊陵尸逐就单于
春，正月，甲子，帝加元服	春季，正月甲子，桓帝行成年加冠礼
庚午，赦天下	庚午，大赦天下
三月，戊辰，帝从皇太后幸大将军冀府	三月戊辰，桓帝跟随梁太后临幸大将军梁冀府
白马羌寇广汉属国，杀长吏	白马种羌人攻打广汉属国，杀害地方官吏
益州刺史率板蛮讨破之	益州刺史率领板蛮人将其击破
夏，四月，丙子，封帝弟顾为平原王，奉孝崇皇祀；尊孝崇皇夫人为孝崇园贵人	夏季，四月丙子，梁太后下诏，封桓帝的弟弟刘顾为平原王，侍奉孝崇皇的祭祀；尊孝崇皇夫人为孝崇园贵人
五月，癸丑，北宫掖庭中德阳殿及左掖门火，车驾移幸南宫	五月癸丑，北宫掖庭中的德阳殿和左掖门失火，桓帝移住南宫
六月，改清河为甘陵	六月，改清河国为甘陵国
立安平孝王得子经侯理为甘陵王，奉孝德皇祀	封安平孝王刘得的儿子、经侯刘理为甘陵王，侍奉孝德皇的祭祀
秋，七月，京师大水	秋季，七月，京都洛阳发生水灾
夏，四月，丁卯晦，日有食之	夏季，四月丁卯晦，出现日食
秋，八月，乙丑，有星孛于天市	秋季，八月乙丑，有异星出现在天市星旁
京师大水	京都洛阳发生水灾
九月，己卯，地震	九月己卯，发生地震
庚寅，地又震	庚寅，再次发生地震
郡、国五山崩	有五个郡和封国发生山崩
冬，十月，太尉赵戒免；以司徒袁汤为太尉，大司农河内张歆为司徒	冬季，十月，太尉赵戒被免职，任命司徒袁汤为太尉，擢升大司农、河内人张歆为司徒
是岁，前朗陵侯相荀淑卒	同年，前任朗陵侯国相荀淑去世
淑少博学有高行，当世名贤李固、李膺皆师宗之	荀淑年轻时，不仅学问渊博，而且德行高尚，当时最著名的贤人李固、李膺，都像对待老师一样地尊崇他
在朗陵，莅事明治，称为神君	荀淑在朗陵侯国任职，治理政事明快果断，被人们奉若神明
有子八从：俭、绲、靖、焘、汪、爽、肃、专，并有名称，时人谓之八龙	荀淑共有八个儿子：荀俭、荀绲、荀靖、荀焘、荀汪、荀爽、荀肃、荀专，都享有盛名，当时人称他们为八龙
所居里旧名西豪，颍阴令渤海苑康以为昔高阳氏有才子八人，更命其里曰高阳里	荀淑所居住的里名，原来叫西豪里，颍阴县令渤海人苑康，因从前高阳氏有八个多才的儿子，就将西豪里改名为高阳里
乙丑，太后诏归政于帝，始罢称制	乙丑，梁太后下诏，将朝政大权归还给桓帝，从此开始不再行使皇帝权力
二月，甲寅，太后梁氏崩	二月甲寅梁太后去世
三月，车驾徙幸北宫	三月，桓帝迁回北宫居住
夏，五月，庚辰，尊博园贵人曰孝崇后，宫曰永乐；置太仆、少府以下，皆如长乐宫故事	夏季，五月庚辰，桓帝尊其母博园贵人为孝崇后，所住宫室称作永乐宫，设置太仆、少府及以下官吏，一切都遵照西汉时期长乐宫的前例
分钜鹿九县为后汤沐邑	从钜鹿郡分割九个县，作为孝崇后的汤沐邑，收取赋税以供个人奉养
秋，七月，梓潼山崩	秋季，七月，广汉郡梓潼县发生山崩
	元嘉元年
癸酉，赦天下，改元	癸酉，大赦天下，改年号
京师旱，任城、梁国饥，民相食	京都洛阳发生旱灾，任城、梁国发生饥荒，出现人吃人的现象
司徒张歆罢，以光禄勋吴雄为司徒	司徒张歆被罢官，擢升光禄勋吴雄为司徒
北匈奴呼衍王寇伊吾，败伊吾司马毛恺，攻伊吾屯城	北匈奴呼衍王攻打伊吾，击败伊吾司马毛恺，又乘胜进攻伊吾屯城
诏敦煌太守马达将兵救之；至蒲类海，呼衍王引去	桓帝下诏，命敦煌太守马达率军援救，当援军到达蒲类海时，呼衍王率兵退走
秋，七月，武陵蛮反	秋季，七月，武陵郡蛮人起兵反叛
冬，十月，司空胡广致仕	冬季，十月，司空胡广辞官退休
闰月，庚午，任城节王崇薨；无子，国绝	闰十二月庚午，任城节王刘崇去世，没有子嗣，封国灭绝
以太常黄琼为司空	擢升太常黄琼为司空
丙辰，京师地震	丙辰，京都洛阳发生地震
夏，四月，甲辰，孝崇皇后氏崩；以帝弟平原王石为丧主，敛送制度比恭怀皇后	夏季，四月甲辰，桓帝的母亲孝崇皇后氏去世，由桓帝的弟弟平原王刘石主持丧事，装殓和送葬的制度，比照和帝的母亲恭怀皇后
五月，辛卯，葬于博陵	五月辛卯，将她安葬在博陵
秋，七月，庚辰，日有食之	秋季，七月庚辰，出现日食
冬，十月，乙亥，京师地震	冬季，十月乙亥，京都洛阳发生地震
十一月，司空黄琼免	十一月，司空黄琼被免官
十二月，以特进赵戒为司空	十二月，任命特进赵戒为司空
	永兴元年
春，三月，丁亥，帝幸鸿池	春季，三月丁亥，桓帝前往鸿池
丁酉，济南悼王广薨；无子，国除	丁酉，济南悼王刘广去世，没有子嗣，封国撤除
冬，十月，太尉袁汤免，以太常胡广为太尉	冬季，十月，太尉袁汤被免官，擢升太常胡广为太尉
司徒吴雄、司空赵戒免，以太仆黄琼为司徒，光禄勋房植为司空	司徒吴雄和司空赵戒，均被免官，擢升太仆黄琼为司徒，擢升光禄勋房植为司空
武陵蛮詹山等反，武陵太守汝南应奉招降之	武陵蛮人首领詹山等起兵反叛，武陵郡太守汝南郡人应奉招抚他们归降
春，正月，甲午，赦天下	春季，正月甲午，大赦天下
二月，辛丑，复听刺史、二千石行三年丧	二月辛丑，恢复许可刺史和官秩二千石以上的高级官吏为父母守丧三年的制度
癸卯，京师地震	癸卯，京都洛阳发生地震
夏，蝗	夏季，发生蝗灾
东海朐山崩	东海朐山发生山崩
乙卯，封乳母马惠子初为列侯	乙卯，桓帝封乳母马惠的儿子马初为列侯
秋，九月，丁卯朔，日有食之	秋季，九月丁卯朔，出现日食
太尉胡广免；以司徒黄琼为太尉	太尉胡广被免官，任命司徒黄琼为太尉
闰月，以光禄勋尹颂为司徒	闰九月，擢升光禄勋尹颂为司徒
冬，十一月，甲辰，帝校猎上林苑，遂至函谷关	冬季，十一月甲辰，桓帝前往上林苑打猎，随后到函谷关
泰山、琅邪贼公孙举、东郭窦等反，杀长吏	泰山郡、琅邪郡贼帅公孙举、东郭窦等起兵叛，杀害地方官吏
	永寿元年
二月，司隶、冀州饥，人相食	二月，司隶、冀州发生饥荒，出现人吃人的现象
夏，南阳大水	夏季，南阳郡发生大水灾
司空房植免；以太常韩为司空	司空房植被免官；擢升太常韩为司空
巴郡、益州郡山崩	巴郡和益州郡，发生山崩
春，三月，蜀郡属国夷反	春季，三月，蜀郡属国的夷人起兵反叛
冬，十二月，地震	冬季，十二月，发生地震
封梁不疑子马为颍阴侯，梁胤子桃为城父侯	封梁不疑的儿子梁马为颍阴侯，梁胤的儿子梁桃为城父侯
闰五月庚辰晦，出现日食	京师蝗
京都洛阳发生蝗灾	或上言：民之贫困以货轻钱薄，宜改铸大钱
冬季，十一月，司徒尹颂去世	长沙蛮反，寇益阳
长沙郡蛮人反叛，攻打益阳县	以司空韩为司徒；以太常北海孙朗为司空
任命司空韩为司徒；擢升太常、北海人孙朗为司空	夏，五月，甲戌晦，日有食之
延熹元年	
京都洛阳发生蝗灾	六月，戊寅，赦天下，改元
举行求雨的祭祀大典	秋，七月，甲子，太尉黄琼免；以太常胡广为太尉
秋季，七月甲子，太尉黄琼被免官，擢升太常胡广为太尉	冬，十月，帝校猎广成，遂幸上林苑
春季，二月，鲜卑侵犯雁门郡	蜀郡夷寇蚕陵
蜀郡夷人攻打蚕陵县	三月，复断刺史、二千石行三年丧
三月，再次取消刺史和二千石官吏为父母服丧三年的规定	夏，京师大水
夏季，京都洛阳发生水灾	六月，鲜卑寇辽东
擢升大司农黄琼为太尉，光禄大夫、中山国人祝恬为司徒，大鸿胪、梁国人盛允为司空	尚书令陈蕃上疏荐五处士，豫章徐稚、彭城姜肱、汝南袁闳、京兆韦著、颍川李昙；帝悉以安车、玄备礼征之，皆不至
冬，十月，壬申，上行幸长安	冬季，十月壬申，桓帝前往长安巡视
十二月，己巳，上还自长安	十月己巳，桓帝从长安返回京都洛阳
夏，五月，甲戌，汉中山崩	夏季，五月甲戌，汉中郡发生山崩
六月，辛丑，司徒祝恬薨	六月辛丑，司徙祝恬去世
秋，七月，以司空盛允为司徒，太常虞放为司空	秋季，七月，任命司空盛允为司徒，擢升太常虞放为司空
勒姐、零吾种羌围允街；段击破之	勒姐、零吾种羌人包围允街，段将其击破
大疫	发生大瘟疫
二月，壬辰，武库火	二月壬辰，兵器库失火
司徒盛允免，以大司农种为司徒	司徒盛允被免官，擢升大司农种为司徒
甲寅，封河间孝王子参户亭侯博为任城王，奉孝王后	甲寅，封河间孝王刘开的儿子、参户亭侯刘博为任城王，做已故任城孝王刘尚的继承人，侍奉祭祀
五月，辛酉，有星孛于心	五月酉，有异星出现在心宿星座
丁卯，原陵长寿门火	丁卯，光武帝陵园原陵长寿门失火
己卯，京师雨雹	己卯，京都洛阳降雹
六月，京兆、扶风及凉州地震	六月，京光、扶风及凉州发生地震
庚子，岱山及博尤来山并颓裂	庚子，岱山以及博县境内的尤来山都发生了山崩
己酉，赦天下	己酉，大赦天下
司空虞放免，以前太尉黄琼为司空	司空虞放被免官，任命前太尉黄琼为司空
犍为属国夷寇钞百姓	犍为属国夷人劫掠百姓
益州刺史山昱击破之	益州刺史山昱将其击破
秋，七月，京师雩	秋季，七月，京都洛阳举行求雨大典
减公卿已下奉，王侯半租，占卖关内侯、虎贲、羽林缇骑、营士、五大夫钱各有差	朝廷削减三公九卿以下官吏的俸禄
	向各封国的王、侯，
九月，司空黄琼免，以大鸿胪东莱刘宠为司空	九月，司空黄琼被免官，擢升大鸿胪、东莱人刘宠为司空
春，正月，壬午，南宫丙署火	春季，正月壬午，南宫丙署失火
夏，四月，长沙贼起，寇桂阳、苍梧	夏季，四月，长沙盗贼反叛，攻打桂阳郡、苍梧郡
乙丑，恭陵东阙火	乙丑，安帝陵园恭陵寝殿东门失火
戊辰，虎贲掖门火	戊辰，虎贲卫士所在地的厕门失火
五月，康陵园寝火	五月，殇帝陵园康陵寝殿失火
乙亥，京师地震	乙亥，京都洛阳发生地震
甲申，中藏府丞禄署火	四申，中藏府丞掌管的俸禄署失火
秋七月，己未，南宫承善闼火	秋季，七月己未，南宫承善闼失火
鸟吾羌寇汉阳，陇西、金城诸郡兵讨破之	鸟吾羌攻打汉阳，陇西、金城等郡军队将其讨伐击破
滇那羌寇武威、张掖、酒泉	滇那羌攻打武威郡、张掖郡、酒泉郡
太尉刘矩免，以太常杨秉为太尉	太尉刘矩被免官，擢升太常杨秉为太尉
春，二月，戊午，司徒种薨	春季，二月戊午，司徒种去世
三月，戊戌，赦天下	三月戊戌，大赦天下
以卫尉颍川许栩为司徒	擢升卫尉、颍川人许栩为司徒
夏，四月，辛亥，康陵东署火	夏季，四月辛亥，康陵东署失火
五月，鲜卑寇辽东属国	五月，鲜卑攻打辽东属国
秋，七月，甲申，平陵园寝火	秋季，七月甲申，昭帝陵园平陵墓园寝殿失火
十一月，司空刘宠免	十一月，司空刘宠被免官
十二月，以卫尉周景为司空	十二月，擢升卫尉周景为司空
景，荣之孙也	周景是周荣的孙子
春，二月，丙戌，乡忠侯黄琼薨	春季，二月丙戌，乡侯黄琼去世
将葬，四方远近名士会者六七千人	临下葬时，四方远近知名人士前来吊丧的有六七千人
三月，癸亥，陨石于	三月癸亥，县坠落陨石
夏，五月，已丑，京师雨雹	夏季，五月己丑，京都洛阳降下冰雹
护羌校尉段击当煎羌，破之	护羌校尉段，率军进击当煎羌民，将其击破
十二月，辛丑，车驾还宫	十二月辛丑，桓帝返回京都洛阳皇宫
中常侍汝阳侯唐衡、武原侯徐璜皆卒	中常侍汝阳侯唐衡、武原侯徐璜二人全都病故
春，正月，帝遣中常侍左之苦县祠老子	春季，正月，桓帝派遣中常侍左前往苦县祭祀老子
丙申晦，日有食之	丙申晦，发生日食
诏公、卿、校尉举贤良方正	桓帝下诏，命三公、九卿、校尉向朝廷推荐贤良方正人才
千秋万岁殿火	千秋万岁殿失火
护羌校尉段击罕姐羌，破之	护羌校尉率军进击罕姐羌人部落，将其击破
三月，辛巳，赦天下	三月辛巳，大赦天下
夏，四月，甲寅，安陵园寝火	夏季，四月甲寅，西汉惠帝陵园安陵寝殿失火
丁巳，诏坏郡国诸淫祀，特留雒阳王涣、密县卓茂二祠	丁巳，桓帝下诏，命各郡各封国拆除滥设的祠庙，仅准许保留京都洛阳王涣和密县卓茂这两处祠庙
五月，丙戌，太尉杨秉薨	五月丙戌，太尉杨秉去世
秉为人，清白寡欲，尝称我有三不惑：酒、色、财也	杨秉为人清白，欲望很少，曾经自称我有三不惑：美酒、女色、钱财
闰月，甲午，南宫朔平署火	闰月甲午，南宫北门朔平署失火
段击破西羌，进兵穷追，展转山谷间，自春及秋，无日不战，虏遂败散，凡斩首二万三千级，获生口数万人，降者万余落	段率军击破西羌，乘胜穷追，转战山谷之间，从春季直到秋季，没有一天不战斗，反叛的羌民终于溃败和逃散，共计斩杀二万三千人，俘虏数万人，投降的有一万余落
封都乡侯	朝廷封段为都乡侯
秋，七月，以太中大夫陈蕃为太尉	秋季，七月，擢升太中大夫陈蕃为太尉
蕃让于太常胡广、议郎王畅、弛刑徒李膺，帝不许	陈蕃先后提出，将太尉之位让给太常胡广、议郎王畅和弛刑徒李膺，桓帝没有批准
八月，戊辰，初令郡国有田者亩敛税钱	八月戊辰，首次命令各郡、各封国，对有田者以亩为单位征收赋税
九月，丁未，京师地震	九月丁未，京都洛阳发生地震
冬，十月，司空周景免；以太常刘茂为司空	冬季，十月，司空同景被免官，擢升太常刘茂为司空
茂，恺之子也	刘茂是刘恺的儿子
十一月，壬子，黄门北寺火	十一月壬子，黄门北寺失火
司隶、豫州饥，死者什四五，至有灭户者	司隶、豫州发生饥荒，饿死的人有十分之四五，有的家庭甚至没有留下一个人
诏征张奂为大司农，复以皇甫规代为度辽将军	桓帝下诏，征召张奂，任命他为大司农，重新任命皇甫规接替张奂担任度辽将军
规自以为连在大位，欲求退避，数上病，不见听	皇甫规因自己一连担任高官职位，为了谋求退避，不断上书称病，要求辞职，朝廷都不批准
会友人丧至，规越界迎之，因令客密告并州刺史胡芳，言规擅远军营，当急举奏	正好有朋友灵柩运回故乡安葬，皇甫规越过辖区边界迎接，然后派他的宾客秘密告诉并州刺史胡芳，指控皇甫规擅自远离军营，应当紧急向朝廷检举弹劾
芳曰：威明欲避第仕涂，故激发我耳	胡芳说：皇甫规为了想早日脱离官场，所以，对我采取这种激将法
吾当为朝廷爱才，何能申此子计邪	我应该为朝廷爱惜人才，不能中他的计
遂无所问	便不闻不问
夏，四月，济阴、东郡、济北、平原河水清	夏季，四月，济阴郡、东郡、济北国、平原郡等地黄河河水澄清
鲜卑闻张奂去，招结南匈奴及乌桓同叛	鲜卑听说张奂被调回京都洛阳，于是召集南匈奴和乌桓一齐起兵反叛
六月，南匈奴、乌桓、鲜卑数道入塞，寇掠缘边九郡	六月，南匈奴、乌桓、鲜卑分兵数路，攻入边塞，劫掠沿边九郡
秋七月，鲜卑复入塞，诱引东羌与共盟诅	秋季，七月，鲜卑再次攻入边塞，引诱东羌部落共同盟誓
于是上郡沈氐、安定先零诸种共寇武威、张掖，缘边大被其毒	于是上郡的沈氐、安定郡的先零等部羌民联合攻打武威郡、张掖郡，使沿边的郡县深受其害
诏复以张负为护匈奴中郎将，以九卿秩督幽、并、凉三州及度辽、乌桓二营，兼察刺史、二千石能否	桓帝下诏，重新任命张奂为护匈奴中郎将，领取和九卿同等的薪俸，督察幽、并、凉三州和度辽将军、护乌桓校尉两营的军事，兼负责考核州刺史和郡太守的政绩
九月，以光禄勋周景为太尉	九月，擢升光禄勋周景为太尉
以越骑校尉窦武为城门校尉	任命越骑校尉窦武为城门校尉
武在位，多辟名士，清身疾恶，礼赂不通；妻子衣食裁充足而已，得两宫赏赐，悉散与太学诸生及丐施贫民，由是众誉归之	窦武在任期间，多方延聘知名人士，洁身自爱，疾恶如仇，杜绝贿赂；妻子儿女的衣服饮食费用，仅够开支而已，得到皇帝和皇后两宫的赏赐，全都发散给太学的学生和施舍给贫民，因此，受到大家的一致赞赏和称誉
夫馀王夫台寇玄菟；玄菟太守公孙域击破之	夫馀王国国王夫台攻打玄菟郡，玄菟郡太守公孙域率军将其击破
夏，四月，先零羌寇三辅，攻没两营，杀千余人	夏季，四月，先零部羌民大举进犯三辅地区，攻灭京兆虎牙营和扶风雍营，杀害一千余人
五月，壬字晦，日有食之	五月壬子晦，发生日食
六月，大水，勃海溢	六月，发生大水灾，勃海海水倒灌泛滥
十二月，壬申，复瘿陶王悝为勃海王	十二月壬申，重新改封瘿陶王刘悝为勃海王
春，正月，壬午，以城门校尉窦武为大将军	春季，正月壬午，升城门校尉窦武为大将军
前太尉陈蕃为太傅，与武及司徒胡广参录尚书事	任命前太尉陈蕃为太傅，和窦武以及司徒胡广统领尚书台事宜
二月，辛酉，葬孝桓皇帝于宣陵，庙曰威宗	二月辛酉，将桓帝安葬在宣陵，庙号为威宗
辛未，赦天下	辛未，大赦天下
闰月，甲午，追尊皇祖为孝元皇，夫人夏氏为孝元后，考为孝仁皇，尊帝母董氏为慎园贵人	闰月甲午，追尊灵帝祖父刘淑为孝元皇，祖母夏氏为孝元后，父亲刘苌为孝仁皇，母亲董氏为慎园贵人
五月，丁未朔，日有食之	五月丁未朔，发生日食
以太中大夫刘矩为太尉	擢升太中大夫刘矩为太尉
六月，京师大水	六月，京都洛阳发生大水灾
癸巳，录定策功，封窦武为闻喜侯，武子机为渭阳侯，兄子绍为侯，靖为西乡侯，中常侍曹节为长安乡侯，侯者凡十一人	癸巳，论拥立皇帝的功劳，封窦武为闻喜侯，窦武的儿子窦机为渭阳侯，侄儿窦绍为侯，窦靖为西乡侯，中常侍曹节为长安乡侯，共封侯爵十一人
段将轻兵追羌，出桥门，晨夜兼行，与战于奢延泽、落川、令鲜水上，连破之	破羌将军段，率领轻装部队穷追残余羌众，出桥门谷，日夜兼程，先后在奢延泽、落川、令鲜水等地接连发生战斗，取得一连串胜利
又战于灵武谷，羌遂大败	尔后，又追到灵武谷，大败羌众
秋，七月，至泾阳，余寇四千落，悉散入汉阳山谷间	秋季，七月，段率军追击到泾阳，残余羌众只剩下四千余个帐落，全都逃散进入汉阳郡的各个山谷里
八月，司空王畅免，宗正刘宠为司空	八月，司空王畅被免官，擢升宗正刘宠为司空
以司徒胡广为太傅，录尚书事，司空刘宠为司徒，大鸿胪许栩为司空	任命司徒胡广为太傅，主管尚书事务；司空刘宠为司徒；擢升大鸿胪许栩为司空
冬，十月，甲辰晦，日有食之	冬季，十月甲辰晦，发生日食
十一月，太尉刘矩免，以太仆沛国闻人袭为太尉	十一月，太尉刘矩被免官，升太仆、沛国人闻人袭为太尉
十二月，鲜卑及貊寇幽、并二州	十二月，鲜卑和貊侵犯幽、并二州
是岁，疏勒王季父和得杀其王自立	同年，西域疏勒王国国王的叔父和得，杀掉国王，自立为王
春，正月，丁丑、赦天下	春季，正月丁丑，大赦天下
九月，江夏蛮反，州郡讨平之	九月，江夏郡蛮族起兵反叛，州郡官府出兵，将其讨伐平定
丹杨山越围太守陈夤，夤击破之	丹杨郡山越族起兵反叛，包围郡太守陈夤，被陈夤率军击破
庚子晦，日有食之	庚子晦，发生日食
十一月，太尉刘宠免；太仆扶沟郭禧为太尉	十一月，太尉刘宠被免官，擢升太仆扶沟县人郭禧为太尉
鲜卑寇并州	鲜卑侵犯并州
长乐太仆曹节病困，诏拜车骑将军	长乐太仆曹节病危，灵帝下诏，任命他为车骑将军
有顷，疾廖，上印绶，复为中常侍，位特进，秩中二千石	不久，病愈，交回印信，仍担任中常侍，官位为特进，官秩为中二千石
高句骊王伯固寇辽东，玄菟太守耿临讨降之	高句丽国王伯固侵犯辽东郡，玄菟郡太守耿临率军前往讨伐，伯固归降
	三年(庚戌、170)
春，三月，丙寅晦，日有食之	春季，三月丙寅晦，发生日食
段还京师，拜侍中	征调段返回京都洛阳，任命他为侍中
在边十余年，未尝一日蓐寝，与将士同甘苦，故皆乐为死战，所向有功	段在边疆十余年，从来没有一天安心睡觉，和将士同甘共苦，所以部属都甘愿奋不顾身地拚死战斗，大军所到之处都能建立功勋
夏，四月，太尉郭禧罢；以太中大夫闻人袭为太尉	夏季，四月，太尉郭禧被罢免，擢升太中大夫闻人袭为太尉
九月，执金吾董宠坐矫永乐太后属请，下狱死	九月，执金吾董宠因假传他的妹妹董太后的谕旨有所请托，被下狱处死
冬，郁林太守谷永以恩信招降乌浒人十余万，皆内属，受冠带，开置七县	冬季，郁林郡太守谷永用恩德和威信招降乌浒蛮族十余万人，归服朝廷，授给帽子和腰带，设立了七个县
凉州刺史扶风孟佗谴从事任涉将敦煌兵五百人，与戊已校尉曹宽、西域长史张宴将焉耆、龟兹、车师前、后部，合三万余人讨疏勒，功桢中城，四十余日，不能下，引去	凉州刺史、右扶风郡人孟佗派遣从事任涉率领敦煌郡兵五百人，会同戊已校尉曹宽、西域长史张宴，动员焉耆王国、龟兹王国、车师前王国、车师后王国军队，共三万余人，前往讨伐疏勒王国，功打桢中城，经过四十余天不能攻克，只好撤退
其后疏勒王连相杀害，朝廷亦不能复治	从此以后，疏勒国王接连不断地被杀害，朝廷再也没有力量进行干预
春，正月，甲子，帝加元服，赦天下，唯党人不赦	春季，正月甲子，灵帝行成年加冠礼，大赦天下，只有党人不在赦免之列
二月，癸卯，地震	二月癸卯，发生地震
三月，辛酉朔，日有食之	三月辛酉朔，发生日食
太尉闻人袭免；以太仆汝南李咸为太尉	太尉闻人袭被免官，擢升汝南郡人李咸为太尉
秋，七月，司空来艳免	秋季，七月，司空来艳被免官
癸丑，立贵人宋氏为皇后	癸丑，灵帝封宋贵人为皇后
后，执金吾酆之女也	宋皇后是执金吾宋酆的女儿
司徒桥玄免；以太常南阳宗俱为司空，前司空许栩为司徒	司徒桥玄被免官，擢升太常、南阳郡人宗俱为司空，任命前任司空许栩为司徒
帝以窦太后有援立之功，冬，十月，戊子朔，率群臣朝太后于南宫，亲馈上寿	灵帝认为窦太后援立自己继承帝位有功，冬季，十月戊子朔，他率领朝廷文武百官，前往南宫朝见窦太后，并亲自向窦太后进食和祝寿
黄门令董萌因此数为太后诉冤，帝深纳之，供养资奉，有加于前	因此，黄门令董萌多次为窦太后申诉冤枉，灵帝深为采纳，对于供养窦太后的财物，都比以前增加
曹节、王甫疾之，诬萌以谤讪永乐宫，下狱死	曹节、王甫对此非常痛恨，于是诬告董萌诽谤灵帝母亲董太后，将董萌下狱处死
鲜卑寇并州	鲜卑攻打并州
三月，壬戌，太傅胡广薨，年八十二	三月壬戌，太傅胡广去世，享年八十二岁
广周流四公，三十余年，历事六帝，礼任极优，罢免未尝满岁，辄复升进	胡广，字伯始，历任太傅、太尉、司徒和司空，前后任职三十余年，曾侍奉过安、顺、冲、质、桓、灵等六个皇帝，受到极优厚的礼遇，每次被免职，不出一年，即又复职
所辟多天下名士，与故吏陈蕃、李咸并为三司	他所聘用的大都是天下的知名人士，曾和他过去的部属陈蕃、李咸并列三公
练达故事，明解朝章，故京师谚曰：万事不理，问伯始；天下中庸，有胡公	他非常熟悉先朝的典章制度，通晓当代的朝廷规章，所以京都洛阳有谚语说：万事不理问伯始，不偏不倚有胡公
然温柔谨悫，常逊言恭色以取媚于时，无忠直之风，天下以此薄之	然而，胡广温柔敦厚，谨小慎微，以此取媚朝廷，没有忠贞正直的气节，天下的人因此而轻视他
五月，己巳，赦天下，改元	五月己巳，大赦天下，改年号
长乐太仆侯览坐专权骄奢，策收印绶，自杀	长乐太仆侯览因专权跋扈和骄横奢侈获罪，灵帝下令收回印信，侯览自杀
六月，京师大水	六月，京都洛阳发生大水灾
十二月，司徒许栩罢；以大鸿胪袁隗为司徒	十二月，司徒许栩被罢免，擢升大鸿胪袁隗为司徒
鲜卑寇并州	鲜卑侵犯并州
是岁，单于车儿死，子屠特若尸逐就单于立	同年，南匈奴汗国伊陵若尸逐就单于栾提车儿去世，儿子继位，号为屠特若尸逐就单于
	二年
春，正月，大疫	春季，正月，发生大瘟疫
丁丑，司空宗俱薨	丁丑，司空宗俱去世
二月，壬午，赦天下	二月壬午，大赦天下
以光禄勋杨赐为司空	擢升光禄勋杨赐为司空
三月，太尉李咸免	三月，太尉李咸被免官
夏，五月，以司隶校尉段为太尉	夏季，五月，擢升司隶校尉段为太尉
六月，北海地震	六月，北海国发生地震
秋，七月，司空杨赐免；以太常颍川唐珍为司空	秋季，七月，司空杨赐被免官，擢升太常颍川郡人唐珍为司空
珍，衡之弟也	唐珍是唐衡的弟弟
冬，十二月，太尉段罢	冬季，十二月，太尉段被罢免
鲜卑寇幽、并二州	鲜卑侵犯幽州、并州
癸酉晦，日有食之	癸酉晦，发生日食
	三年
春，二月，己巳，赦天下	春季，二月己巳，大赦天下
以太常东海陈耽为太尉	擢升太常东海郡陈耽为太尉
三月，中山穆王畅薨，无子，国除	三月，中山王刘畅去世，无子继承，封国被撤除
夏，六月，封河间王利子康为济南王，奉孝仁皇祀	夏季，六月，封河间王刘利的儿子刘康为济南王，侍奉灵帝父亲、孝仁皇刘苌的祭祀
吴郡司马富春孙坚召募精勇，得千余人，助州郡讨许生	吴郡司马富春县人孙坚招募精锐强悍的勇士，集结千余人，帮助州郡官府讨伐妖贼许生
冬，十一月，臧、陈寅大破生于会稽，斩之	冬季，十一月，臧、陈寅在会稽郡大破许生，并将许生斩杀
任城王博薨，无子，国绝	任城王刘博去世，无子继承，封国撤销
十二月，鲜卑入北地，太守夏育率屠各追击，破之	十二月，鲜卑攻入北地郡，太守夏育率领屠各兵前往追击，将其击破
迁育为护乌桓校尉	夏育被朝廷擢升为护乌桓校尉
鲜卑又寇并州	鲜卑又侵犯并州
司空唐珍罢，以永乐少府许训为司空	司空唐珍被罢免，擢升永乐少府许训为司空
	四年
封河间王建孙佗为任城王	封河间王刘建的孙子刘佗为任城王
夏，四月，郡、国七大水	夏季，四月，有七个郡、封国发生大水灾
五月，丁卯，赦天下	五月丁卯，大赦天下
延陵园灾	汉成帝陵园延陵失火
鲜卑寇幽州	鲜卑侵犯幽州
六月，弘农、三辅螟	六月，弘农郡和三辅地区螟虫成灾
夏，四月，癸亥，赦天下	夏季，四月癸亥，大赦天下
益州郡夷反，太守李讨平之	益州郡夷族起兵反叛，太守李率军前往讨伐，将其平定下去
大雩	朝廷举行祈雨祭祀大典
五月，太尉陈耽罢；以司空许训为太尉	五月，太尉陈耽被罢免，任命司空许训为太尉
六月，壬戌，以太常南阳刘逸为司空	六月壬戌，擢升太常南阳郡人刘逸为司空
秋，七月，太尉许训罢；以光禄勋刘宽为太尉	秋季，七月，太尉许训被罢免，擢升光禄勋刘宽为太尉
是岁，鲜卑寇幽州	同年，鲜卑侵犯幽州
	六年
春，正月，辛丑，赦天下	春季，正月辛丑，大赦天下
夏，四月，大旱，七州蝗	夏季，四月，大旱，有七个州蝗虫成灾
鲜卑寇三边	鲜卑侵犯东、西、北等三边
秋，七月，司空刘逸免；以卫尉陈球为司空	秋季，七月，司空刘逸被免官，擢升卫尉陈球为司空
冬，十月，癸丑朔，日有食之	冬季，十月癸丑朔，发生日食
太尉刘宽免	太尉刘宽被免官
辛丑，京师地震	辛丑，京都洛阳发生地震
十一月，司空陈球免	十一月，司空陈球被免官
	．
十二月，甲寅，以太常河南孟为太尉	十二月甲寅，擢升太常河南尹人孟为太尉
庚辰，司徒杨赐免	庚辰，司徒杨赐被免官
以太常陈耽为司空	擢升太常陈耽为司空
春，正月，合浦，交趾乌浒蛮反，招引九真、日南民攻没郡县	春季，正月，合浦郡、交趾郡乌浒蛮族起兵反叛，并招诱九真郡、日南郡百姓攻陷郡县
太尉孟罢	太尉孟被罢免
二月，辛亥朔，日有食之	二月辛亥朔，发生日食
癸丑，以光禄勋陈国袁滂为司徒	癸丑，擢升光禄勋陈国人袁滂为司徒
已未，地震	己未，发生地震
三月，辛丑，赦天下，改元	三月辛丑，大赦天下，改年号
以太常常山张颢为太尉	擢升太常常山国人张颢为太尉
颢，中常侍奉之弟也	张颢是中常侍张奉的弟弟
夏，四月，丙辰，地震	夏季，四月丙辰，发生地震
侍中寺雌鸡化为雄	侍中官署有一只母鸡变成公鸡
司空陈耽免；以太常来艳为司空	司空陈耽被免官，擢升太常来艳为司空
六月，丁丑，有黑气堕帝所御温德殿东庭中，长十余丈，似龙	六月丁丑，有一道黑气从天而降，坠落到灵帝常去的温德殿东侧庭院中，长十余丈，好象一条黑龙
八月，有星孛于天市	八月，有异星出现在天市星旁
九月，太尉张颢罢；以太常陈球为太尉	九月，太尉张颢被罢免，擢升太常陈球为太尉
司空来艳薨	司空来艳去世
冬，十月，以屯骑校尉袁逢为司空	冬季，十月，擢升屯骑校尉袁逢为司空
丙子晦，日有食之	丙子晦，发生日食
十一月，太尉陈球免；十二月，丁巳，以光禄大夫桥玄为太尉	十一月，太尉陈球被免官，十二月丁巳，擢升光禄大夫桥玄为太尉
鲜卑寇酒泉；种众日多，缘边莫不被毒	鲜卑侵犯酒泉郡，出动的兵力日益增多，边界一带都深受他们的毒害
诏中尚方为鸿都文学乐松、江览等三十二人图象立赞，以劝学者	灵帝下诏，命中尚方官署为鸿都门的文学之士乐松、江览等三十二人，各画一张肖像，分别配上赞美的言辞，作为对后学晚辈的劝告和勉励
尚书令阳球谏曰：臣案松、览等皆出于微蔑，斗筲小人，依凭世戚，附托权豪，俯眉承睫，徼进明时	尚书令阳球上书劝阻说：我查考乐松、江览等人都出身微贱，不过是才识短浅的斗筲小人，依靠和皇室世代有婚姻关系的国戚，依附和请托有权势的豪门，看人眼色，阿谀奉承，侥幸得以上进
或献赋一篇，或鸟篆盈简，而位升郎中，形图丹青	有的呈献一篇辞赋，有的写出满简的鸟篆，竟然被擢升为郎中，还要用丹青画像
亦有笔不点牍，辞不辨心，假手请字，妖伪百品，莫不蒙被殊恩，蝉蜕滓浊	也有一个字没写，一句辞不会作，完全请别人代替出手，怪诞诈伪，花样百出，可是全都蒙受特殊的恩典，好象鸣蝉脱壳一样，从微贱的地位中解脱出来
是以有识掩口，天下嗟叹	以致有见识的人无不对此掩口而笑，天下一片嗟叹之声
臣闻图象之设，以昭劝戒，欲令人君动鉴得失，未闻竖子小人诈作文颂，而可妄窃天官，垂象图素者也	我听说之所以设立画像，是为了表示劝勉告诫，希望君主的举动能够借鉴前人的得失成败，却从来没有听说竖子小人们弄虚作假，写作了几篇歌颂文章，就可以妄自窃取高官厚禄，并且在素帛上留下画像
今太学、东观足以宣明圣化，愿罢鸿都之选，以销天下之谤	而今有太学、东观这两个地方，已经足够宣传圣明的教化，请陛下废止鸿都门文学的推荐和选举，以解除天下的谴责
书奏，不省	奏章呈上去后，灵帝不理
南匈奴屠特若尸逐就单于死，子呼徵立	南匈奴汗国屠特若尸逐就单于去世，他的儿子栾提呼征继位为单于
	二年
春，大疫	春季，发生大瘟疫
三月，司徒袁滂免，以大鸿胪刘为司徒	三月，司徒袁滂被免官，擢升大鸿胪刘为司徒
乙丑，太尉桥玄罢，拜太中大夫；以太中大夫段为太尉	乙丑，太尉桥玄被罢免，任命他为太中大夫；擢升太中大夫段为太尉
玄幼子游门次，为人所劫，登楼求货；玄不与	桥玄最小的儿子在门口游玩，被匪徒劫持，当作人质，登楼要求钱货作赎金，桥玄不肯给
司隶校尉、河南尹围守玄家，不敢迫	司隶校尉、河南尹等派人将桥玄的家宅包围守住，不敢向前进逼
玄目呼曰：奸人无状，玄岂以一子之命而纵国贼乎	桥玄怒目大声呼喊说：奸人的罪恶数不胜数，我岂能因一个儿子的性命，而让国贼逃脱法网
促令攻之，玄子亦死	催促他们迅速进攻，桥玄的儿子也被杀害
玄因上言：天下凡有劫质，皆并杀之，不得赎以财宝，开张奸路	桥玄因而向朝廷上书说：天下凡是有劫持人质勒索财物的，都应该同时诛杀，不准许用钱财宝物赎回人质，为奸邪开路
由是劫质遂绝	从此，劫持人质的事件绝迹
京兆地震	京兆发生地震
司空袁逢罢；以太常张济为司空	司空袁逢被罢免，擢升太常张济为司空
夏，四月，甲戌朔，日有食之	夏季，四月甲戌朔，发生日食
丁酉，赦天下	丁酉，大赦天下
上禄长和海上言：礼，从祖兄弟别居异财，恩义已轻，服属疏末	上禄县长和海上书灵帝说：根据礼制，同曾祖而不同祖父的兄弟，已经分开居住，家财也已分开，恩德和情义已经很轻，从丧服上说只不过是疏远的家族
而今党人锢及五族，既乖典训之文，有谬经常之法	而今禁锢党人却扩大到这类疏远亲属，既不符合古代的典章制度，也不符合正常的法令规章
帝览之而悟，于是党锢自从祖以下皆得解释	灵帝看到奏章后醒悟，于是对党人的禁锢从伯叔祖父以下都得到解除
五月，以卫尉刘宽为太尉	五月，擢升卫尉刘宽为太尉
护匈奴中郎将张与南单于呼徵不相能，擅斩之，更立右贤王羌渠为单于	护匈奴中郎将张与南匈奴汗国单于栾提呼徵不和睦，张擅自斩杀栾提呼征，并改立右贤王栾提羌渠为南匈奴汗国单于
秋，七月，坐不先请而擅诛杀，槛车征诣廷尉，死	秋季，七月，张被指控事先没有奏请朝廷批准而擅自诛杀，被用囚车押回京都洛阳，送往廷尉监狱处死
巴郡板蛮反，遣御史中丞萧瑗督益州刺史讨之，不克	巴郡板部蛮族起兵反叛，朝廷派遣御史中丞萧瑗督促益州刺史率军前往讨伐，未能取胜
十二月，以光禄勋杨赐为司徒	十二月，擢升光禄勋杨赐为司徒
鲜卑寇幽、并二州	鲜卑侵犯幽州、并州
	三年
春，正月，癸酉，赦天下	春季，正月癸酉，大赦天下
夏，四月，江夏蛮反	夏季，四月，江夏郡蛮族起兵反叛
秋，酒泉地震	秋季，酒泉郡发生地震
冬，有星孛于狼、弧	冬季，有异星出现于狼星、弧星之间
鲜卑寇幽、并二州	鲜卑侵犯幽州、并州
十二月，己已，立贵人何氏为皇后	十二月己巳，封何贵人为皇后
征后兄颍川太守进为侍中	征召何皇后的哥哥、颍川郡太守何进为侍中
后本南阳屠家，以选入掖庭，生皇子辨，故立之	何皇后本是南阳郡一个屠户家的女儿，后被选进宫廷，生下皇子刘辨，所以被灵帝立为皇后
巴郡板蛮反	巴郡板部蛮族再度起兵反叛
