春正月，初置骥厩丞，领受郡国调马	春季，正月，首次设立骥厩丞，负责接收和饲养从各郡、国征发来的马匹
豪右辜榷，马一匹至二百万	由于各地豪强垄断马匹交易，马价涨到一匹值二百万钱
夏，四月，庚子，赦天下	夏季，四月，庚子，大赦天下
六月，庚辰，雨雹如鸡子	六月，庚辰，天上降下大如鸡蛋的冰雹
秋，九月，庚寅朔，日有食之	秋季，九月，庚寅，出现日食
太尉刘宽免；卫尉许为太尉	太尉刘宽被免职，任命卫尉许为太尉
闰月，辛酉，北宫东掖庭永巷署灾	闰九月，辛酉，洛阳北宫东掖庭永巷署发生火灾
鲜卑寇幽、并二州	鲜卑族侵犯幽州与并州
檀石槐死，子和连代立	鲜卑族首领檀石槐去世，他的儿子和连继任首领
和连才力不及父而贪淫，后出攻北地，北地人射杀之	和连不仅才干和能力不如他的父亲，而且贪财好色，后来在进攻北地时，被北地人射死
其子骞曼尚幼，兄子魁头立	由于他的儿子骞曼年龄尚小，便由他哥哥的儿子魁头担任首领
后骞曼长大，与魁头争国，众遂离散	后来骞曼长大，与魁头争夺首领的地位，致使部众离散
魁头死，弟步度根立	魁头去世后，他的弟弟步度根继任首领
何皇后性强忌，后宫王美人生皇子协，后鸩杀美人	何皇后嫉妒心非常重，后宫王美人生下皇子刘协，何皇后就用毒药把王美人杀死
帝大怒，欲废后；诸中官固请，得止	灵帝大怒，要废掉何皇后，宦官们竭力为她求情，才使灵帝打消这个想法
大长秋华容侯曹节卒；中常侍赵忠代领大长秋	大长秋、华容侯曹节去世，由中常侍赵忠代理大长秋的职务
春，正月，辛未，赦天下	春季，正月，辛未，大赦天下
二月，大疫	二月，瘟疫到处流行
三月，司徒陈耽免	三月，司徒陈耽被免职
夏，四月，旱	夏季，四月，发生旱灾
以太常袁隗为司徒	任命太常袁隗为司徒
五月，庚申，永乐宫署灾	五月，庚申，永乐宫署发生火灾
秋，七月，有星孛于太微	秋季，七月，有异星出现于太微星旁
八月，起四百尺观于阿亭道	八月，在阿亭道建造起高达四百尺的楼台
冬，十月，太尉许罢；以太常杨赐为太尉	冬季，十月，太尉许被免职，任命太常杨赐为太尉
帝校猎上林苑，历函谷关，遂狩于广成苑	灵帝在上林苑打猎，后又经函谷关，到广成苑进行狩猎
十二月，还，幸太学	十二月，回到京城洛阳，到太学进行巡视
桓典为侍马御史，宦官畏之	桓典担任侍御史，宦官们都很怕他
典常乘骢马，京师为之语曰：行行且止，避骢御史	桓典常骑一匹青白杂色的马，京城洛阳因此传言说：走走停停，避开骑杂色马的御史
典，焉之孙也	桓典是桓焉的孙子
春，三月，辛未，赦天下	春季，三月，辛未，大赦天下
夏，大旱	夏季，出现严重旱灾
爵号皇后母为舞阳君	封何皇后的母亲为舞阳君
秋，金城河水溢出二十余里	秋季，金城郡境内的黄河水暴涨，泛滥两岸二十余里
五原山岸崩	五原郡境内发生山崩
庚子，南阳黄巾张曼成功杀太守褚贡	庚子，南阳郡的黄巾军将领张曼成进攻并杀死太守褚贡
汝南黄巾败太守赵谦于邵陵	汝南郡的黄巾军在邵陵击败太守赵谦所率的官军
广阳黄巾杀幽州刺史郭勋及太守刘卫	广阳郡的黄巾军杀幽州刺史郭勋及太守刘卫
八月，皇甫嵩与黄巾战于苍亭，获其帅卜巳	八月，皇甫嵩与黄巾军在苍亭大战，俘虏黄巾军将领卜巳
董卓攻张角无功，抵罪	董卓进攻张角，未能取胜，受到处分
乙巳，诏嵩讨角	乙巳，灵帝下诏，命皇甫嵩率军征讨张角
九月，安平王续坐不道，诛，国除	九月，安平王刘续被指控为大逆不道，处死，封国撤销
北地先零羌及罕、河关群盗反，共立湟中义从胡北宫伯玉、李文侯为将军，杀护羌校尉泠徵	北地郡羌族的先零部落及罕、河关两地的盗贼起来反抗，共同拥立湟中的义勇首领胡人北宫伯玉和李文侯为将军，杀死护羌校尉泠征
金城人边章、韩遂素著名西州，群盗诱而劫之，使专任军政，杀金城太守陈懿，攻烧州郡	金城人边章、韩遂在西州素有盛名，起事者将其诱骗来，武力胁迫他们主持军政事务，杀死金城太守陈懿，攻打焚烧州郡官府
十二月，己巳，赦天下，改元	十二月，己巳，大赦天下，改年号为中平元年
春，正月，大疫	春季，正月，瘟疫到处流行
二月，己酉，南宫云台灾	二月，巳酉，洛阳南宫的云台发生火灾
庚戌，乐城门灾	庚戌，皇宫的乐城门又发生火灾
以朱俊为右车骑将军	任命朱俊为右车骑将军
自张角之乱，所在盗贼并起，博陵张牛角、常山褚飞燕及黄龙、左校、于氐根、张白骑、刘石、左髭文八、平汉大计、司隶缘城、雷公、浮云、白雀、杨凤、于毒、五鹿、李大目、白绕、眭固、苦蝤之徒，不可胜数，大者二三万，小者六七千人	自从张角举事之后，各地盗贼纷纷起事
	有博陵人张牛角、常山人褚飞燕以及
司徒袁隗免	司徒袁隗被免职
三月，以廷尉崔烈为司徒	三月，任命廷尉崔烈为司徒
烈，之从兄也	崔烈是崔的堂兄
北宫伯玉等寇三辅，诏左车骑将军皇甫嵩镇长安以讨之	北宫伯玉等进攻三辅地区，灵帝下诏，命左车骑将军皇甫嵩镇守长安，指挥大军进行讨伐
夏，四月，庚戌，大雨雹	夏季，四月，庚戌天降大雹
六月，以讨张角功，封中常侍张让等十二人为列侯	六月，灵帝以讨伐张角有功的名义，封中常侍张让等十二人为列侯
秋，七月，三辅螟	秋季，七月，三辅地区螟虫成灾
九月，以特进杨赐为司空	九月，任命特进杨赐为司空
冬，十月，庚寅，临晋文烈侯杨赐薨	冬季，十月，庚寅，临晋侯杨赐去世，被谥为文烈
以光禄大夫许相为司空	任命光禄大夫许相为司空
相，训之子也	许相是许训的儿子
春，二月，江夏兵赵慈反，杀南阳太守秦颉	春季，二月，江夏郡的兵士赵慈聚众造反，杀死南阳郡太守秦颉
庚戌，赦天下	庚戌，大赦天下
太尉张延罢	太尉张延被免职
遣使者持节就长安拜张温为太尉	灵帝派遣使者持符节到长安，任命张温为太尉
三公在外始于温	在京城以外任命三公，由张温开始
以中常侍赵忠为车骑将军	任命中常侍赵忠为车骑将军
帝使忠论讨黄巾之功，执金吾甄举谓忠曰：傅南容前在东军，有功不侯，天下失望	灵帝命赵忠评定讨伐黄巾军的功劳
今将军亲当重任，宜进贤理屈，以副众心	执金吾甄举对赵忠说：傅燮先前在征伐东方的黄巾军时，立有大功，但是未被封侯，天下人感到失望
忠纳其言，遣弟城门校尉延致殷勤于傅燮	如今将军亲负这项重任，应该推举贤人，审理冤情，以满足众人之心
延谓燮曰：南容少答我常侍，万户侯不足得也	赵忠采纳了甄举的意见，派他的弟弟城门校尉赵延去向傅燮致意
燮正色拒之曰：有功不论，命也	赵延对傅燮说：只要你肯稍稍接受我哥哥的友情，封万户侯则不在话下
傅燮岂求私赏哉	傅燮正色地拒绝他说：有功而未得到封赏，是我的命运不好，我岂能乞求私人的恩惠
忠愈怀恨，然惮其名，不敢害，出为汉阳太守	赵忠知道后，越发怀恨，然而顾忌傅燮的名望，不敢公开加以迫害，便任命他为汉阳郡太守，离开了京城
五月，壬辰晦，日有食之	五月，壬辰晦，出现日食
六月，荆州刺史王敏讨赵慈，斩之	六月，荆州刺史王敏讨伐赵慈，将他斩杀
车骑将军赵忠罢	车骑将军赵忠被免职
冬，十月，武陵蛮反，郡兵讨破之	冬季，十月，武陵蛮族反叛，武陵郡的军队将他们镇压下去
前太尉张延为宦官所谮，下狱死	前任太尉张延遭宦官们诬陷，被逮捕，死在狱中
十二月，鲜卑寇幽、并二州	十二月，鲜卑族侵掠幽州与并州
征张温还京师	征召张温回京城洛阳
春，正月，己卯，赦天下	春季，正月，己卯，大赦天下
十二月，屠各胡反	十二月，匈奴屠各胡部落反叛
是岁，卖关内侯，直五百万钱	本年，售卖关内侯，价格为五百万钱
春，正月，丁酉，赦天下	春季，正月，丁酉，大赦天下
二月，有星孛于紫宫	二月，有异星出现于紫微星旁
黄巾余贼郭大等起于河西白波谷，寇太原、河东	黄巾军残部郭大等人在河西白波谷起兵，进攻太原郡、河东郡
三月，屠各胡攻杀并州刺史张懿	三月，匈奴屠各部落进攻并州，杀并州刺史张懿
夏，四月，太尉曹嵩罢	夏季，四月，太尉曹嵩被免职
五月，以永乐少府南阳樊陵为太尉；六月，罢	五月，任命永乐少府南阳樊陵为太尉；六月，将他免职
益州贼马相、赵祗等起兵绵竹，自号黄巾，杀刺史俭，进击巴郡、犍为，旬月之间，破坏三郡，有众数万，自称天子	益州人马相、赵祗等在绵竹起兵，自称为黄巾，杀死刺史俭，进攻巴郡、犍为，不过一个月，连破三郡，有部众数万人，马相自称天子
州从事贾龙率吏民攻相等，数日破走，州界清静	益州从事贾龙等率领官吏及百姓进攻马相等，几天后将他们打败，马相等逃跑，益州界内安宁
龙乃选吏卒迎刘焉	贾龙于是选派官兵去迎接刘焉
郡国七大水	有七个郡、国发生水灾
秋，七月，以射声校尉马日为太尉	秋季，七月，任命射声校尉马日为太尉
日，融之族孙也	马日他是马融的族孙
以卫尉条侯董重为票骑将军	任命卫尉、条侯董重为票骑将军
重，永乐太后兄子也	董重是灵帝母亲永乐太后哥哥的儿子
冬，十月，青、徐黄巾复起，寇郡县	冬季，十月，青州、徐州的黄巾军再度起兵，攻掠郡县
十一月，王国围陈仓	十一月，王国包围陈仓
诏复拜皇甫嵩为左将军，督前将军董卓，合兵四万人以拒之	灵帝下诏再次任命皇甫嵩为左将军，统率前将军董卓，共有军队四万人，去抵抗王国
董卓谓皇甫嵩曰：陈仓危急，请速救之	董卓对皇甫嵩说：陈仓形势危急，请赶快救援
嵩曰：不然，百战百胜，不如不战而屈人兵	皇甫嵩说：不然，百战百胜，不如不战而胜
陈仓虽小，城守固备，未易可拔	陈仓虽小，但城垣坚固，守卫严密，不容易攻破
王国虽强，攻陈仓不下，其众必疲，疲而击之，全胜之道也，将何救焉	王国兵力虽强，但攻不下陈仓，部众必然疲乏，我们乘他们疲乏，发动攻击，这是获得彻底胜利的策略，用得着什么援救呢
国攻陈仓八十余日，不拔	王国围攻陈仓八十余天，未能攻破
幽州牧刘虞到部，遣使至鲜卑中，告以利害，责使送张举、张纯首，厚加购赏	幽州牧刘虞到任后，派使臣到鲜卑部落去，告诉他们利害，责令他们斩送张举和张纯的人头，悬以重赏
丘力居等闻虞至，喜，各遣译自归	丘力居等听说刘虞来到幽州，都很高兴，各派翻译来晋见刘虞，自动归降
举、纯走出塞，余皆降散	张举、张纯逃到塞外，所余部下全都投降或逃散
虞上罢诸屯兵，但留降虏校尉公孙瓒，将步骑万人屯右北平	刘虞上奏，请求将征集的各部队全部遣散，只留下降虏校尉公孙瓒，率领步、骑兵一万人，驻扎在右北平
三月，张纯客王政杀纯，送首诣虞	三月，张纯的门客王政刺杀张纯，带张纯的人头去见刘虞
公孙瓒志欲扫灭乌桓，而虞欲以恩信招降，由是与瓒有隙	公孙瓒决心用武力消灭乌桓部落，而刘虞想用恩德和信义来招降他们，因此两人之间产生矛盾
夏，四月，丙子朔，日有食之	夏季，四月，丙子朔，出现日食
蹇硕忌大将军进，与诸常侍共说帝遣进西击韩遂；帝从之	蹇硕忌恨大将军何进，与诸常侍共同劝说灵帝派遗何进西征韩遂，灵帝同意了
进阴知其谋，奏遣袁绍收徐、兖二州兵，须绍还而西，以稽行期	何进暗中获悉他们的阴谋后，上奏请求派袁绍到徐州和兖州去调集军队，要等到袁绍回来再进行西征，以便拖延行期
辛酉，葬孝灵皇帝于文陵	辛酉，把灵帝安葬在文陵
何进惩蹇硕之谋，称疾，不入陪丧，又不送出陵	何进警惕会发生蹇硕那样的阴谋，自称有病，不入宫去陪丧，也不送灵帝的棺椁到墓地
大水	发生水灾
秋，七月，徒勃海王协为陈留王	秋季，七月，改封勃海王刘协为陈留王
司徒丁宫罢	司徒丁宫被免职
诏除公卿以下子弟为郎，以补宦官之职，侍于殿上	下诏，任命朝中公卿及以下官员的子弟为郎官，以填补原来由宦官担任的职务，在宫殿侍侯皇帝
乙酉，以太尉刘虞为大司马，封襄贲侯	乙酉，任命太尉刘虞为大司马，封襄贲侯
董卓自为太尉，领前将军事，加节传、斧钺、虎贲，更封侯	董卓自己担任太尉，兼前将军，并加赐代表皇帝权力的符节，以及作为仪仗的斧钺和虎贲卫士，进封为侯
丙戌，以太中大夫杨彪为司空	丙戌，任命太中大夫杨彪为司空
甲午，以豫州牧黄琬为司徒	甲午，任命豫州牧黄琬为司徒
董卓率诸公上书，追理陈蕃、窦武及诸党人，悉复其爵位，遣使吊祠，擢用其子孙	董卓率领三公等大臣上书，请求重新审理陈蕃、窦武以及党人的案件，一律恢复爵位，派使者去祭悼他们的坟墓，并擢用他们的子孙为官
自六月雨至于是月	自六月到九月，大雨连绵不断
冬，十月，乙巳，葬灵思皇后	冬季，十月，乙巳，安葬何太后
白波贼寇河东，董卓遣其将牛辅击之	白波叛军进攻河东郡，董卓派部下将领牛辅率军讨伐
十二月，戊戌，以司徒黄琬为太尉，司空杨彪为司徒，光禄勋荀爽为司空	十二月，戊戌，任命司徒黄琬为太尉，司空杨彪为司徒，光禄勋荀爽为司空
诏除光熹、昭宁、永汉三号	下诏废除光熹、昭宁、永汉三个年号，仍称本年为中平六年
辛亥，赦天下	辛亥，大赦天下
癸酉，董卓使郎中令李儒鸩杀弘农王辩	癸酉，董卓派郎中令李儒用毒酒杀死了弘农王刘辩
董卓以袁绍之故，戊午，杀太傅袁隗、太仆袁基，及其家尺口以上五十余人	董卓因袁绍的缘故，戊午，杀死太傅袁隗、太仆袁基，及其袁家婴孩以上的五十余口
董卓在雒阳，袁绍等诸军皆畏其强，莫敢先进	董卓镇守洛阳，袁绍等各部队都畏惧董卓军力强盛，无人胆敢先行进攻
曹操曰：举义兵以诛暴乱，大众已合，诸君何疑	曹操说：我们兴起义兵来诛除暴乱，大军已经集结，诸位还有什么迟疑
向使董卓倚王室，据旧京，东向以临天下，虽以无道行之，犹足为患	假如董卓倚仗皇帝的权威，据守洛阳，向东进军，尽管他凶残无道，也会成为我们的大患
今焚烧宫室，劫迁天子，海内震动，不知所归，此天亡之时也，一战而天下定矣	如今他烧毁宫殿，强迫天子迁徒，全国震动，不知道该跟从谁，这正是上天赐予我们灭亡董卓的时机，一战就可以平定天下
遂引兵西，将据成，张邈遣将卫兹分兵随之	于是，曹操率军向西进发，准备攻占成，张邈拨出部分军队，派部将卫兹率领，随曹操一同进军
进至荥阳汴水，遇卓将玄菟徐荣，与战，操兵败，为流矢所中，所乘马被创	曹军行进到荥阳汴水，与董卓部将玄菟人徐荣的部队相遇，双方交战，曹军战败
从弟洪以马与操，操不受	曹操被流箭射中，所骑的马也受了伤
洪曰：天下可无洪，不可无君	他的堂弟曹洪把马让给他，他不肯接受，曹洪说：天下可以没有曹洪，不可以没有您
遂步从操，夜遁去	于是曹操上马，曹洪步行跟从，乘着黑夜逃走
荣见操所将兵少，力战尽日，谓酸枣未易攻也，亦引兵还	而徐荣见曹操虽然兵少，但奋战了一整天才败退，认为酸枣不容易攻破，也率军返回
五月，司空荀爽薨	五月，司空荀爽去世
六月，辛丑，以光禄大夫种拂为司空	六月，辛丑，任命光禄大夫种拂为司空
拂，邵之父也	种拂是种邵的父亲
董卓遣大鸿胪韩融、少府阴、执金吾胡班、将作大匠吴、越骑校尉王安集关东，解譬袁绍等	董卓派大鸿胪韩融、少府阴、执金吾胡毋班、将作大匠吴、越骑校尉王去招抚关东将领，劝说袁绍等人服从朝廷
胡毋班、吴，王至河内，袁绍使王匡悉收击杀之	胡毋班、吴、王走到河内，袁绍命令王匡把他们全都抓起来杀掉
袁术亦杀阴；惟韩融以名德免	袁术也杀死了阴，只有韩融因德高望重，免于一死
王匡屯河阳津，董卓袭击，大破之	王匡驻在河阳津，董卓派军袭击，大破王匡军队
左中郎将蔡邕议：孝和以下庙号称宗者，皆宜省去，以遵先典	左中郎将蔡邕提议：孝和帝以后的皇帝，庙号称宗的，都应该撤去，以遵循传统的典制
从之	献帝同意
春，正月，辛丑，赦天下	春季，正月，辛丑，大赦天下
二月，丁丑，以董卓为大师，位在诸侯王上	二月，丁丑，任命董卓为太师，地位在诸侯王之上
孙坚移屯梁东，为卓将徐荣所败，复收散卒进屯阳人	孙坚率军移驻梁县以东，被董卓部将徐荣打败，他又收集残部进驻阳人
卓遣东郡太过胡轸督步骑五千击之，以吕布为骑督	董卓派遣东郡太守胡轸统率步、骑兵五千人，攻打孙坚，任命吕布为骑督
轸与布不相得，坚出击，大破之，枭其都督华雄	胡轸与吕布不和，孙坚出来迎战，大破胡轸，斩杀他部下的都督华雄
六月，丙戌，地震	六月，丙戌，发生地震
秋，七月，司空种拂免；以光禄大夫济南淳于嘉为司空	秋季，七月，司空种拂被免职，任命光禄大夫、济南人淳于嘉为司空
太尉赵谦罢；以太常马日为太尉	太尉赵谦被免职，任命太常马日为太尉
南单于劫张杨以叛袁绍，屯于黎阳	南匈奴单于於抚罗动持张杨，背叛了袁绍，驻军黎阳
董卓以杨为建义将军、河内太守	董卓任命张杨为建义将军，河内郡太守
春，正月，丁丑，赦天下	春季，正月，丁丑，大赦天下
董卓遣牛辅将兵屯陕，辅分遣校尉北地李、张掖郭汜、武威张济将步骑数万击破朱俊于中牟，因掠陈留、颖川诸县，所过杀虏无遗	董卓派牛辅率军驻在陕县，牛辅分别派遣校尉北地人李、张掖人郭汜、武威人张济率领步、骑兵数万人袭击中牟，大败朱俊，并沿抢掠陈留、颖川两郡所属各县，所过之处，烧杀掳掠，人民几乎死尽
曹操军顿丘，于毒等攻东武阳	曹操驻军顿丘，于毒等进攻东武阳
操引兵西入山，攻毒等本屯	曹操命令军队西行入山，前去攻击于毒等的营寨
诸将皆请救武阳	部下将领全都请求援救东武阳
操曰：使贼闻我西而还，武阳自解也；不还，我能败其本屯，虏不能拔武阳必矣	曹操说：让叛匪听说我们西行，如果他们回来救援，那么东武阳的包围不救自解；如果他们不回来，那么我们能够攻下他们的营寨，而他们肯定不能攻下武阳
遂行	于是率军出发
毒闻之，弃武阳还	于毒听说曹军西行，便放弃东武阳，赶回来援救营寨
操遂击眭固及匈奴於扶罗于内黄，皆大破之	曹操乘势进军内黄，向眭固及南匈奴单于於扶罗发动进攻，大败这两支队伍
五月，以征西将军皇甫嵩为车骑将军	五月，任命征西将军皇甫嵩为车骑将军
吕布自武关奔南阳，袁术待之甚厚	吕布途经武关到南阳投奔袁术，袁术待他十分优厚
布自恃有功于袁氏，恣兵销掠	吕布认为自己杀死了董卓，对袁家有功，因此放纵部下士兵抢掠，袁术对此不满
术患之，布不自安，去从张杨于河内	吕布察觉后，心不自安，便离开袁术，去河内投奔张杨
李等购求布急，布又逃归袁绍	李等人悬赏捉拿吕布，形势很紧，吕布又从张杨处逃走，改投袁绍
丙子，以前将军赵谦为司徒	丙子，任命前将军赵谦为司徒
诏太傅马日、太仆赵岐杖节镇抚关东	献帝下诏，命令太傅马日、太仆赵岐持符节去安抚关东诸州、郡
九月，以李为车骑将军、领司隶校尉、假节；郭汜为后将军，樊稠为右将军，张济为骠骑将军，皆封侯	九月，任命李为车骑将军，兼任司隶桃尉，假节；任命郭汜为后将军，樊稠为右将军，张济为骠骑将军，都封为侯爵
、汜、稠管朝政，济出屯弘农	李、郭汜、樊稠掌管朝政，张济出京，率军驻在弘农郡
司徒赵谦罢	司徒赵谦被免职
甲申，以司空淳于嘉为司徒，光禄大夫杨彪为司空，隶尚书事	甲申，任命司空淳于喜为司徒，光禄大夫杨彪为司空，主持尚书事务
冬，十月，荆州刺史刘表遣使贡献	冬季，十月，荆州刺史刘表派遗使者到长安进献贡品
以表为镇南将军荆州牧，封成武侯	任命刘表为镇南将军、荆州牧，封成武侯
十二月，太尉皇甫嵩免，以光禄大夫周忠为太尉，参录尚书事	十二月，太尉皇甫嵩被免职，任命光禄大夫周忠为太尉，参与主持尚书事务
公孙瓒复遣兵击袁绍，至龙凑，绍击破之	公孙瓒又派遣军队进攻袁绍，到达龙凑，被袁绍军队击败
瓒遂还幽州，不敢复出	公孙瓒于是退回幽州，不敢再出来
春，正月，甲寅朔，日有食之	春季，正月，甲寅朔，出现日食
丁卯，赦天下	丁卯，大赦天下
袁绍与公孙瓒所置青州刺史田楷连战二年，士卒疲困，粮食并尽，互掠百姓；野无青草	袁绍与公孙瓒所委任的青州刺史田楷连续作战两年，军队疲惫不堪，粮食全都吃尽，因抢掠百姓致使田地间连青草都难得见到
绍以其子谭为青州刺史，楷与战，不胜	袁绍任命自己的儿子袁谭为青州刺史，田楷进攻袁谭，未能取胜
会赵岐来和解关东，乃与绍和亲，各引兵去	正好朝廷派赵岐前来调解关东各州、郡的矛盾，公孙瓒于是与袁绍结为儿女亲家，各自率兵退回
三月，袁绍在薄落津	三月，袁绍驻军薄落津
魏郡兵反，与黑山贼于毒等数万人共覆邺城，杀其太守	这时，他属下魏郡的士兵叛变，与黑山军于毒等数万人联合，攻占邺城，杀死魏郡太守
绍还屯斥丘	袁绍率军回到斥丘
夏，曹操还军定陶	夏季，曹操大军回到定陶
六月，扶风大雨雹	六月，扶风郡下了大冰雹
华山崩裂	华山发生山崩
太尉周忠免，以太仆朱俊为太尉，录尚书事	太尉周忠被免职，任命太仆朱俊为太尉，主持尚书事务
大雨，昼夜二十余日，漂没民居	大雨昼夜不停地持续二十余日，淹没了许多百姓的住宅
冬，十月，辛丑，京师地震	冬季，十月，辛丑，京城长安发生地震
有星孛于天市	有异星出现在天市星旁
司空杨彪免	司空杨彪被免职
丙午，以太常赵温为司空，录尚书事	丙午，任命太常赵温为司空，主持尚书事务
十二月，辛丑，地震	十二月，辛丑，发生地震
司空赵温免	司空赵温被免职
乙巳，以卫尉张喜为司空	乙巳，任命卫尉张喜为司空
春，正月，辛酉，赦天下	春季，正月，辛酉，大赦天下
甲子，帝加元服	甲子，献帝举行加冠礼
二月，戊寅，有司奏立长秋宫	二月，戊寅，有关部门奏请献帝选立皇后
诏曰：皇妣宅兆未卜，何忍言后宫之选乎	献帝下诏说：我母亲安葬的地方还未定，怎么忍心谈挑选后妃的事呢
壬午，三公奏改葬皇妣王夫人，追上尊号曰灵怀皇后	壬午，三公上奏，请将献帝的母亲王美人改葬到灵帝之陵，并追加尊号，称灵怀皇后
曹操使司马荀、寿张令程昱守甄城，复往攻陶谦，遂略地至琅邪、东海，所过残减	曹操委派司马荀、寿张县令程昱留守鄄城，自己再次前往徐州进攻陶谦，于是沿途攻掠，直到琅邪、东海，所过之处受到严重破坏
还，击破刘备于郯东	大军返回，又在郯县以东击败刘备的军队
谦恐，欲走归丹阳	陶谦震恐，打算逃回丹阳
会陈留太守张邈叛操迎吕布，操乃引军还	正在这时，陈留太守张邈背叛曹操，迎接吕布入兖州，于是曹操撤军，回救兖州
河西四郡以去凉州治远，隔以河寇，上书求别置州	河西的敦煌、酒泉、张掖、武威四郡，因为距离凉州官府所在地冀县太远，而且交通又被盗寇阻断，因此上书请求另外设置一州
六月，丙子，诏以陈留邯郸商为雍州刺史，典治之	六月，丙子，下诏设置雍州，任命陈留人邯郸商为雍州刺史，治理河西四郡事务
乙酉晦，日有食之	乙酉晦，出现日食
秋，七月，壬子，太尉朱俊免	秋季，七月，壬子，太尉朱俊被免职
戊午，以太常杨彪为太尉，录尚书事	戊午，任命太常杨彪为太尉，主持尚书事务
甲子，以镇南将军杨定为安西将军，开府如三公	甲子，任命镇南将军杨定为安西将军，允许他开府置僚属，待遇与三公相同
八月，冯翊羌寇属县，郭汜、樊稠等率众破之	八月，冯翊地区的羌族人进攻属下各县，郭汜、樊稠率军将其击败
十二月，司徒淳于嘉罢，以卫尉赵温为司徒，录尚书事	十二月，司徒淳于嘉被免职，任命卫尉赵温为司徒，主持尚书事务
春，正月，癸丑，赦天下	春季，正月，癸丑，大赦天下
曹操败吕布于定陶	曹操在定陶击败吕布
诏即拜袁绍为右将军	朝廷下诏派使者到邺城，就地任命袁绍为右将军
夏，四月，甲子，立贵人琅邪伏氏为皇后；以后父侍中完为执金吾	夏季，四月，甲子，献帝立贵人、琅邪人伏氏为皇后，任命皇后的父亲、侍中伏完为执金吾
曹操围雍丘，张邈诣袁术求救，未至，为其下所杀	曹操率军包围雍丘，张邈去见袁术请求救援，他还没有走到，就被自己部下杀死
冬，十月，以曹操为兖州牧	冬季，十月，任命曹操为兖州牧
戊戌，郭汜党夏育、高硕等谋胁乘舆西行	戊戌，郭汜的党羽夏育、高硕等策划劫持献帝西行，先纵火扰乱人心
侍中刘艾见火起不止，请帝出幸一营以避火	侍中刘艾看到火起不息，就请献帝到其他军营中躲避火势
杨定、董承将兵迎天子幸杨奉营，夏育等勒兵欲止乘舆，杨定、杨奉力战，破之，乃得出	杨定、董承率军接献帝到杨奉营，夏育等出兵企图阻拦献帝，杨定、杨奉奋力作战，击败夏育等，献帝才得以逃出
壬寅，行幸华阴	壬寅，献帝抵达华阴
南单于於扶罗死，弟呼厨泉立，居于平阳	南匈奴单于於扶罗去世，他弟弟呼厨泉继位，率部驻在平阳
春，正月，癸酉，大赦，改元	春季，正月，癸酉，大赦天下，改年号为建安元年
董承、张杨欲以天子还雒阳，杨奉、李乐不欲，由是诸将更相贰	董承、张杨打算护送献帝回洛阳，杨奉、李乐不同意，于是将领们进一步相互猜疑
二月，韩暹攻董承，承奔野王	二月，韩暹进攻董承，董承败走，投奔驻在野王的张杨
韩暹屯闻喜，胡才、杨奉之坞乡	韩暹驻军闻喜，胡才、杨奉率军前往坞乡
胡才欲攻韩暹，上使人喻止之	胡才准备进攻韩暹，献帝派人传旨，阻止他进军
汝南、颖川黄巾何仪等拥众附袁术，曹操击破之	汝南、颖川的黄巾军首领何仪等率众投靠袁术，曹操出军击溃何仪等
张杨使董承先缮修雒阳宫	张杨派董承先去修缮被董卓烧毁的洛阳宫殿
太仆赵岐为承说刘表，使遣兵诣雒阳，助修宫室；军资委输，前后不绝	太仆赵岐为董承去说服刘表，使刘表派兵到洛阳，协助修缮宫殿，并源源不断地输送军用物资和粮草
夏，五月，丙寅，帝遣使至杨奉、李乐、韩暹营，求送至雒阳，奉等从诏	夏季，五月，丙寅，献帝派使者到杨奉、李乐、韩暹等人营中，要求他们护送自己返回洛阳，杨奉等听从诏命
六月乙未，车驾幸闻喜	六月，乙未，献帝抵达闻喜
九月，司徒淳于嘉、太尉杨彪、司空张喜皆罢	九月，司徒淳于嘉、太尉杨彪、司空张喜被免职
车驾之东迁也，杨奉自梁欲邀之，不及	曹操护送献帝从洛阳向东迁到许县时，杨奉从梁地出兵想要阻拦，但未来得及
冬，十月，曹操征奉，奉南奔袁太，遂攻其梁屯，拔之	冬季，十月，曹操出兵征讨杨奉，杨奉向南投奔袁术，曹操攻陷了杨奉在梁地的营寨
袁术畏吕布为已害，乃为子求婚，布复许之	袁术害怕吕布危害自己，就为儿子向吕布女儿求婚，吕布答应了
术遣将纪灵等步骑三万攻刘备，备求救于布	袁术派遣部将纪灵等率领步、骑兵三万进攻刘备，刘备向吕布求救
诸将谓布曰：将军常欲杀刘备，今可假手于术	吕布属下的将领们对吕布说：将军一直想杀刘备，这次可以借袁术的手来实现
布曰：不然	吕布说：不然
术若破备，则北连泰山诸将，吾为在术围中，不得不救也	袁术如果击溃刘备，就可以向北联络泰山的诸将领，我就将陷入袁术的包围之中，因此不能不救刘备
便率步骑千余驰往赴之	吕布便率领步、骑兵一千余人急速赶赴刘备处
灵等闻布至，皆敛兵而止	纪灵等听说吕布前来，都收兵回营，停止攻战
布屯沛城西南，遣铃下请灵等，灵等亦请布，布往就之，与备共饮食	吕布驻军沛城西南，派遣侍卫去请纪灵等人，纪灵等也派人来请吕布，吕布就前往纪灵营中，邀请刘备一起赴宴
布谓灵等曰：玄德，布弟也，为诸君所困，故来救之	吕布对纪灵等人说：刘玄德是我的弟弟，被你们围困，所以我来救他
布性不喜合斗，喜解斗耳	我生性不喜欢聚合别人争斗，只喜欢化解别人的争斗
乃令军候植戟于营门，布弯弓顾曰：诸君观布射戟小支，中者当各解兵，不中可留决斗	于是命令军官把铁戟竖立在营门，吕布拉满了弓，对旁观的人说：你们看我射戟头旁边的戟支，如果射中，你们就各自罢兵，如果不中，你们可以留下厮杀
布即一发，正中戟支	吕布随即射了一箭，正中戟支
灵等皆惊，言：将军天威也	纪灵等全都大吃一惊，说：将军真是天赋神威
明日复欢会，然后各罢	第三天，又设酒欢宴，然后各自班师
三月，诏将作大匠孔融持节拜袁绍大将军，兼督冀、青、幽、并四州	三月，献帝下诏，派将作大匠孔融持符节到邺城，任命袁绍为大将军，兼管冀州、青州、幽州、并州四州的军务
夏，五月，蝗	夏季，五月，发生蝗灾
夏，四月，使谒者仆射裴茂，诏关中诸将段煨等讨李，夷其三族	夏季，四月，朝廷派谒者仆射裴茂到关中传达献帝所下诏书，命令段煨等诸将领联合讨伐李
以煨为安南将军，封乡侯	段煨等将李的本族亲属全部诛灭，任命段煨为安南将军，封乡侯
刘表与袁绍深相结约	刘表与袁绍往来密切，交情深厚
治中邓谏表，表曰：内不失贡职，外不背盟主，此天下之达义也	治中邓对他进行劝告，刘表说：我对朝廷不缺进贡，对地方不背盟主，这是天下人都能理解的道理
治中独何怪乎	你为什么偏要见怪呢
乃辞疾而退	于是邓自称有病而辞去职务
以卫将军董承车骑将军	任命卫将军董承为车骑将军
袁绍既克公孙瓒，心益骄，贡御稀简	袁绍消灭公孙瓒后，更加骄横，对朝廷进贡的次数和数量减少
主簿耿包密白绍，宜应天人，称尊号	主簿耿包秘密向袁绍建议，应当应天顺民，即位称帝
绍以包白事示军府	袁绍把耿包的建议告诉军府的官员，官员们一致认为耿包大逆不道，应该斩首
僚属皆言包妖妄，宜诛，绍不得已，杀包以自解	袁绍不得已，杀掉耿包以表白自己无意称帝
汝南黄巾刘辟等叛曹操应袁绍，绍遣刘备将兵助辟，郡县多应之	汝南郡的黄巾军首领刘辟等背叛曹操，响应袁绍，袁绍派遣刘备统兵去援助刘辟，周围的郡、县纷纷起来响应
绍遣使拜阳安都尉李通为征南将军，刘表亦阴招之，通皆拒焉	袁绍派使者委任阳安郡都尉李通为征南将军，刘表也暗中派人来招李通，李通一概拒绝
或劝通从绍，通按剑叱之曰：曹公明哲，必定天下；绍虽强盛，终为之虏耳	有人劝李通与袁绍联络，李通手按剑柄叱责说：曹公明智，必然平定天下；袁绍虽然强盛，终究会败在曹公之手
吾以死不贰	我誓死不二
即斩绍使，送印绶诣操	随即杀死袁绍使者，把袁绍送来的印绶上交给曹操
九月，庚午朔，日有食之	九月，庚午朔，出现日食
曹操出兵与袁绍战，不胜，复还，坚壁	曹操出兵与袁绍交战，没有取胜，又退回营垒，坚守不出
绍为高橹，起土山，射营中，营中皆蒙而行	袁绍军中制造高楼，堆起土山，居高临下地向曹营射箭，曹军在营中行走，都要用盾牌遮挡飞箭
操乃为霹雳车，发石以击绍楼，皆破；绍复为地道攻操，操辄于内为长堑以拒之	曹操制成霹雳车，发射石块，将袁绍的高楼全都击毁
操众少粮尽，士卒疲乏，百姓困于征赋，多叛归绍者	袁绍又挖地道进攻，曹军在营内挖一道长长的深沟，以抵御袁军从地下来攻
操患之，与荀书，议欲还许，以致绍师	曹操兵少粮尽，士兵疲惫不堪，百姓无法交纳沉重的赋税，纷纷背叛而降附袁绍
报曰：绍悉众聚官渡，欲与公决胜败	曹操大为忧虑，给荀写信，说准备用退回许都的办法，引诱袁军深入
公以至弱当至强，若不能制，必为所乘，是天下之大机也	荀回信说：袁绍集中全部军队到官渡，打算与您一决胜负
且绍，布衣之雄耳，能聚人而不能用	您以最弱者抵抗最强者，如果不能制敌，就将为敌所制，这正是夺取天下的重要关键
以公之神武明哲而辅以大顺，何向而不济	而且，袁绍只是布衣中的英雄罢了，能把人才招集在自己身边，却不能任用
今谷食虽少，未若楚、汉在荥阳、成间也	以您的神武明智，加上尊奉天子、名正言顺，有谁能阻拦得住
是时刘、项莫肯先退者，以为先退则势屈也	如今，粮食虽少，但还没有到楚、汉在荥阳、成对峙时的困境
公以十分居一之众，画地而守之，扼其喉而不得进，已半年矣	那时刘邦、项羽谁也不肯先向后撤，是因为先退就会处于劣势
情见势竭，必将有变	您的军队只有袁绍军队的十分之一，但您坚守不动，扼住袁军的咽喉，使袁军无法前进，已长达半年
此用奇之时，不可失也	情势显现，已到终结，必将发生变化，这正是出奇制胜的时机，一定不能放弃
操从之，乃坚壁持之	曹操听从荀的劝告，于是坚守营垒，与袁绍相持
冬，十月，辛亥，有星孛于大梁	冬季，十月，辛亥，有异星出现在大梁星次
曹操闻孙策死，欲因丧伐之	曹操听到孙策的死讯，打算乘孙权等正在办丧事之机，大举讨伐
侍御史张谏曰：乘人之丧，既非古义，若其不克，成雠弃好，不如因而厚之	侍御史张说：乘人办丧事进行讨伐，是不符合古代道义的，如果不能攻克，便化友为敌，不如利用这个机会厚待他
操即表权为讨虏将军，领会稽太守	于是曹操上表推荐孙权担任讨虏将军，兼任会稽郡太守
张鲁以刘璋暗懦，不复承顺，袭别部司马张，杀之而并其众	张鲁认为刘璋懦弱无能，不再服从刘璋的命令，袭击别部司马张，杀死张而吞并了他的队伍
璋怒，杀鲁母及弟，鲁遂据汉中，与璋为敌	刘璋大怒，杀死张鲁的母亲和弟弟，于是张鲁占据汉中地区，与刘璋为敌
璋遣中郎将庞羲击之，不克	刘璋派中郎将庞羲进攻张鲁，未能取胜
璋以羲为巴郡太守，屯阆中以御鲁	刘璋委任庞羲为巴郡太守，驻守阆中，抵抗张鲁
羲辄召汉昌民为兵，或构羲于璋，璋疑之	庞羲未请示刘璋，就召集汉昌的人为兵，有人向刘璋诬告庞羲图谋不轨，刘璋起疑
赵韪数谏不从，亦恚恨	赵韪屡次劝告刘璋，刘璋不加理睬，赵韪也怀恨在心
春，三月，丁卯朔，日有食之	春季，三月，丁卯，出现日食
曹操遣夏侯渊、张辽围昌于东海，数月，粮尽，议引军还	曹操派遣夏侯渊、张辽率军在东海围攻昌，数月未能攻下，曹军粮草已尽，将领们商议撤军
辽谓渊曰：数日已来，每行诸围，辄属目视辽，又其射矢更稀；此必计犹豫，故不力战	张辽对夏侯渊说：几天以来，我每次巡视阵地，昌的目光总追随着我，而且他们的箭也比以前射得更少
辽欲挑与语，傥可诱也	这必定是昌心中犹豫，所以未尽全力作战
乃使谓曰：公有命，使辽传之	我准备引动他交谈，或许能诱使他归降
果下与辽语	于是，张辽派人对昌说：曹公有命令，让张辽传达给你
辽为说操神武，方以德怀四方，先附者受大赏	昌果然下城与张辽交谈
乃许降	张辽向他盛赞曹操的谋略武功，说曹操正广施恩德，招纳四方豪杰，先归附的可受到重赏
辽遂单身上三公山，入家，拜妻子	昌便答应投降
欢喜，随辽诣操；操遣还	张辽就孤身一人上三公山，到昌家中，会见他的妻子，昌十分高兴，随张辽一起去拜见曹操，曹操命昌返回原处
赵韪围刘璋于成都	赵韪率军在成都包围刘璋，东州人恐怕受到屠杀，都拼死作战，杀退赵韪，并追击到江州将他杀死
东州人恐见诛灭，相与力战，韪遂败退，追至江州，杀之	庞羲听说赵韪被杀，心中恐惧，派属官程祁传达命令给他父亲汉昌县令程畿，征调人队伍
庞羲惧，遣吏程祁宣旨于其父汉昌令畿，索兵	程畿说：郡里召集队伍，本不是为了叛乱，纵然有人进谗言加以陷害，也只能对上表白我们的忠诚，如果因此而怀有异心，则我不敢遵从命令
畿曰：郡合部曲，本不为乱，纵有谗谀，要在尽诚，若遂怀异志，不敢闻命	庞羲又派程祁去劝说程畿，程畿说：我受到刘州牧的大恩，应当为他尽节；而你身为郡的官员，自当为庞太守效力
羲更使祁说之，畿曰：我受牧恩，当为尽节，汝为郡吏，自宜效力	不义的事情，我宁死也不会去做
不义之事，有死不为	庞羲大怒，派人对程畿说：如果你不服从太守，将给你全家带来灾祸
羲怒，使人谓畿曰：不从太守，祸将及家	程畿说：乐羊吃下他儿子的肉，并不是没有父子间的恩情
畿曰：乐羊食子，非无父子之恩，大义然也	而是为了维护君臣大义
今虽羹祁以赐畿，畿啜之矣	如今，即使庞太守把程祁煮成肉羹来赐给我，我也会吃下去
羲乃厚谢于璋	庞羲无奈，便送上重礼，向刘璋道歉
璋擢畿为江阳太守	刘璋提拨程畿担任江阳郡太守
袁尚亲自统帅大军进攻袁谭，袁谭大败，逃到平原，据城固守	孙权西伐黄祖，破其舟军，惟城未克，而山寇复动
袁尚将城围住，发动猛攻	权还，过豫章，使征虏中郎将吕范平鄱阳、会稽，荡寇中郎将程普讨乐安，建昌都尉太史慈领海昏，以别部司马黄盖、韩当、周泰、吕蒙等守剧县令长，讨山越，悉平之
袁谭派辛评的弟弟辛毗到曹操那里求救	建安、汉兴、南平民作乱，聚众各万余人，权使南部都尉会稽贺齐进讨，皆平之，复立县邑，料出兵万人；拜齐平东校尉
冬季，十月，有异星出现在东井星旁	高干以并州降，操复以干为并州刺史
八月，曹操向东讨伐海上的盗贼管承，进军到淳于，派大将乐进、李典击败管承，管承逃到海岛上	昌复叛，操遣于禁讨斩之
昌又背叛曹操，曹操派于禁讨伐，斩杀昌	是岁，立故琅邪王容子熙为琅邪王，齐、北海、阜陵、下邳、常山、甘陵、济阴、平原八国皆除
冬季，十月，辛卯，有异星出现在鹑尾星次	乙巳，黄巾杀济南王
乙巳，黄巾军杀死济南王刘	十一月，曹操至易水，乌桓单于代郡普富卢、上郡那楼皆来贺
十一月，曹操到达易水，乌桓代郡部落单于普富卢、上郡部落单于那楼都来向曹操祝贺	是岁，孙权西击共祖，虏其人民而还
这一年，孙权向西攻击黄祖，俘虏百姓后返回吴郡	权母吴氏疾笃，引见张昭等，属以后事而卒
起初，琅邪人诸葛亮寄居襄阳隆中，经常把自己比作管仲和乐毅；但当时人并不认可，只有颍川人徐庶与崔州平认为确是如此	春，正月，司徒赵温辟曹操子丕
崔州平是崔烈的儿子	操表温辟臣子弟，选举故不以实；策免之
曹操派张辽驻守长社，临出发时，军中有人造反，乘夜在营中放火，全军都惊恐不定	初，前将军马腾与镇西将军韩遂结为异姓兄弟，后以部曲相侵，更为雠敌
张辽对左右说：不要乱动	朝廷使司隶校尉锺繇、凉州刺史韦端和解之，徵腾入屯槐里
这不是全营的人都想造反，只是少数叛乱分子制造混乱，想扰乱军心	曹操将征荆州，使张既说腾，令释部曲还朝，腾许之
就下令说：凡没有参与叛乱的，都坐在那里不动	已而更犹豫，既恐其为变，乃移诸县促储，二千石郊迎，腾不得已，发东
张辽率领数十名亲兵在营的中央站定，过了一会，全军都安定下来，随即捉到主谋的人，将他们处死	操表腾为卫尉，以其子超为偏将军，统其众，悉徒其家属诣邺
秋季，七月，曹操出军南征刘表	八月，丁未，汉光禄勋山阳郗虑为御史大夫
秋季，七月，曹操统率水军自涡水进入淮河，在肥水登岸，驻屯合肥，重新修整芍陂的水利设施，在周围地区屯田	冬，十月，荆州地震
冬季，十月，荆州地区发生地震	十二月，操军还谯
十二月，曹操的军队返回谯县	庐江人陈兰、梅成据、六叛，操遣荡寇将军张辽讨斩之；因使辽与乐进、李典等将七千余人屯合肥
二月，乙巳朔，出现日食	冬，曹操作铜爵台于邺
夏季，五月，癸未，诛杀卫尉马腾，并把他的三族一齐处死	六月，庚寅晦，日有食之
六月，庚寅晦，出现日食	秋，七月，螟
秋季，七月，发生螟灾	马超等余众屯蓝田，夏侯渊击平之
马超等人的残余部众驻守蓝田，夏侯渊率军讨伐，全部平定	九月，庚戌，立皇子熙为济阴王，懿为山阳王，邈为济北王，敦为东海王
庚寅，献帝下诏，把全国的十四个州合并，恢复为九个州	夏，四月，曹操至邺
秋季，七月，魏国开始建立祭祀土神与谷神的社稷坛和曹氏祖先的宗庙	魏公操纳三女为贵人
春季，二月，魏公曹操回到邺城	夏，五月，进魏公操爵为王
夏季，五月，进封魏公曹操为王	五月，已亥朔，日有食之
代郡乌桓的三个首领都称单于，依仗实力，态度骄横，恣意妄行，以往的太守对他们无可奈何	初，南匈奴久居塞内，与编户大同而不输贡赋
魏王曹操任命丞相仓曹属裴潜为太守，准备给他一支精干的部队	议者恐其户口滋蔓，浸难禁制，宜豫为之防
裴潜说：单于自己也知道放纵横行的时间很长了，现在多带兵去，他们必会感到恐惧而拒绝我们入境；少带，他们则不怕，因此应当用计谋去解决问题	秋，七月，南单于呼厨泉入朝于魏，魏王操因留之于邺，使右贤王去卑监其国
于是，裴潜只驾单车到郡，单于们又惊又喜	单于岁给绵、绢、钱、谷如列侯，子孙传袭其号
裴潜恩威并加，进行安抚，单于们慑服	分其众为五部，各立其贵人为帅，选汉人为司马以监督之
八月，魏任命大理钟繇作相国	冬，十月，魏王操治兵击孙权；十一月，至谯
冬季，十月，魏王曹操练兵准备向孙权进攻；十一月，到达谯郡	春，正月，魏王操军居巢，孙权保濡须，二月，操进攻之
夏季，四月，献帝下诏：魏王曹操可用皇帝专用的旌旗，出入同帝王一样称警跸，实行戒严和清道	六月，魏以军师华歆为御史大夫
六月，魏任命军师华歆为御史大史	冬，十月，命魏王操冕十有二旒，乘金根车，驾六马，设五时副车
冬季，十月，献帝下诏增加魏王曹操的特权：魏王曹操所戴王冠可有十二条旒，可乘金根车，以六匹马驾驶，可设五时副车	魏以五官中郎将丕为太子
魏王曹操派丞相长史王必掌管军队，督理许都的事务	春，正月，吉邈等率其党千余人，夜攻王必，烧其门，射必中肩，帐下督扶必奔南城
当时关羽实力强盛，京兆人金见汉朝政权将被取代，便和少府耿纪、司直韦晃、太医令吉本、吉本的儿子吉邈、吉邈的弟弟吉穆等人密谋杀掉王必，挟持天子打击曹魏的势力，并在南面联合关羽作为外援	会天明，邈等众溃，必与颍川典农中郎将严匡共讨斩之
改年号为延康	二月，丁未朔，日有食之
二月，丁未朔，出现日食	壬戍，以太中大夫贾诩为太尉，御只大夫华歆为相国，大理王朗为御史大夫
壬戌，任命太中大夫贾诩为太尉，御史大夫华歆为相国，大理王朗为御史大夫	丁卯，葬武王于高陵
尚书陈群认为，汉朝任用的官员，并没有把人才都选举出来，于是设立九口官人的制度：在州和郡都设置中正的职位，以确定应该选用哪些人；中正由各州、郡正贤德、能够鉴别人才的人担任，由他们鉴别人物品行、能力，分出高低不同等级	夏，五月，戊寅，汉帝追尊王祖太尉曰太王，夫人丁氏曰太王后
六月瘐午，魏王曹丕率烟南下巡查	秋七月，孙权遣使奉献
秋季，七月，孙权派使者至汉朝廷奉献贡物	蜀将军孟达屯上庸，与副军中郎将刘封不协；封侵陵之，达率部曲四千余家来降
	达有容止才观，王甚器爱这，引与同辇，以达为散骑常侍、建武将军，封平亭侯，合房陵、上庸、西城三郡为新城，以达领新城太守，委以西
武都氐族酋长杨仆率部落依附汉朝廷	甲午，王次天谯，大飨六军及谯父老于邑东，设伎乐百戏，吏民上寿，日夕而罢
左中郎将李伏、太史丞许芝向曹丕上书说：魏应该取代汉，经过占验河图和纬书，很多事例都证明了这一点	十二月，初营洛阳宫
大臣们因此都上表，劝魏王曹丕遵从上天的意志，顺应官员和百姓的愿望，取代汉朝，登基答帝，曹丕不同意	戊午，帝如洛阳
文帝要迁徙冀州籍士兵的家属十万户，充实河南郡	春，正月，以议即孔羡为宗圣侯，奉孔子祀
当时，天大旱，又	
春季，正月，封议郎孔羡为宗圣侯，奉侍祭祀孔子	三月，加辽示太守公孙恭车骑将军
三月，加封辽东太守公孙恭为车骑将军	初复五铢钱
魏文帝的弟弟鄢陵侯曹彰、宛侯曹据、鲁阳侯曹宇、谯侯曹林、赞侯曹衮、襄邑侯曹峻、弘农侯曹、寿春侯曹彪、历城侯曹微、平舆侯曹茂都进爵为公；改封安乡侯曹植为鄄城侯	筑陵云台
]春季，正月，丙寅朔，出现日食	庚午，帝行如许昌
癸亥，文帝回到许昌	五月，以江南八郡为荆州，江北诸郡为郢州
庚申晦，出现日食	吴王使太中大夫郑泉聘汉，汉太中大夫宗玮报之，吴、汉复通
汉王听说魏大举攻吴，写信给陆逊说：曹军现抵达长江、汉水一带，我将再度率军东下，将军认为我能否这样做	汉汉嘉太守黄元叛
陆逊回信说：只恐怕贵军新	
蜀汉汉嘉太守黄元反叛	吴将孙盛督万人据江陵中洲，以为南郡外援
吴将孙盛率兵一万从占据江陵中洲，作为外围协助保卫南郡	春，正月，曹真使张击破吴兵，遂夺据江陵中洲
春季，正月，曹真派张击溃吴军一部，攻占江陵的中洲	二月，诸葛亮至永安
六月，甲戌，任城威王曹彰去世	甲申，魏寿肃侯贾诩卒
甲申，魏寿肃侯贾诩去世	大水
发生水灾	吴贺齐袭蕲春，虏太守晋宗以归
同年，蜀汉后主立妃子张氏为皇后	春，二月，帝自许昌还洛阳
自汉献帝初平年以来，教育制度废弛	吴王使辅议中郎将吴郡张温聘于汉，自是吴、蜀信使不绝
夏季，四月，开始建立太学，设博士的职务，依照汉朝制度，采取以《五经》考试的办法	时事所宜，吴主常令陆逊语诸葛亮；又刻印置逊所，王每与汉主及诸葛亮书，常过示逊，轻重、可否有所不安，每令改定，以印封之
冬季，十月，魏文帝回到许昌	十一月，戊申晦，日有食之
十一月，东武阳王曹鉴去世	十二月，吴番阳贼彭绮攻没郡县，众数万人
春季，正月，壬子，魏文帝返回洛阳，对蒋济说：对事情不能不弄清楚	汉丞相亮欲出军汉中，前将军李严当知后事，移屯江州，留护军陈到驻永安，而统属于严
我先前决定将一半船只毁在山阳湖中，幸亏你设法将船只解救	
太子曹睿即帝位，尊皇太后卞氏为太皇太后，养母郭皇后为皇太后	癸未，追谥甄夫人曰文昭皇后
癸未，曹睿追谥生母甄夫人谥号为文昭皇后	壬辰，立皇弟蕤为阳平王
壬辰，立弟弟曹蕤为阳平王	六月，戊寅，葬文帝于首阳陵
吴地丹阳、吴、会三郡山民再度叛乱，攻克三郡的属县	冬，十月，清柯王卒
吴王以三	
甲申，开始在洛阳营建宗庙	六月，以司马懿都督荆、豫州诸军事，率所领镇宛
起初，征西将军夏侯渊的儿子夏侯和太祖的女儿清河公主结了婚，文帝年少时和他亲近友好，等到继子帝位，便任命他为安西将军，都督关中，镇守长安，让他承接夏侯渊的防区	夏，四月，丁酉，帝还洛阳
护乌桓校尉田豫进攻鲜卑人郁筑，郁筑的岳父轲比能前来相救，用三万骑兵把田豫围困在马城上谷太守阎志是阎柔的弟弟，素来为鲜卑人所信赖，前去解释劝导，轲比能才解围而去	冬，十一月，兰陵成侯王朗卒
元城哀王曹礼去世	六月，癸卯，繁阳王穆卒
六月，癸卯，繁阳王曹穆去世	戊申，追尊高祖大长秋曰高皇帝，夫人吴氏曰高皇后
十一月，洛阳皇家宗庙建成，从邺城迎来高帝、太帝、武帝、文帝四位先祖的灵位供奉	十二月，雍丘王植徙封东阿
十二月，雍丘王曹植被迁徙，封于东阿	汉丞相帝徙府营于南山下原上，筑汉城于沔阳，筑东城于成固
三月，邵陵元侯曹真去世	自十月不雨，至于是月
十一月，戊戌晦，出现日食	十二月，戊午，博平敬侯华歆卒
十二月，戊午，博平敬侯华歆去世	丁卯，吴大赦，改明年元曰嘉禾
吴王派遣将军周贺、校尉裴潜乘船渡海到辽东，向公孙渊求购马匹	夏，四月，壬寅，帝如许昌
夏季，四月，壬寅，明帝到达许昌	五月，皇子殷卒
五月，皇子曹殷去世	秋，七月，以卫尉董昭为司徒
秋季，七月，明帝提升卫尉董昭为司徒	九月，帝行如摩陂，治许昌宫，起景福、承光殿
十一月，庚寅，陈思王曹植去世	十二月，帝还许昌宫
夏季，五月，戊寅，北海王曹蕤去世	闰月，庚寅朔，日有食之
闰五月，庚寅朔，出现日食	六月，洛阳宫鞠室灾
三月，庚寅，山阳公刘协去世，魏明帝身穿素服发丧	已酉，大赦
已酉，大赦天下	夏，四月，大疫
夏季，四月，流行瘟疫	崇华殿灾
八月，壬申，在禅陵为汉献帝下葬	辛巳，帝还许昌
三月，庚寅，安葬皇太后郭氏	夏，四月，汉主以蒋琬为大将军、录尚书事；费代琬为尚书令
十一月，丁酉，明帝前往许昌	是岁，幽州刺史王雄使勇士韩龙刺杀鲜卑轲比能；自是种落离散，互相侵伐，强者远遁，弱者请服，边陲遂安
夏季，四月，汉后主到达湔氐道，登上观阪，观看汶水水道，停留十日返回	武都氐苻健请降于汉；其弟不从，将四百户来降
武都郡氐族人苻健向蜀汉请降，其弟不跟从，率四百户来降魏	五月，乙卯，乐平定侯董昭卒
五月，乙卯，乐平定侯董昭去世	冬，十月，己卯，帝还洛阳宫
五月，己巳，明帝返回洛阳	己丑，大赦
己丑，魏大赦天下	六月，戊申，京都地震
六月，戊申，魏京都发生地震	己亥，以尚书令陈矫为司徒，左仆射卫臻为司空
己亥，明帝任命尚书令陈矫担任司徒，左仆射卫臻担任司空	有司奏以武皇帝为魏太祖，文皇帝为魏太祖，帝为魏烈祖；三祖之庙，万世不毁
主管官吏奏请以武皇帝曹操为魏太祖，文皇帝曹丕为魏高祖，明帝曹睿为魏烈祖；三祖的祭庙，万世不能毁坏	秋，七月，丁卯，东乡贞公陈矫卒
蜀国张皇后去世	九月，冀、兖、徐、豫大水
吴国铸造可当一千的大钱	夏，四月，庚子，南乡恭侯韩暨卒
夏季，四月，庚子，南乡恭侯韩暨去世	庚戍，大赦
九月，吴改年号为赤乌	吴步夫人卒
冬季，十一月，壬午，魏任命司空卫臻担任司徒，司隶校尉崔林担任司空	十二月，汉蒋琬出屯汉中
十二月，蜀蒋琬出兵驻扎在汉中	乙丑，帝不豫
乙丑，魏明帝患病	辛巳，立郭夫人为皇后
三月，任命征东将军满宠担任太尉	夏，四月，吴督军使者羊击辽东守将，俘人民而去
秋季，七月，魏帝开始亲临朝政	八月，大赦
十二月，魏帝下诏恢复以建寅之月为正月	春，旱
春季，正月，蜀国姜维率领偏师从汉中回到涪县驻防	吴主立其子和为太子，大赦
春季，正月，魏帝行加冠礼	吴诸葛恪袭六安，掩其人民而去
五月，朔，出现日食，为日全食	冬，十月，汉蒋琬自汉中还住涪，疾益甚，以汉中太守王平为前监军、镇北大将军，督汉中
冬季，十月，蜀国蒋琬从汉中返回涪县居住，病情更加严重，任命汉中太守王平担任前监军、镇北大将军，督领汉中	十一月，汉主以尚书令费为大将军、录尚书事
十一月，汉后主任命尚书令费担任大将军、录尚书事	吴丞相顾雍卒
秋季，八月，秦王曹询去世	冬，十二月，安阳孝侯崔林卒
冬季，十二月，安阳孝侯崔林去世	是岁，汉大司马琬以病固让州职于大将军，汉主乃以为益州刺史，以侍中董允守尚书令，为之副
春季，正月，任命票骑将军赵俨担任司空	吴太子和与鲁王同宫，礼秩如一，群臣多以为言，吴主乃命分宫别僚；二子由是有隙
夏季，六月，都乡穆侯赵俨去世	秋，七月，吴将军马茂谋杀吴主及大臣以应魏，事泄，并党与皆伏诛
秋季，七月，吴国将军马茂图谋杀害吴王及大臣以降魏，事情泄漏，马茂和他的党羽都被诛杀	八月，以太常高柔为司空
八月，任命太常高柔担任司空	汉甘太后殂
蜀甘太后去世	吴主遣校尉陈勋将屯田及作士三万人凿句容中道，自小其至云阳西城，通会市，作邸阁
吴王派遣校尉陈勋统率屯田部队及工匠三万人，开凿句容山道，从小其直到云阳西城，开通集市，以会商旅，并修建了存储粮物的邸阁	冬，十一月，汉大司马琬卒
冬季，十一月，蜀大司马蒋琬去世	十二月，汉费至汉中，行围守
十二月，蜀费抵达汉中，巡视戍边军队	汉尚书令董允卒；以尚书吕为尚书令
蜀尚书令董允去世，任命尚书吕担任尚书令	春，二月，吴车骑将军朱然寇中，杀略数千人而去
春季，正月，吴国的全琮去世	二月，日有食之
魏帝喜好宠幸亲近一群小人，在后园游乐饮宴	吴主大发众集建业，扬声欲入寇，扬州刺史诸葛诞使安丰太守王基策之，基曰：今陆逊等已死，孙权年老，内无贤嗣，中无谋主
秋季，七月，尚书何晏上疏说：从今以后皇帝到式乾殿或者到后园游乐时，应该都有大臣跟随，以便询问商量政事，讲解讨论经书大义，并为世世代代所效法	权自出则惧内衅卒起，痈疽发溃；遣将则旧将已尽，新将未信
冬季，十二月，散骑常侍、谏议大夫孔义又上疏说：如今天下已经太平，陛下可以不必再到后园学习骑术，外出一定要乘坐辇车，这是天下之福，也是臣子的愿望	此不过欲补支党，还自保护耳
魏帝都没有听从他们的意见	已而吴果不出
秋季，九月，任命车骑将军王为司空	涪陵夷反，汉车骑将军邓芝讨平之
丙午，实行大赦	丁未，以太傅懿为丞相，加九锡；懿固辞不受
当初，会稽郡的潘夫人受到呈王的宠幸，生下少子孙亮，吴王十分喜爱他	冬，十月，庐江太守文钦伪叛，以诱吴偏将军朱异，欲使异自将兵迎己
全公主既已与太子孙和有矛盾，就想预先奉承结交孙亮，于是常常称赞孙亮之美，并把她丈夫之侄全尚的女儿嫁与孙亮为妻	异知其诈，表吴主，以为钦不可迎
吴王因鲁王孙霸结交朋党来陷害自己的兄长，所以心中十分厌恶他，就对侍中孙峻说：子弟之间不和睦，臣下就会分党分派，这样就将出现像袁绍兄弟那样的失败，而被天下之人耻笑	吴主曰：方今北土未一，钦欲归命，宜且迎之
假若只立一人的话，怎能不乱呢	若嫌其有谲者，但当设计网以罗之，盛重兵以防之耳
从此就有了废孙和立孙亮的意思，但在数年间仍然未拿定主意	乃遣偏将军吕据督二万人与异并力至北界，钦果不降
孙峻是孙静的曾孙	异，桓之子；据，范之子也
十一月，大利景侯孙礼去世	吴主立子亮为太子
吴王立其子孙亮为太子	吴主遣军十万作堂邑涂塘以淹北道
吴王派遣十万大军进驻堂邑、涂塘二县，以占领通往北部的道路	十二月，甲辰，东海定王霖卒
蜀汉的姜维再次进犯西平，未能获胜	春，正月，王基、州泰击吴兵，皆破之，降者数千口
春季，正月，王基、州泰进击吴国军队，都获得胜利，投降者有数千人	三月，以尚书令司马孚为司空
三月，任命尚书令司马孚为司空	夏，四月，甲申，以王昶为征南大将军
夏季，四月，甲申，任命王昶为征南大将军	壬辰，大赦
秋季，七月，壬戌，魏国皇后甄氏去世	辛未，以司马孚为太尉
这一年，蜀汉的尚书令吕又去世，任命侍中陈祗为尚书令	春，正月，癸卯，以司马师为大将军
春季，正月，癸卯，任命司马师为大将军	吴主立故太子和为南阳王，使居长沙；仲姬子奋为齐王，居武昌；王夫人子休为琅邪王，居虎林
当初，吴大帝孙权建筑东兴堤用以遏止巢湖之水外流，后来进攻淮南，战败，就把巢湖用来停泊船只，于是废弃大堤不再修筑	初，汉姜维寇西平，获中郎将郭循，汉人以为左将军
冬季，十月，太傅诸葛恪会集众人于东兴，重新建筑大堤，连结左右两座山，山上建筑了两座城，各留千人把守，派将军全端守西城，都尉留略守东城，然后率军返回	循欲刺汉主，不得亲近，每因上寿，且拜且前，为左右所遏，事辄不果
辛亥，实行大赦	三月，废皇后张氏；夏，四月，立皇后王氏，奉车都尉夔之之女也
三月，魏国废掉皇后张氏；夏季，四月，立皇后王氏	狄道长李简密书请降于汉
王皇后是奉车都尉王夔之的女儿	六月，姜维寇陇西
吴国丞相孙峻率领骠骑将军吕据、左将军会稽人留赞袭击寿春，司马师命令各部队都加固加高营垒坚守不出，以等待东部军队的到来	舞阳忠武侯司马师疾笃，还许昌，留中郎将参军事贾充监诸军事
各位将领请求进军攻打项县，司马师说：诸位只知其一，不知其二	充，逵之子也
淮南的将士们本来没有反叛之心，丘俭、文钦说服劝诱他们共同反叛，说是无论远近必然群起响应；而他们起事之后，不仅淮北地区不响应，而且史据李续也都前后投降	卫将军昭自洛阳往省师，师令昭总统诸军
内部离心，外部背叛，他们自知必败无疑	辛亥，师卒于许昌
被困的野兽想着拼斗，如果速战就更符合他们的心意，虽然我们一定能胜，但伤亡也必然惨重	中书侍郎钟会从师典知密事，中诏敕尚书傅嘏，以东南新定，权留卫将军昭屯许昌为内外之援，令嘏率诸军还
况且丘俭等人诳骗自己的将士，诡计多端，变化无常，我们只要稍微多与他们持久对峙一些时日，其诈伪之情自然会显露出来，这是不战而胜的战术	会与嘏谋，使嘏表上，辄与昭俱发，还到洛水南屯住
于是派遣诸葛诞督领豫州各军从安风向寿春推进；派遣征东将军胡遵督领青州、徐州各军进驻谯郡、睢阳之间，以绝断叛军退路；司马师自己率军驻扎在汝阳	二月，丁巳，诏以司马昭为大将军、录尚书事
丘俭、文钦进不能战，退又恐怕寿春受到袭击，无计可施不知应该怎么办；淮南将士们的家都在北方，此时众心沮丧涣散，投降者接连不断，只有淮南地区新依附的农民能受他们驱使	会由是常有自矜之色，嘏戒之曰：子志大其量，而勋业难为也，可不慎哉
吴国的孙峻听到诸葛诞已经占据了寿春，就领兵返回	三月，立皇后卞氏，大赦
任命文钦为都护、镇北大将军和幽州牧	后，武宣皇后弟秉之曾孙女也
春季，正月，蜀汉姜维升任为大将军	二月，丙辰，帝宴群臣于太极东堂，与诸儒论夏少康、汉高祖优劣，以少康为优
二月，丙辰，魏帝在太极东堂宴请群臣，与各位儒生讨论夏少康和汉高祖的优劣，魏帝认为少康优于汉高祖	夏，四月，赐大将军昭衮冕之服，赤舄副焉
司马昭攻克寿春，钟会出谋划策很多；因此，司马昭对他日益亲近重视，委任他办理机密要事，当时人把他比之为汉代的张良	汉姜维闻诸葛诞死，复还成都，复拜大将军
蜀汉的姜维听到诸葛诞已死，又返回成都，重新担任大将军之职	夏，五月，诏以司马昭为相国，封晋公，食邑八郡，加九锡；昭前后九让，乃止
夏季，五月，诏令任命司马昭为相国，封为晋公，食邑八个郡，加赐九锡；司马昭先后推辞了九次，才收回成命	秋，七月，吴主封故齐王奋为章安侯
秋季，七月，吴王封以前的齐王孙奋为章安侯	八月，以骠骑将军王昶为司空
冬季，十一月，车骑将军孙壹被奴婢所杀	是岁，以王基为征南将军，都督荆州诸军事
这一年，任命王基为征南将军，都督荆州诸军事	春，正月，朔，日有食之
春季，正月朔，发生日食	夏，四月，诏有司率遵前命，复进大将军昭位相国，封晋公，加九锡
辛卯，各位公侯向太后奏明，从今日起太后下达的命令文书都称为诏	癸卯，司马昭固让相国、晋公、九锡之命，太后诏许之
癸卯，司马昭坚决推辞封锡相国、晋公、九锡的命令，太后下诏同意	戊申，昭上言：成济兄弟大逆不道，夷其族
丙辰，诏令晋升司马昭的爵位、九锡如前所命，司马昭坚决推辞，于是作罢	癸亥，以尚书右仆射王观为司空
冬季，十月，阳乡肃侯王观去世	十一月，诏尊燕王，待以殊礼
十一月，诏令尊崇燕王曹宇，并待以特殊的礼遇	十二月，甲午，以司隶校尉王祥为司空
冬季，十月，汉后主任命董厥为辅国大将军，诸葛瞻为都护、卫将军，共同管理尚书事，又任命侍中樊建为尚书令	是岁，鲜卑索头部大人拓跋力微始遣其子沙漠汗入贡，因留为质
当时宦官中常侍黄皓当政，董厥、诸葛瞻都不能纠正他的错误行事，士大夫们也都依附于他，只有樊建不与黄皓往来	力微之先，世居北荒，不交南夏
秘书令正多年在宫内任职，与黄皓的房屋相邻，周旋共处三十余年，淡然自守，每日以读书为乐，既不被黄皓所喜爱，也不被黄皓所憎恶，因此官职不过六百石，但也没遭受祸患	至可汗毛，始强大，统国三十六，大姓九十九；后五世至可汗推寅，南迁大泽；又七世至可汗邻，使其兄弟七人及族人乙旃氏、车氏分统部众为十族，邻老，以位授其子诘汾，使南迁，遂居匈奴故地
汉后主的弟弟甘陵王刘永憎恶黄皓，黄皓就在汉后主面前诋毁他，使他十年都不得朝见	诘汾卒，力微立，复徙居定襄之盛乐，部众浸盛，诸部皆畏服之
吴王任命濮阳兴为丞相，廷尉丁密、光禄勋孟宗为左右御史大夫	谯郡嵇康，文辞壮丽，好言老、庄而尚奇任侠，与陈留阮籍、籍兄子咸、河内山涛、河南向秀、琅邪王戎、沛国刘伶特相友善，号竹林七贤
当初，濮阳兴任会稽太守，吴王居住在会稽，濮阳兴对他很好，左将军张布曾任会稽王的左右督将，因此吴王即位之后，濮阳兴和张布二人受到尊崇而执掌朝政；张布主管朝内官署，濮阳兴主管军国之事，二人在里里外外阿谀欺蒙，吴国人很失望	皆崇尚虚无，轻蔑礼法，纵酒昏酣，遗落世事
谯郡人嵇康，文章写得雄壮清丽，喜好谈论《老子》、《庄子》，高节奇行，行侠仗义	司马昭患姜维数为寇，官骑路遗求为刺客入蜀，从事中郎荀勖曰：明公为天下宰，宜杖正义以伐违贰，而以刺客除贼，非所以刑于四海也
他与陈留人阮籍、阮籍的侄子阮咸、河内人山涛、河南人向秀、琅邪人王戎、沛国人刘伶是至交好友，号称竹林七贤	昭善之
他们都崇尚虚无之论，轻蔑礼仪法度，每日以纵情饮酒为乐，不问世事	勖，爽之曾孙也
诏令因征蜀的各位将领捷报频传，再次命大将军司马昭晋位，所赐爵位一切都与前面的诏令相同，司马昭终于接受了任命	癸卯，立皇后卞氏，昭烈将军秉之孙也
十二月，庚戌，任命司徒郑冲为太保	壬子，分益州为梁州
壬子，从益州中分出部分土地设置梁州	癸丑，特赦益州士民，复除租税之半五年
癸丑，特赦益州士人百姓，又下令在五年之内免除一半租税	乙卯，以邓艾为太尉，增邑二万户；钟会为司徒，增邑万户
乙卯，任命邓艾为太尉，增加食邑两万户；任命钟会为司徒，增加食邑一万户	皇太后郭氏殂
二月，丙辰，魏帝车驾返回洛阳	庚申，葬明元皇后
刘禅的全家迁居洛阳，临行时十分纷乱仓猝，刘禅的大臣没有随行的人，只有秘书令正和殿中督汝南人张通舍弃妻儿老小单身随刘禅而行，刘禅仰仗正的导引帮助，才使自己的言谈举止合乎礼仪而无所缺误，于是他慨然长叹，恨自己了解正之晚	夏，四月，新附督王稚浮海入吴句章，略其长吏及男女二百余口而还
夏季，四月，新附督王稚从海路进入吴国的句章，抢掠了那里的官吏及男女百姓二百余人而还	五月，庚申，晋王奏复五等爵，封骑督以上六百余人
五月，庚申，晋王上奏恢复五等爵位，封了骑督以上六百余人的爵位	甲戌，改元
甲戌，改年号为咸熙	癸未，追命舞阳文宣侯懿为晋宣王，忠武侯师为景王
晋王上奏让司空荀制定礼仪，中护军贾充订正法律，尚书付射裴秀议论官制，太保郑冲总揽其事加以裁定	吴分交州置广州
夏季，四月，吴国改年号为甘露	五月，魏帝加文王殊礼，进五妃曰后；世之曰太子
五月，魏元帝施与晋文王特殊的礼遇，晋升王妃为王后，世子改称为太子	癸未，大赦
癸未，大赦天下	秋，七月，吴主逼杀景皇后，迁景帝四子于吴；寻又杀其长者二人
秋季，七月，吴主逼杀吴帝皇后，把景帝的四个儿子迁到吴，不久，又把四人中两个年龄大的杀了	八月，辛卯，文王卒，太子嗣为相国、晋王
八月，辛卯，晋文王司马昭去世，太子司马炎继位，做了相国、晋王	九月，乙未，大赦
九月，乙未，大赦天下	戊子，以魏司徒何曾为晋丞相；癸亥，以标骑将军司马望为司徒
戊子，任命魏司马何曾为晋丞相	乙亥，葬文王于崇阳陵
癸亥，任命票骑将军司马望为司徒.	
当初，汉征西将军司马钧生下豫章太守司马量，司马量生下颍川太守司马，司马生下京兆尹司马防，司马防生下晋宣帝司马懿	春，正月，丁亥，即用魏庙祭征西府君以下，并景帝凡七室
春季，正月，丁亥，就便利用魏庙，祭祀征西府君司马钧以下，连同景帝司马师共七个堂屋	辛丑，尊景帝夫人羊氏曰景皇后，居弘训宫
辛丑，尊奉景帝夫人羊氏为景皇后，居住在弘训宫	丙午，立皇后弘农杨氏；后，魏通事郎文宗之女也
二月，解除魏对汉宗室的禁锢	三月，戊戌，吴遣大鸿胪张俨、五郎将丁忠来吊祭
夏季，五月，壬子，博陵元公王沈去世	六月，丙午晦，日有食之
十一月，晋开始把冬至一圜丘祭天、夏至在方泽祭地的仪式合并于南郊和北郊	罢山阳国督军，除其禁制
秋季，七月，王祥以睢陵公的爵位被免职	九月，甲申，诏增使俸
九月，甲申，晋武帝下诏，增加官吏的薪俸	以何曾为太保，义阳王望为太尉，荀为司徒
晋武帝任命何曾为太保，义阳王司马望为太尉，荀为司徒	禁星气、谶纬之学
丁亥，晋武帝在洛水之北耕种奉祀宗庙的籍田	戊子，大赦
戊子，晋武帝大赦天下	二月，吴主以左御史大夫丁固为司徒，右御史大夫孟仁为司空
三月，戊子，皇太后王氏去世	夏，四月，戊戌，睢陵元公王祥卒，门无杂吊之宾
晋武帝居丧期的制度，一概遵循古时倏的礼节	其族孙戎叹曰：太保当正始之世，不在能言之流；及间与之言，理致清远，岂非以德掩其言乎
秋季，七月，众多流星落向西方如雨水倾泻而下	已卯，帝谒崇阳陵
已卯，晋武帝拜谒崇阳陵	九月，青、徐、兖、豫四州大水
吴主出东关；冬季，十月，派他的将领施绩进入江夏，派万入侵襄阳	误交州刺史刘俊、大都督则、将军顾容前后三攻交趾，交趾太守杨稷皆拒破之；郁林、九真皆附于稷
晋武帝命义阳王司马望统领中军步兵、骑兵二万人驻扎在龙陂，声援江夏与襄阳两方面	稷遣将军毛炅、董元攻合浦，战于古城，大破吴兵，杀刘俊、则，余兵散还合浦
这时，荆州刺史胡烈抵御施绩的入侵并打败了施绩，司马望便领兵返回	稷表炅为郁林太守，元为九真太守
十一月，吴国丁奉、诸葛靓从芍陂出兵，攻打合肥，遭到安东将军、汝阴王司马骏的抵抗，吴兵退却	以义阳王望为大司马，荀为太尉，石苞为司徒
晋武帝任命义阳王司马望为大司马，荀为太尉，石苞为司徒	春，正月，吴主立子瑾为皇太子
晋武帝任命文立为散骑常侍	秋，九月，有星孛于紫宫
蜀汉从前的尚书、犍为人程琼、德行政	
秋季，九月，有异星出现于紫宫星座	冬，十月，吴大赦，改元建衡
冬季，十月，吴国实行大赦，改年号为建衡	封皇子景度为城阳王
春季，正月，吴国丁奉进入涡口，扬州刺史牵弘将他击退	吴万自巴丘还建业
秋季，七月，乙巳，城阳王司马景度去世	丁未，以汝阴王骏为镇西大将军，都督雍、凉等州诸军事，镇关中
丁未，晋任命汝阴王司马骏为镇西大将军，统领雍、凉等州的各项军事行动，镇守关中	冬，十一月，立皇子东为汝南王
这一年，吴国实行大赦	初，魏人居南匈奴五部于并州诸郡，与中国民杂居，自谓其先汉氏外孙，因改姓刘氏
三月，丙戌，钜鹿元公裴秀去世	夏，四月，吴交州刺史陶璜袭九真太守董元，杀之；杨稷以其将王素代之
五月，立皇子司马宪为城阳王	辛丑，义阳成王望卒
八月丙申，城阳王司马宪去世	分益州南中四郡置宁州
晋朝分出益州南部、中部的四个郡，设置宁州	九月，吴司空孟仁卒
九月，吴国司孟仁去世	冬，十月，丁丑朔，日有食之
冬季，十月，丁丑朔，出现日食	十一月，刘猛寇并州，并州刺史刘钦击破之
贾充将要赴镇守之任，公卿大臣们在夕阳亭为他饯行	十二月，以光禄大夫郑袤为司空，袤固辞不受
贾充悄悄问	
十二月，晋任命光禄大夫郑袤为司空，郑袤坚决辞让不接受	是岁，安乐思公刘禅卒
吴国改明年年号为凤凰	春，正月，监军何桢讨刘猛，屡破之，潜以利诱其左部帅李恪，恪杀猛以降
春季，正月，晋监军何桢讨伐刘猛	二月，辛卯，皇太子纳贾妃
多次打败刘猛，何桢暗中以利益引诱刘猛的左部帅李恪，李恪杀了刘猛投降了晋	妃年十五，长于太子二岁，妒忌多权诈，太子嬖而畏之
壬辰，晋朝大赦天下	秋七月，以贾充为司空，侍中、尚书令、领兵如故
	充与侍中任恺皆
春季，正月，辛酉，密陵元侯郑袤去世	二月，癸巳，乐陵武公石苞卒
二月，癸巳，乐陵武公石苞去世	三月，立皇子祗为东海王
三月，晋朝立皇子司马祗为东海王	吴以陆抗为大司马、荆州牧
吴国任命陆抗为大司马、荆州牧	夏，四月，戊辰朔，日有食之
五月，晋任命何曾兼任司徒	六月，乙未，东海王祗卒
六月，乙未，东海王司马祗去世	秋，七月，丁酉朔，日有食之
春季，正月，乙未，出现日食	闰月，癸酉，寿光成公郑冲卒
闰月，癸酉，晋朝寿光成公郑冲去世	丁亥，诏曰：近世以来，多由内宠以登后妃，乱尊卑之序；自今不得以妾媵为正嫡
丁亥，晋武帝下诏说：近代以来，时常由姬妾登上后妃的位子，乱了尊卑的次序，从现在起，不得以侍妾的身份，任正宗的后妃	分幽州置平州
晋朝分出幽州的一部分，设置了平州	三月，癸亥，日有食之
三月，癸亥，出现日食	诏又取良家及小将吏女五千人入宫选之，母子号哭于宫中，声闻于外
吴国接连三年闹起大瘟疫	春，正月，戊午朔，大赦，改元
春季，正月，戊午朔，晋大赦天下，改年号为咸宁	吴掘地得银尺，上有刻文；吴主大赦，改元天册
秋季，七月，甲申晦，出现日食	冬，十二月，丁亥，追尊宣帝庙曰高祖，景帝曰世宗，文帝曰太祖
冬季，十二月，丁亥，晋朝追尊晋宣帝司马懿庙号为高祖，晋景帝司马师庙号为世宗，晋文帝司马昭庙号为太祖	大疫，洛阳死者以万数
晋国流行大瘟疫，洛阳因瘟疫而死的人，数以万计	春，令狐丰卒，弟宏继立，杨欣讨斩之
春季，正月，丙子朔，出现日食	立皇子裕为始平王；庚寅，裕卒
晋朝立皇子司马裕为始平王；庚寅，司马裕去世	三月，平虏护军文鸯督凉、秦、雍州诸军讨树机能，破之，诸胡二十万口来降
三月，平虏护军文鸯，统领凉州、秦州、雍州各军征讨发树机能，将其打败，胡人各部落共二十万人归降晋	夏，五月，吴将邵、夏祥帅众七千余人来降
夏季，五月，吴将邵、夏祥郭领部众七千余人投降了晋	秋，七月，中山王睦坐招诱逋亡，贬为丹水县侯
秋季，七月，中山王司马睦因为招募逃亡的罪犯而获罪，被贬为丹水县侯	有星孛于紫宫
会稽人张经常在吴主面前搬弄口舌，诬陷别人，因而深受吴主宠爱信任，被多次升迁，任司直中郎将，还被封为侯	卫遣拓跋沙漠汗归国
张的父亲在山阴县当差，知道张不是善良之辈，就上表说：如果任用张为司直，我请求，他犯了罪不要牵连到我	自沙漠汗入质，力微可汗诸子在侧者多有宠
吴主答应了他	及沙漠汗归，诸部大人共谮而杀之
张上表，设置弹曲二十人，专门负责举报检查种种不法行为	既而力微疾笃，乌桓王库贤亲近用事，受卫赂，欲扰动诸部，乃砺斧于庭，谓诸大人曰：可汗恨汝曹谗杀太子，欲尽心收汝曹长子杀之
于是官吏百姓各自凭自己的好恶互相告发检举，一时间监狱里人满为患，上上下下，人人惶恐不安	诸大人惧，皆散走
而张却借机为自己在谋私利，骄奢专横	力微以忧卒，时年一百四
后来张的罪恶暴露出来，父亲儿子都曹车袭的酷刑	子悉禄立，其国遂衰
夏季，四月，晋朝大赦天下	除部曲督以下质任
六月，重新封丹水侯司马睦为交阳王	秋，八月，己未，封皇弟延祚为乐平王，寻薨
秋季，八月，己未，封武帝弟司马延祚为乐平王，不久他就去世了	九月，庚寅，贾充等以天下一统，屡请封禅；帝不许
夏季，五月，己亥，琅邪武王司马去世	冬，十一月，以尚书左仆射魏舒为司徒
冬季，十一月，任命尚书左仆射魏舒为司徒	河南及荆、扬等六州大水
河南以及荆、扬等六州洪水泛滥	归命侯孙卒
冬季，十二月，庚午，实行大赦	闰月，当阳成侯杜预卒
闰月，当阳成侯杜预去世	是岁，塞外匈奴胡太阿厚帅部落二万九千三百人来降；帝处之塞内西河
这一年，塞外的匈奴人太阿厚，率领他的部落二万九千三百人归降晋，晋武帝让他们在塞内西河居住	罢宁州入益州，置南夷校尉以护之
废除了宁州，归并入益州，设置南夷校尉监理益州	春，正月，尚书左仆射刘毅致仁，寻卒
青、梁、幽、冀州闹旱灾	秋，八月，丙戌朔，日有食之
秋季，八月，丙戌朔，出现日食	冬，十二月，庚子，襄阳武侯王浚卒
秋季，匈奴人都大博以及萎莎人，各自率领种族部落十万多人到雍州投降	九月，戊寅，扶风武王骏薨
这一年，鲜卑人拓跋悉鹿去世，他的弟弟拓跋绰继位	春，正月，戊申朔，日有食之
春季，正月，戊申朔，出现日食	太庙殿陷，九月，改营太庙，作者六万人
这一年，匈奴都督大豆得一育鞠等人又率领其种族部落一万一千五百人投降了晋	春，正月，壬申朔，日有食之
春季，正月，壬申朔，出现日食	夏，六月，庚子朔，日有食之
夏季，六月，庚子朔，出现日食	郡国三十三大旱
有三十三个郡国大旱	秋，八月，壬子，星陨如雨
秋季，八月，壬子，星星像下雨似的坠落下来	地震
发生了地震	夏，四月，太庙成；乙巳，袷祭；大赦
奚轲人男女共十万人投降了晋	春，正月，辛酉朔，改元太熙
春季，正月，辛酉朔，改年号为太熙	己巳，以王浑为司徒
剧阳康子魏舒去世	三月，甲子，以右光禄大夫石鉴为司空
冬季，十月，辛酉，任命石鉴为太尉，陇西王司马泰为司空	以刘渊为建威将军、匈奴五部大都督
任命刘渊为建威将军、匈奴五部大都督	春，正月，乙酉朔，改元永平
元康元年	
秋季，七月，分出荆州、扬州的十个郡设置了江州	八月，辛未，立陇西王泰世子越为东海王
八月，辛未，立陇西王司马泰的长子司马越为东海王	九月，甲午，秦献王柬薨
九月，甲午，秦献王司马柬去世	辛丑，征征西大将军梁王肜为卫将军、录尚书事
秋季，八月，壬子，大赦天下	夏，六月，弘农雨雹，深三尺
夏季，六月，弘农下雹子，三尺深	鲜卑宇文莫槐为其下所杀，弟普拨立
鲜卑人宇文莫槐被他的部下所杀，他的弟弟宇文普拨即位	拓拔绰卒，子弗立
拓跋绰去世，他的弟弟的儿子拓跋弗即位	春，正月，丁酉，安昌元公石鉴薨
慕容迁移到大棘城居住	拓跋弗卒，叔父禄官立
拓跋弗去世，他的叔父拓跋禄官即位	夏，六月，东海雨雹，深五寸
夏季，六月，东海下雹子，深五寸	荆、扬、兖、豫、青、徐六州大水
夏季，郝散的弟弟郝度元与冯翊、北地的马兰羌人、卢水胡人一起造反，杀了北地太守张损，打败了冯翊太守欧阳建	关中饥、疫
春季，三月，壬戌，大赦天下	秋，九月，荆、豫、徐、扬、冀五州大水
己亥，相国司马伦假借诏令派遣尚书刘弘送金屑酒赐给贾皇后，贾皇后饮后死于金墉城	五月，已巳，诏立临海王臧为皇太孙，还妃王氏以母之；太子官属即转为太孙官属，相国伦行太孙太傅
立襄阳王司马尚为皇太孙	六月，乙卯，齐王帅众入洛阳，顿军通章署，甲士数十万，威震京都
戊辰，大赦天下	复封宾徒王晏为吴王
十二月，颖昌康公何邵去世	封大司马子冰为乐安王，英为济阳王，超为淮南王
封大司马司马的儿子司马冰为安乐王，封司马英为济阳王，司马超为淮南王	春，三月，冲太孙尚薨
春季，三月，皇太孙司马尚去世	夏，五月，己酉，梁孝王肜薨
夏季，五月，乙酉，梁孝王司马肜去世	以右光禄大夫刘为太傅，寻以老病罢
大司马司马想长久地独自控制朝政，但因为惠帝的子孙都死了，而大将军司马颖有按皇位继承次序递补的可能	秋，八月，李特攻张微，微击破之，遂进攻特营
清河王司马覃是司马遐的儿子，刚八岁，司马就上表奏请册立司马覃	李荡引兵救之，山道险狭，荡力战而前，遂破微兵
癸卯，立司马覃为皇太子，让司马担任太子太师	特欲还涪，荡及司马王幸谏曰：微军已败，智勇俱竭，宜乘锐气遂禽之
让东海王司马越担任司空，兼中书监	特复进攻微，杀之，生禽微子存，以微丧还之
李雄攻杀汶山太守陈图，遂取郫城	李雄进攻并杀死汶山太守陈图，于是占取郫城
初，李含以长沙王微弱，必为齐王所杀，因欲以为罪而讨之，遂废帝，立大将军颖，以河间王为宰相，己得用事	当初，李含以为长沙王司马力量微弱，一定会被齐王司马杀掉，所以想借讨伐司马罪行为名，废黜惠帝，拥立大将军司马颖，让河间王司马任宰相，这样自己便得以执掌大权
既而为所杀，颖、犹守藩，不如所谋	但不久司马却被司马杀掉，司马颖、司马仍然镇守藩地，不像自己所谋划的那样
颖恃功骄奢，百度驰废，甚于时；犹嫌在内，不得逞其欲，欲去之	此后，司马颖居功自傲，朝政各方面荒废松弛，比司马时还要严重，司马颖尤其不能忍受司马在禁城之内，使自己不能随心所欲，打算除掉司马
时皇甫商复为参军，商兄重为秦州刺史	当时皇甫商又重新任司马的参军，皇甫商的哥哥皇甫重担任秦州刺史
含说曰：商为所任，重终不为人用，宜早除之	李含对司马说：皇甫商被司马任用，皇甫重终究不会被别人所用，应该尽快除掉
可表迁重为内职，因其过长安执之	可以表奏建议把皇甫重提升到朝廷中任职，趁他经过长安时把他抓住
重知之，露檄上尚书，发陇上兵以讨含	皇甫重知道了李含的阴谋，向尚书公布檄文，纠集陇上军队讨伐李含
以兵方少息，遣使诏重罢兵，征含为河南尹	司马因军队刚刚稍事休息，就派使者带诏书命令皇甫重取消这次军事行动，并征调李含去担任河南尹
含就征而重不奉诏，遣金城太守游楷、陇西太守韩稚等合四郡兵攻之	李含接受征调而皇甫重却不服从诏令，司马派金城太守游楷、陇西太守韩稚等人联合四个郡的军队去攻打皇甫重
密使含与侍中冯荪、中书令卞粹谋杀；皇甫商以告，收含、荪、粹，杀之	司马又秘密派遣李含与侍中冯荪、中书令卞粹谋杀司马，皇甫商得知后告诉司马，拘捕并杀掉了李含、冯荪、卞粹
骠骑从事琅邪诸葛玫、前司徒长史武邑牵秀皆出奔邺	骠骑从事琅邪人诸葛玫，前司徒长史武邑人牵秀都出城投奔邺城
石超进逼缑氏	石超进军逼临缑氏
冬，十月，壬寅，帝还宫	冬季，十月，壬寅，惠帝回到皇宫
丁未，败牵秀于东阳门外	丁未，在东阳门外击败牵秀
大将军颖遣将军马咸助陆机	大将军司马颖派将军马咸协助陆机
戊申，太尉奉帝与机战于建春门	戊申，太尉司马尊奉帝命与陆机在建春门战斗
司马王瑚使数千骑系戟于马，以突咸陈，咸军乱，执而斩之	司马的司马王瑚派几千骑兵把戟系在马上，冲击马咸的兵阵，马咸军队混乱，捉住马咸杀掉了
机军大败，赴七里涧，死者如积，水为之不流	陆机军队惨败，退到七里涧，死尸堆积，把水流都堵塞住了
斩其大将贾崇等十六人，石超遁去	王瑚杀死陆机的大将贾崇等十六人，石超逃遁离去
闰月，李雄急攻罗尚	闰月，李雄对罗尚发起猛攻
尚军无食，留牙门张罗守城，夜，由牛水东走，罗开门降	罗尚的军队没有粮食，就留下牙门张罗守城，自己夜里从牛水向东逃跑，张罗打开城门投降
雄入成都，军士饥甚，乃帅众就谷于，掘野芋而食之	李雄进入成都，军队兵士非常饥饿，就率部众到县寻求给养，挖掘野山芋当粮吃
许雄坐讨贼不进，征即罪	李雄被判定犯了讨伐盗贼时裹足不前的罪过，朝廷召他去接受判罚
春，正月，丙午，乐广以忧卒	春季，正月，丙午，乐广忧郁而死
长沙厉王屡与大将军颖战，破之，前后斩获六、七万人	长沙厉王司马多次与大将军司马颖开战，打败司马颖，前后杀死或俘虏六七万人
而未尝亏奉上之礼；城中粮食日窘，而士卒无离心	战事紧张而司马对侍奉皇上的礼节却从不曾耽搁减少
张方以为洛阳未可克，欲还长安	城中粮食日益困窘，但士卒们却没有背离的想法
而东海王越虑事不济，癸亥，潜与殿中诸将夜收送别省	张方认为洛阳不能攻克，想返回长安
甲子，越启帝，下诏免官，置金墉城	这时东海王司马越在朝中考虑事情不能成功，癸亥，暗地与殿中各位将领趁夜把司马拘捕送到另外的官署
大赦，改元	甲子，司马越启奏惠帝，下诏书罢免司马的官职，把他关在金墉城
城既开，殿中将士见外兵不盛，悔之，更谋劫出以拒颖	赦免罪犯，改年号为永安
越惧，欲杀以绝众心	城门打开后，殿中的官兵看到城外的军队并不强，因而感到后悔，又谋划劫出司马来抗拒司马颖
黄门侍郎潘滔曰：不可，将自有静之者	司马越惶惶不安，想杀掉司马使大家断绝这个想法
乃遣人密告张方	黄门侍郎潘滔说：不能这样，将自然有使大家静心的人
丙寅，方取于金墉城，至营	就派人秘密告诉张方
炙而杀之，方军士亦为之流涕	丙寅，张方在金墉城带走司马，到军营后，把司马用火烧烤后杀了，连张方军中的兵士也为司马流泪
罗尚逃至江阳，遣使表状；诏尚权统巴东、巴郡、涪陵以供军赋	罗尚逃到江阳，派使者向朝廷奏报情况，朝廷诏令罗尚暂且统领巴东、巴郡、涪陵，来供应军事给养
尚遣别驾李兴诣镇南将军刘弘求粮，弘纲纪以运道阻远，且荆州自空乏，欲以零陵米五千斛与尚	罗尚派遣别驾李兴向镇南将军刘弘求助粮食，刘弘的参佐考虑到运粮道路遥远，加之荆州本地也粮食紧张，就想从零陵拨出五千斛米给罗尚
弘曰：天下一家，彼此无异，吾今给之，则无西顾之忧矣	刘弘说：天下是一家，互相不分彼此，我现在供给他，就没有照顾担心西边的忧虑了
遂以三万斛给之，尚赖以自存	于是给罗尚三万斛米，罗尚靠这些米得以生存
李兴愿留为弘参军，弘夺其手版而遣之	李兴想留下来作刘弘的参军，刘弘将他来参见用的手版夺走而赶他回去
又遣治中何松领兵屯巴东为尚后继	刘弘还派治中何松带兵驻扎在巴东作为罗尚的后援
于是流民在荆州者十余万户，羁旅贫乏，多为盗贼，弘大给其田及种粮，擢其贤才，随资叙用，流民遂安	当时在荆州的流民有十多万户，寄居他乡十分贫困，大多成为盗贼，刘弘分给他们大批田地和种籽，提拔其中贤德的人才，按照资质任用，流民于是安定下来
三月，乙酉，丞相颖表废皇后羊氏，幽于金墉城；废皇太子覃为清河王	三月，乙酉，丞相司马颖表奏废黜皇后羊氏，幽禁在金墉城，废黜皇太子司马覃为清河王
陈敏与石冰战数十合，冰众十倍于敏，敏击之，所向皆捷，遂与周合攻冰于建康	陈敏与石冰交战几十次，石冰的人数是陈敏的十倍，但陈敏攻打石冰，每次都获得胜利，于是与周在建康联合进攻石冰
三月，冰北走，投封云，云司马张统斩冰及云以降，扬、徐二州平	三月，石冰失败逃窜，投奔封云，封云的司马张统杀掉石冰和封云后投降，扬、徐二州于是平定
周、贺循皆散众还家，不言功赏	周、贺循都遣散部众回家，不提功劳封赏
朝廷以陈敏为广陵相	朝廷让陈敏担任广陵相
陈、上官巳等奉太子覃守洛阳	陈、上官巳等人侍奉太子司马覃留守洛阳
司空越奔下邳，徐州都督东平王不纳，越径还东海	司空司马越逃奔下邳，徐州都督东平王司马不接纳，司马越就直接回到东海
太弟颖以越兄弟宗室之望，下令招之，越不应命	皇太弟司马颖因为司马越兄弟在宗室中享有声望，下令招他来，司马越没有接受命令应召
前奋威将军孙惠上书劝越要结藩方，同奖王室，越以惠为记室参军，与参谋议	前奋威将军孙惠给司马越去信劝说司马越团结藩王，共同辅助王室，司马越让孙惠担任记室参军，让他参与计策的谋划商讨
北军中候苟奔范阳王，承制以行兖州刺史	北军中候苟投奔范阳王司马，司马按照朝廷旨意让苟担任兖州刺史
丞相从事中郎王澄发孟玖奸利事，劝太弟颖诛之，颖从之	丞相从事中郎王澄揭发孟玖用邪恶的手段谋取私利，劝说太弟司马颖把他杀掉，司马颖批准
上官巳在洛阳，残暴纵横	上官巳在洛阳，残暴横行
守河南尹周馥，浚之从父弟也，与司隶满奋等谋诛之，事泄，奋等死，馥走，得免	任河南尹的周馥，是周浚的堂弟，与司隶满奋等人谋划杀掉上官巳，走露了风声，满奋等人被杀，周馥逃走，得以免死
司空越之讨太弟颖也，太宰遣右将军、冯翊太守张方将兵二万救之，闻帝已入邺，因命方镇洛阳	司空司马越征讨皇太弟司马颖，太宰司马派右将军、冯翊太守张方率两万人的军队前去救援，听说惠帝已进入邺城，就命令张方去镇守洛阳
巳与别将苗愿拒之，大败而还	上官巳与另一支军队的将军苗愿抗拒张方，惨败，回到城里
太子覃夜袭巳、愿，巳、愿出走；方入洛阳	太子司马覃夜袭上官巳、苗愿，上官巳、苗愿出城逃走，张方进入洛阳
覃于广阳门迎方而拜，方下车扶止之，复废覃及羊后	司马覃在广阳门迎着张方叩拜，张方下车把他扶住不让他叩拜，再一次废黜了司马覃和羊皇后
初，太弟颖表匈奴左贤王刘渊为冠军将军，监五部军事，使将兵在邺	当初，皇太弟表奏匈奴左贤王刘渊任冠军将军，监理五部匈奴的军政事务，让他在邺城统领军队
渊子聪，骁勇绝人，博涉经史，善属文，弯弓三百斤；弱冠游京师，名士莫不与交	刘渊的儿子刘聪，骁勇超人，博览经史典籍，善于写文章，能用三百斤张力的大弓，年轻时到京都游玩，京都名士没有不与他结交的
颖以聪为积弩将军	司马颖让他任积弩将军
东嬴公腾乞师于拓跋猗以击刘渊，猗与弟猗卢合兵击渊于西河，破之，与腾盟于汾东而还	东赢公向拓跋猗求兵攻打刘渊，拓跋猗与弟拓跋猗卢联合在西河进攻刘渊，把刘渊打败，与司马腾在汾东结盟后回师
荆州兵擒斩张昌，同党皆夷三族	荆州的军队擒获并杀掉张昌，他的同党都被诛灭三族
罗尚移屯巴郡，遣兵掠蜀中，获李骧妻昝氏及子寿	罗尚迁移到巴郡驻扎，派兵抢掠蜀中，抓获李骧的妻子昝氏和儿子李寿
东嬴公腾遣将军聂玄击汉王渊，战于大陵，玄兵大败	东嬴公司马腾派将军聂玄攻打汉王刘渊，在大陵县交战，聂玄的军队惨败
夏，四月，张方废羊后	夏季，四月，张方废黜羊皇后
游楷等攻皇甫重，累年不能克，重遣其养子昌求救于外	游楷等人攻打皇甫重，几年都没有攻克，皇甫重派他的养子皇甫昌到外边录求救援
昌诣司空越，越以太宰新与山东连和，不肯出兵	皇甫昌拜见司空司马越，司马越因为太宰司马新近与崤山以东地区联系和解，不肯出兵
昌乃与故殿中人杨篇诈称越命，迎羊后于金墉城	皇甫昌就与以前为殿中人的杨篇一起，伪称奉司马越的旨意，从金墉城迎出羊皇后
入宫，以后令发兵讨张方，奉迎大驾	进入皇宫后，用皇后的命令发兵讨伐张方，尊奉迎接皇帝大驾
事起仓猝，百官初皆从之；俄知其诈，相与诛昌	事情来得仓猝，朝廷各部门官员开始都跟随皇甫昌，不久知道是伪令，就一起杀了皇甫昌
请遣御史宣诏喻重令降	司马请求派御史向皇甫重宣布诏令，命令他投降
重不奉诏	皇甫重不遵行诏令
先是城中不知长沙厉王及皇甫商已死	开始时城里不知道长沙厉王司马和皇甫商已被杀死
重获御史驺人，问曰：我弟将兵来，欲至未	皇甫重抓住来宣布诏令的御史马夫，询问说：我弟弟带兵过来，快到了吗
驺人曰：已为河间王所害	马夫说：他已被河间王司马害死了
重失色，立杀驺人	皇甫重大惊失色，当即杀掉马夫
于是城中知无外救，共杀重以降	这样城里知道没有外援，就一起杀了皇甫重投降
以冯翊太守张辅为秦州刺史	司马命冯翊太守张辅担任秦州刺史
六月，甲子，安丰元侯五戎薨于郏	六月，甲子，安丰元侯王戎在郏县去世
汉王渊攻东嬴公腾，腾复乞师于拓跋猗，卫操劝猗助之	汉王刘渊攻打东赢公司马腾，司马腾又向拓跋猗求援助，卫操劝拓跋猗帮助司马腾
猗帅轻骑数千救腾，斩汉将綦毋豚	拓跋猗率领几千轻装的骑兵去救援司马腾，杀了汉将綦毋豚
诏假猗大单于，加操右将军	诏令把拓跋猗封为大单于，加封卫操右将军
甲申，猗卒，子普根代立	甲申，拓跋猗去世，儿子拓跋普根代他立为大单于
八月，辛丑，大赦	八月，辛丑，宣布大赦
太宰闻山东兵起，甚惧	太宰司马听说崤山以东战事又起，非常恐惧
以公师藩为成都王颖起兵，壬午，表颖为镇军大将军、都督河北诸军事，给兵千人；以卢志为魏郡太守，随颖镇邺，欲以抚安之	因为公师藩是为成都王司马颖而起兵，壬午，司马表奏任司马颖为镇东大将军，都督河北诸军事，配给一千兵士；任卢志为魏郡太守，随从司马颖镇守邺城，想以此抚尉并安定公师藩
又遣建武将军吕朗屯洛阳	又派建武将军吕朗到洛阳驻扎
有星孛于北斗	有异星出现在北斗星旁
平昌公模遣将军宋胄趣河桥	平昌公司马模派将军宋胄向河桥进兵
十一月，立节将军周权，诈被檄，自称平西将军，复立羊后	十一月，立节将军周权，假称收到檄文，自称为平西将军，又重新立羊皇后
洛阳令何乔攻权，杀之，复废羊后	洛阳令何乔攻打周权，把他杀了，又废黜羊皇后
太宰矫诏，以羊后屡为奸人所立，遣尚书田淑敕留台赐后死	太宰司马假称诏令，根据羊皇后多次被坏人拥立，派尚书田淑命令留守台署赐羊皇后死
诏书屡至，司隶校尉刘暾等上奏，固执以为：羊庶人门户残破，废放空宫，门禁峻密，无缘得与奸人构乱；众无愚智，皆谓其冤	诏书几次传到，司隶校尉刘暾等人上奏，坚持认为：羊庶人门庭早已破败，废黜放逐空宫，宫门禁卫戒备森严，没有条件能够与坏人勾结而制造变乱，大家无论愚蠢还是聪明，都说她很冤枉
今杀一枯穷之人，而令天下伤惨，何益于治	现在杀这样一个潦倒穷愁的人，而使天下悲伤，对社会安定有什么好处
怒，遣吕朗收暾；暾奔青州，依高密王略	司马发怒，派吕朗拘捕刘暾，刘暾投奔青州，依靠高密王司马略
然羊后亦以是得免	但羊皇后也因此而得以免于一死
十二月，吕朗等东屯荥阳，成都王颖进据洛阳	十二月，吕朗等向东在荥阳驻扎，成都王司马颖进兵据守洛阳
初，陈敏既克石冰，自谓勇略无敌，有割据江东之志	当初，陈敏战胜石冰后，自以为勇猛谋略没有对手，产生在江东割据的想法
其父怒曰：灭我门者，必此儿也	他父亲生气地说：使我们家族灭绝的，一定是这个儿子
遂以忧卒	于是忧郁而死
敏以丧去职	陈敏因为丧事而离职
司空越起敏为右将军、前锋都督	司空司马越起用陈敏为右将军、前锋都督
越为刘所败，敏请东归收兵，遂据历阳叛	司马越被刘打败，陈敏请求收兵东归，于是占据历阳反叛
吴王常侍甘卓，弃官东归，至历阳，敏为子景娶卓女，使卓假称皇太弟令，拜敏扬州刺史	吴王常侍甘卓，抛弃官职东归，到历阳，陈敏为自己的儿子陈景娶甘卓的女儿，并让甘卓伪称皇太弟的命令，任命陈敏为扬州刺史
敏使弟恢及别将钱端等南略江州，弟斌东略诸郡，扬州刺史刘机、丹杨太守王旷皆弃城走	陈敏派弟弟陈恢以及部将钱端等人向南攻打江州，弟弟陈斌向东攻打各郡，扬州刺史刘机，丹阳太守王旷都弃城逃跑
春，正月，戊子朔，日有食之	春季，正月，戊子朔，出现日食
范长生诣成都，成都王雄门迎，执版，拜为丞相，尊之曰范贤	范长生到成都，成都王李雄到城门口迎接，拿着表示礼节的手板，任范长生为丞相，尊称他为范贤
秋，七月，乙酉朔，日有食之	秋季，七月，乙酉朔，出现日食
八月，以司空越为太傅，录尚书事；范阳王为司空，镇邺；平昌公模为镇东大将军，镇许昌；王浚为骠骑大将军、都督东夷、河北诸军事，领幽州刺史	八月，朝廷任司空司马越为太傅，录尚书事；任范阳王司马为司空，镇守邺城；任平昌公司马模为镇东大将军，镇守许昌；任王浚为骠骑大将军、都督东夷、河北诸军事，兼任幽州刺史
越以吏部郎庚为军谘祭酒，前太弟中庶子胡母辅之为从事中郎，黄门侍郎郭象为主簿，鸿胪丞阮修为行参军，谢鲲为掾	司马越任吏部郎庚为军咨祭酒，任前太弟中庶子胡母辅之为从事中郎，任黄门侍郎郭象为主簿，任鸿胪丞阮修为行参军，任谢鲲为掾
辅之荐乐安光逸于越，越亦辟之	胡母辅之向司马越推荐乐安人光逸，司马越也加以任用
等皆尚虚玄，不以世务婴心，纵酒放诞；殖货无厌，象薄行，好招权；越皆以其名重于世，故辟之	庚等人都崇尚虚玄空淡，不把政务放在心上，纵酒放诞，庚聚敛财物贪得无厌，郭象品行轻薄，喜好贪图权位，司马越都因为他们名重于世，所以任用他们
进东嬴公腾爵为东燕王，平昌公模为南阳王	把东嬴公司马腾的爵位提升为东燕王，平昌公司马模的爵位提升为南阳王
冬，十月，范阳王薨	冬季，十月，范阳王司马去世
长史刘舆以颖素为邺人所附，秘不发丧，伪令人为台使称诏，夜，赐颖死，并杀其二子	长史刘舆因为过去邺城人一直归附司马颖，所以秘不发丧，派人假装成朝廷使者传宣假诏书，夜里赐司马颖死，并且杀了他的两个儿子
颖官属先皆逃散，惟卢志随从，至死不怠，收而殡之	司马颖的部属起先已全部逃散，只有卢志一直跟随，直到他死了也不懈怠，为司马颖收尸并安葬了他
太傅越召志为军谘祭酒	太傅司马越宣召卢志为军咨祭酒
十二月，壬午朔，日有食之	十二月，壬午朔，出现日食
太傅越以诏书徵河间王为司徒，乃就征	太傅司马越用诏书征召河间王司马为司徒，司马就前去接受征召
南阳王模遣其将梁臣邀之于新安，车上扼杀之，并杀其三子	南阳王司马模派部将梁臣，在新安拦住司马，在车上把他掐死，并杀了他的三个儿子
己酉，葬惠帝于太阳陵	己酉，把惠帝安葬在太阳陵
春，正月，癸丑，大赦，改元	春季，正月，癸丑，宣布大赦，改年号为永嘉
吏部郎周穆，太傅越之姑子也，与其妹夫御史中丞诸葛玫说越曰：主上之为太弟，张方意也	吏部郎周穆是太傅司马越姑母的儿子，他与妹夫御史中丞诸葛玫劝司马越说：皇上当时成为太弟，是张方的意图
清河王本太子，公宜立之	清河王本来是太子，您应当拥立他
越不许	司马越不同意
重言之，越怒，斩之	他们又向司马越说，司马越发怒，把他们杀了
二月，王弥寇青、徐二州，自称征东大将军，攻杀二千石	二月，王弥在青、徐二州作乱，自称征东大将军，攻杀郡守
太傅越以公车令东莱鞠羡为本郡太守，以讨弥，弥击杀之	太傅司马越让公车令东莱人鞠羡担任本郡太守，以讨伐王弥，王弥把他打死了
诏追复杨太后尊号；丁卯，改葬之，谥曰武悼	诏令追复杨太后的尊号，丁卯，将太后改葬，定谥号为武悼
庚午，立清河王覃弟豫章王诠为皇太子	庚午，立清河王司马覃的弟弟豫章王司马铨为皇太子
辛未，大赦	辛未，宣布大赦
帝观览大政，留心庶事；太傅越不悦，固求出藩	怀帝司马炽亲自审察大政，对朝廷事务也很留心
庚辰，越出镇许昌	太傅司马越对此不高兴，坚决要求出去作藩镇
以高密王略为征南大将军，都督荆州诸军事，镇襄阳；南阳王模为征西大将军，都督秦、雍、梁、益诸军事，镇长安；东燕王腾为新蔡王，都督司、冀二州诸军事，仍镇邺	任高密王司马略为征南大将军，都督荆州诸军事，镇守襄阳；任南阳王司马模为征西大将军，都督秦、雍、梁、益诸军事，镇守长安；封东燕王司马腾为新蔡王，都督司、冀二州诸军事，仍然镇守邺城
石勒与苟等相持于平原、阳平间数月，大小三十余战，互有胜负	石勒与苟在平原、阳平之间相持对垒几个月，大小三十余城，双方互有胜负
秋，七月，己酉朔，太傅越屯官渡，为声援	秋季，七月，己酉朔，太傅司马越在官渡屯兵驻扎，声援苟
己未，以琅邪王睿为安东将军、都督扬州江南诸军事、假节，镇建业	己未，朝廷任命琅邪王司马睿为安东将军、都督扬州江南诸军事，持符节，镇守建业
八月，己卯朔，苟击汲桑于东武阳，大破之	八月，己卯朔，苟在东武阳攻打汲桑，大败汲桑
桑退保清渊	汲桑撤退到清渊防守
分荆州、江州八郡为湘州	从荆州、江州分出八个郡，建立湘州
九月，戊申，琅邪王睿至建业	九月，戊申，琅邪王司马睿到达建业
睿以安东司马王导为谋主，推心亲信，每事咨焉	司马睿让安东司马王导作为主要谋士，对他推心置腹，非常信任，每件事都找王导咨询
睿名论素轻，吴人不附，居久之，士大夫莫有至者，导患之	司马睿名望声誉一直很轻，吴地人们都不附从，在建业居住了很久，士大夫没有来拜访的，王导感到忧虑
会睿出现禊，导使睿乘肩舆，具威仪，导与诸名胜皆骑从，纪瞻、顾荣等见之惊异，相帅拜于道左	正赶上司马睿出去观看禊祭，王导让司马睿乘上抬轿，安排了威严的仪仗
导因说睿曰：顾荣、贺循，此土之望，宜引之以结人心；二子既至，则无不来矣	王导和名士们都骑马侍从，纪瞻、顾荣等人见了后感到惊异，一个跟着一个地在道路左边行拜礼
睿乃使导躬造循、荣，二人皆应命而至	王导就劝说司马睿道：顾荣、贺循，都是这个地区最具名望的人了，应当结交他们来收服人心，他们两人来了，就没有不来的人
以循为吴国内史；荣为军司，加散骑常侍，凡军府政事，皆与之谋议	司马睿就派王导亲自拜访贺循、顾荣，两个人都接受邀请而来到司马睿处，司马睿让贺循担任吴国内史，顾荣担任军司马，加授散骑常侍
又以纪瞻为军祭酒，卞为从事中郎，周为仓曹属	军政事务，都与他们商议
琅邪刘超为舍人，张及鲁国孔衍为参军	又让纪瞻担任军咨祭酒，卞担任从事中郎，周任仓曹属，琅邪人刘超任舍人，张和鲁国的孔衍任参军
，粹之子；，昭之曾孙也	卞是卞粹的儿子，张是张昭的曾孙
王导说睿：谦以接士，俭以足用，以清静为政，抚绥新旧；故江东归心焉	王导对司马睿说：以谦逊的态度对待士人，通过节俭的办法保证用度的充足，以清静无为的原则处理政务，安抚以前的故旧部下与新结交的士人
睿初至，颇以酒废事；导以为言	所以得到了江东地区人们的信任
睿命酌，引觞覆之，于此遂绝	司马睿刚来时，常常因为喝酒耽误事情，王导对此进行劝说，司马睿就命令人斟上酒，他接过酒杯后把酒倒掉，从此便戒了酒
苟追击汲桑，破其八垒，死者万余人	苟追击汲桑，攻破汲桑的八个营垒，打死一万多人
桑与石勒收余众，将奔汉，冀州刺史谯国丁绍邀之于赤桥，又破之	汲桑与石勒收拾残余部众，打算投奔刘汉，冀州刺史谯国人丁绍又在赤桥拦截，结果丁绍打败了他们
桑奔马牧，勒奔乐平	汲桑逃奔马牧，石勒逃奔乐平
太傅越还许昌，加苟抚军将军、都督青、兖诸军事，丁绍宁北将军、监冀州诸军事，皆假节	太傅司马越返回许昌，给苟加官为抚军将军，都督青、兖诸军事，给丁绍加官为宁北将军、监冀州诸军事，都授给符节
胡部大张督、冯莫突等，拥众数千，壁于上党，石勒往从之，因说督等曰：刘单于举兵击晋，部大拒而不从	胡人首领部大张督、冯莫突等人，有部众几千人，在上党设置军垒，石勒去投奔他们
自度终能独立乎	石勒对张督等人说：单于刘渊举兵攻打晋朝，您抗拒而不随从，自己考虑一下能够最终独立吗
曰：不能	张督等人回答说：不能
勒曰：然则安可不早有所属	石勒说：那怎么能不早点找一靠山
今部落皆已受单于赏募，往往聚议，欲叛部大而归单于矣	现在部落都已经接受了单于的赏赐招募，常常在一起商议，想背叛部下而投归单于了
督等以为然	张督等人认为说得对
冬，十月，督等随勒单骑归汉，汉王渊署督为亲汉王，莫突为都督部大，以勒为辅汉将军、平晋王、以统之	冬季，十月，张督等人随石勒骑马投归汉，汉王刘渊封张督为亲汉王，冯莫突为都督部大，任石勒为辅汉将军，并封平晋王，以统率他们
十一月，戊申朔，日有食之	十一月，戊申朔，出现日食
甲寅，以尚书右仆射和郁为征北将军，镇邺	甲寅，朝廷任尚书右仆射和郁为征北将军，镇守邺城
乙亥，以王衍为司徒	乙亥，任王衍为司徒
衍说太傅越曰：朝廷危乱，当赖方伯，宜得文武兼资以任之	王衍对太傅司马越说：朝廷出现危险变乱，应当依靠地方最高长官，找得文武兼备的人加以任用
乃以弟澄为荆州都督，族弟敦为青州刺史，语之曰：荆州有江、汉之固，青州有负海之险，卿二人在外而吾居中，足以为三窟矣	于是让弟弟王澄任荆州都督，族弟王敦为青州刺史，王衍告诉他们说：荆州有江、汉的坚固，青州有靠海的险要，你二人在外面而我在朝中，足以成为狡兔的三窟了
澄至镇，以郭舒为别驾，委以府事	王澄到任所，让郭舒担任别驾，将都督府的事务都交给了他
澄日夜纵酒，不亲庶务，虽寇戎交急，不以为怀	王澄则日夜纵情喝酒，不亲理事务，虽然盗贼军情紧急，也不放在心上
舒常切谏，以为宜爱民养兵，保全州境，澄不从	郭舒常常苦苦劝谏，认为应当爱护人民保养军队，这样来使州境稻两保全，王澄不采纳
十二月，戊寅，乞活田甄、田兰、薄盛等起兵，为新蔡王腾报仇，斩汲桑于乐陵	十二月，戊寅，随司马腾乞活的州将田甄、田兰、薄盛等人起兵，为新蔡王司马腾报仇，在乐陵杀了汲桑
弃成都王颖棺于故井中，颖故臣收葬之	把成都王司马颖的棺材丢弃到故井里，司马颖的故臣又收拾好棺材安葬了
前北军中候吕雍、度支校尉陈颜等谋立清河王覃为太子；事觉，太傅越矫诏囚覃于金墉城	前北军中侯吕雍、度支校尉陈颜等人密谋立清河王司马覃为太子，事情暴露，太傅司马越假称诏令把司马覃囚禁在金墉城
初太傅越与苟亲善，引升堂，结为兄弟	起初太傅司马越与苟关系很亲近，带他进入后堂，结拜为兄弟
司马潘滔说越曰：兖州冲要，魏武以之创业	司马藩滔对司马越说：兖州地处险要，魏武帝从这儿创业
苟有大志，非纯臣也，久令处之，则患生心腹矣	苟有大志向，不是纯粹的臣下，让他在这里呆久了，就会成为心腹祸患
若迁于青州，厚其名号，必悦	如果把他调迁到青州，提高他的名号，苟一定高兴
公自牧兖州，经纬诸夏，藩卫本朝，此所谓为之于未乱者也	您亲自管理兖州，规划治理全国，藩卫朝廷，这就是所谓防患于未然
越以为然	司马越认为说得正确
癸卯，越自为丞相，领兖州牧，都督兖、豫、司、冀、幽、并诸军事	癸卯，司马越自任丞相，兼充州牧，都督兖、豫、司、冀、幽、并诸军事
以为征东大将军、开府仪同三司，加侍中、假节、都督青州诸军事，领青州刺史，封东平郡公	让苟任征东大将军、开府仪同三司、加任侍中，授予符节，都督青州诸军事、兼青州刺史，封东平郡公
越、由是有隙	司马越、苟之间因此产生怨恨
李钊至宁州，州人奉钊领州事	李钊到宁州，州里的人们尊奉李钊兼理州刺史事务
治中毛孟诣京师，求刺史，屡上奏，不见省	治中毛孟到京城，请求朝廷委派刺史，多次上奏，没有被审理
孟曰：君亡亲丧，幽闭穷城，万里诉哀，精诚无感，生不如死	毛孟说：州君已死，州城被围困，不远万里到朝廷倾诉悲哀，心意精诚而朝廷无动于衷，生不如死
欲自刎，朝廷怜之，以魏兴太守王逊为宁州刺史，仍诏交州出兵救李钊	就想自刎，朝廷怜惜他，让魏兴太守王逊任宁州刺史，同时诏令交州出兵救援李钊
交州刺史吾彦遣其子咨将兵救之	交州刺史吾彦派他儿子吾咨带兵去救援李钊
慕容自称鲜卑大单于	慕容自称鲜卑大单于
拓跋禄官卒，弟猗卢总摄三部，与通好	拓跋禄官去世，弟拓跋猗卢总管三部，与慕容结交友好
春，正月，丙午朔，日有食之	春季，正月，丙午朔，出现日食
丁未，大赦	丁未，宣布大赦
汉王渊遣抚军将军聪等十将南据太行，辅汉将军石勒等十将东下赵、魏	汉王刘渊派遣抚军将军刘聪等十名将军向南占据太行，派辅汉将军石勒等十名将军向东到赵、魏地区
二月，辛卯，太傅越杀清河王覃	二月，辛卯，太傅司马越杀死清河王司马覃
庚子，石勒寇常山，王浚击破之	庚子，石勒进犯常山，王浚击败了石勒
三月，太傅越自许昌徙镇鄄城	三月，太傅司马越从许昌迁徙到鄄城镇守
诏封张轨西平郡公，轨辞不受	诏令封张轨为西平郡公，张轨推辞而不接受
时州郡之使，莫有至者，轨独遣使贡献，岁时不绝	当时各州郡都没有到京城的使者，只有张轨独自派遣使者进贡，每年都不中断
八月，丁亥，太傅越自鄄城徙屯濮阳；未几，又徙屯荥阳	八月，丁亥，太傅司马越从鄄城迁徙到濮阳驻扎，没有多久，又迁徙到荥阳驻扎
九月，汉王弥、石勒寇邺，和郁弃城走	九月，汉国王弥、石勒进犯邺城，守将和郁弃城而逃
诏豫州刺史裴宪屯白马以拒弥，车骑将军王堪屯东燕以拒勒，平北将军曹武屯大阳以备蒲子	诏令豫州刺史裴宪在白马驻扎以抵御王弥；车骑将军王堪在东燕驻扎以抵御石勒；平北将军曹武驻扎在大阳以护备蒲子
宪，楷之子也	裴宪是裴楷的儿子
冬，十月，甲戌，汉王渊即皇帝位，大赦，改元永凤	冬季，十月，甲戌，汉王刘渊即皇帝位，宣布大赦，改年号为永凤
十一月，以其子和为大将军，聪为车骑大将军，族子曜为龙骧大将军	十一月，任命他儿子刘和为大将军，刘聪为车骑大将军，同族侄子刘曜为龙骧大将军
壬寅，并州刺史刘琨使上党太守刘帅鲜卑攻壶关，汉镇东将军綦毋达战败亡归	壬寅，并州刺史刘琨让上党太守刘带领鲜卑人攻打关，汉的镇东将军綦毋达战败而逃回
丙午，汉都督中外诸军事、领丞相、右贤王宣卒	丙午，汉国都督中外诸军事、兼丞相、右贤王刘宣去世
石勒、刘灵帅众三万寇魏郡、汲郡、顿丘，百姓望风降附者五十余垒；皆假垒主将军、都尉印绶，简其强壮五万为军士，老弱安堵如故	石勒、刘灵率领三万人进犯魏郡、汲郡、顿丘等地，五十多个村垒的百姓望风投降，石勒对全部村垒头目都授给将军、都尉的印章和绶带，并从百姓中挑选了五万强壮者作为兵士，对老弱病残的百姓仍让他们在原地安居
己酉，勒执魏郡太守王粹于三台，杀之	己酉，石勒在三台抓住并杀了魏郡太守王粹
十二月，辛未朔，大赦	十二月，辛未朔，宣布大赦
成尚书令杨褒卒	成汉尚书令杨褒去世
褒好直言，成主雄初得蜀，用度不足，诸将有以献金银得官者，褒谏曰：陛下设官爵，当网罗天下英豪，何有以官买金邪	杨褒喜欢直言，成汉主李雄刚刚占据蜀地时，费用不够，部将当中有因为捐献金银财物而得到职任的人，杨褒劝谏说：陛下设置官职爵位，应该网罗天下的英雄豪杰，哪里有用官职换取金钱的道理
雄谢之	李雄向他谢罪
雄尝醉，推中书令杖太官令，褒进曰：天子穆穆，诸侯皇皇	李雄曾经喝醉了酒，让中书令杖打太官令，杨褒进言说：天子威仪庄严，诸侯仪态端正
安有天子而为酗也	哪里有天子酗酒的道理
雄惭而止	李雄感到惭愧而停止了酗酒
丁巳，太傅越自荥阳入京师	丁巳，太傅司马越从荥阳进入京城
中书监王敦谓所亲曰：太傅专执威权，而选用表请，尚书犹以旧制裁之，今日之来，必有所诛	中书监王敦对他所亲近的人说：太傅独揽威势权力，但选拔任用官员仍上表请示，而尚书仍然按照过去的制度来裁定，因此太傅现在到京城，一定会杀掉一些官员
太傅越以王敦为杨州刺史	太傅司马越任王敦为扬州刺史
刘连年请老，朝廷不许	刘连年请求告老还乡，朝廷不同意
尚书左丞刘坦上言：古之养老，以不事为优，不以吏之为重，谓宜听所守	尚书左丞刘坦给朝廷上言：古代养老，以不使任职为好，并不把任职视为看重他，所以说应当尊重刘自己的安排
丁卯，诏以侯就第	丁卯，诏令刘以侯爵的身分回归府第
以王衍为太尉	任王衍为太尉
夏，大旱，江、汉、河、洛皆竭，可涉	夏季，大旱，长江、汉水、黄河、洛阳都枯竭了，可以徒步渡过去
汉主渊以王弥为侍中、都督青・徐・兖・豫・荆・扬六州诸军事、征东大将军、青州牧，与楚王聪共攻壶关，以石勒为前锋都督	汉主刘渊以王弥担任侍中，都督青、徐、兖、豫、荆、扬六州诸军事，征东大将军，青州牧，与楚王刘聪一起进攻壶关，以石勒任前锋都督
刘琨遣护军黄肃、韩述救之，聪败述于西涧，勒败肃于封田，皆杀之	刘琨派遣护军黄肃、韩述救援壶关，刘聪在西涧打败韩述，石勒在封田打败黄肃，把他们都杀了
五月，汉主渊封子裕为齐王，隆为鲁王	五月，汉主刘渊把儿子刘裕封为齐王，刘隆封为鲁王
天水人訇琦等杀成太尉李离、尚书令阎式，以梓潼降罗尚；成主雄遣太傅骧、司徒云、司空璜攻之，不克，云、璜战死	天水人訇琦等人杀了成汉的太尉李离和尚书令阎式，献出梓潼向罗尚投降，成汉主李雄派太傅李骧、司徒李云、司空李璜攻打梓潼，没有成功，李云、李璜战死
十一月，甲申，汉楚王聪、始安王曜归于平阳	十一月，甲申，汉楚王刘聪、始安王刘曜回到平阳
王弥南出辕，流民之在颍川、襄城、汝南、南阳、河南者数万家，素为居民所苦，皆烧城邑，杀二千石、长吏以应弥	王弥向南出兵辕，在颍川、襄城、汝南、南阳、河南的流民有几万家，一直被当地居民欺负，所以放火烧城焚邑，杀掉郡守、长史等官员，响应王弥
十二月，汉主渊以陈留王欢乐为太傅，楚王聪为大司徒，江都王延年为大司空	十二月，汉主刘渊以陈留王刘欢乐任太傅，楚王刘聪任大司徒，江都王刘延年任大司空
遣都护大将军曲阳王刘贤与征北大将军刘灵、安北将军赵固、平北将军王桑，东屯内黄	派遣都护大将军曲阳王刘贤与征北大将军刘灵、安北将军赵固、平北将军王桑，在东边的内黄县驻扎
王弥表左长史曹嶷行安东将军，东徇青州，且迎其家；渊许之	王弥表奏左长史曹嶷任安东将军，向东攻略青州，顺便接他的家眷，刘渊同意了这个安排
初，东夷校尉勃海李臻，与王浚约共辅晋室，浚内有异志，臻恨之	当初，东夷校尉勃海人李臻，与王浚相约共同辅佐晋皇室，王浚有另外的想法，李臻于是怨恨王浚
和演之死也，别驾昌黎王诞亡归李臻，说臻举兵讨浚	和演死后，别驾昌黎人王诞逃亡归附李臻，劝说李臻出兵讨伐王浚
臻遣其子成将兵击浚	李臻就派他儿子李成带兵攻打王浚
辽东太守庞本，素与臻有隙，乘虚袭杀臻，遣人杀成于无虑	辽东太守庞本，一直与李臻有怨恨，乘虚袭击杀了李臻，又派人在无虑杀了李成
诞亡归慕容	王诞又逃跑投奔慕容
诏以勃海封释代臻为东夷校尉，庞本复谋杀之；释子悛劝释伏兵请本，收斩之，悉诛其家	朝廷诏令以勃海人封释代替李臻任东夷校尉，庞本又图谋杀他，封释的儿子封悛劝封释设伏兵邀请庞本，把庞本抓住并杀了，之后又杀了他的全家
春，正月，乙丑朔，大赦	春季，正月，乙丑朔，宣布大赦
汉镇东大将军石勒济河，拔白马，王弥以三万众会之，共寇徐、豫、兖州	汉镇东大将军石勒渡过黄河，攻克白马，王弥带领三万人与石勒会师一同进犯徐州、豫州、兖州
二月，勒袭鄄城，杀兖州刺史袁孚，遂拔仓垣，刹王堪	二月，石勒袭击鄄城，杀兖州刺史袁孚，又攻克仓垣，杀王堪
复北济河，攻冀州诸郡，民从之者九万余口	又北渡黄河，攻打冀州各郡，九万多百姓附从石勒
成太尉李国镇巴西，帐下文石杀国，以巴西降罗尚	成汉太尉李国镇守巴西，部下文石杀死李国，献出巴西投降罗尚
曹嶷自大梁引兵而东，所至皆下，遂克东平，进攻琅邪	曹嶷从大梁带兵向东进攻，所向披靡，于是攻克东平，进兵攻打琅邪
夏，四月，王浚将祁弘败汉冀州刺史刘灵于广宗，杀之	夏季，四月，王浚部将祁弘在广宗打败汉冀州刺史刘灵，杀死刘灵
成主雄谓其将张宝曰：汝能得梓潼，吾以李离之官赏汝	成汉主李雄告诉他的部将张宝说：你能攻下梓潼，我把李离的官职赏给你
宝乃先杀人而亡奔梓潼，訇琦等信之，委以心腹	张宝于是杀人后逃亡投奔梓潼，訇琦等人都信任他，把他当作心腹
会罗尚遣使至梓潼，琦等出送之；宝从后闭门，琦等奔巴西	正遇到罗尚派使者到梓潼，訇琦等人出城送使者，张宝则在后边关团了城门，訇琦等人只好投奔巴西
雄以宝为太尉	李雄让张宝担任太尉
幽、并、司、冀、秦、雍六州大蝗，食草木、牛马毛皆尽	幽、并、司、冀、秦、雍等六州遭到严重蝗灾，蝗虫把草木、牛马的毛都啃食光了
罗尚卒于巴郡，诏以长沙太守下邳皮素代之	罗尚在巴郡去世，朝廷诏令以长沙太守下邳人皮素代替他的职务
略阳临渭氐酋蒲洪，骁勇多权略，群氐畏服之	略阳郡临渭县氐人酋长蒲洪，骁勇而善于权变谋略，氐人都敬畏而服从他
汉主聪遣使拜洪平远将军，洪不受，自称护氐校尉、秦州刺史、略阳公	汉主刘聪派使者任命蒲洪为平远将军，蒲洪不接受，而自称护氐校尉、秦州刺史、略阳公
九月，辛未，葬汉主渊于永光陵，谥曰光文皇帝，庙号高祖	九月，辛未，在永光陵安葬汉主刘渊，谥号为光文皇帝，庙号为高祖
雍州流民多在南阳，诏书遣还乡里	雍州流民大多在南阳谋生，朝廷下诏书要把流民遣返回故乡
流民以关中荒残，皆不	流民们因为关中地区荒芜残
冬，十月，汉河内王粲、始安王曜及王弥帅众四万寇洛阳，石勒帅骑二万会粲于大阳，败监军裴邈于渑池，遂长驱入洛川	冬季，十月，汉河内王刘粲、始安王刘曜以及王弥率领四万人进犯洛阳，石勒率领二万骑兵在大阳与刘粲会合，在渑池打败监军裴邈，于是长驱直入进入洛川
粲出辕，掠梁、陈、汝、颍间	刘粲从辕出兵，在梁、陈、汝、颍等地区攻掠
勒出成皋关，壬寅，围陈留太守王赞于仓垣，为赞所败，退屯文石津	石勒从成皋关出兵，壬寅，在仓垣包围陈留太守王赞，被王赞打败，退到文石津驻扎
壬子，以刘琨为平北大将军，王浚为司空，进鲜卑段务勿尘为大单于	壬子，以刘琨任平北大将军，王浚任司空，把鲜卑段务勿尘封为大单于
京师饥困日甚，太傅越遣使以羽檄征天下兵，使入援京师	京城洛阳饥饿困顿日益严重，太傅司马越派遣使者带着插羽毛的檄文征召全国军队，让他们来救援京城
帝谓使者曰：为我语诸征、镇，今日尚可救，后则无及矣	怀帝对使者说：替我告诉各征、镇，今天还可以援救，迟了就来不及了
既而卒无至者	但后来终究没有军队到达
征南将军山简遣督护王万将兵入援，军于涅阳，为王如所败	征南将军山简派遣督护王万带兵前去救援，在涅阳驻军，结果被王如打败
如遂大掠沔、汉，进逼襄阳，简婴城自守	王如于是在沔水、汉水地区大肆抢掠，进逼襄阳，山简只能围绕城墙进行防守
荆州刺史王澄自将，欲援京师，至口，闻简败，众散而还	荆州刺史王澄亲自带兵
朝议多欲迁都以避难，王衍以为不可，卖车牛以安众心	想去救援京城，到达口，听到山简的军队失败的消息，部众溃散，也只好回师，朝廷商议，多数人想迁都逃难，王衍认为不行，应该卖掉车、牛来安定人心
山简为严嶷所逼，自襄阳徙屯夏口	山简被严嶷逼迫，从襄阳迁徙到夏口驻扎
扬州都督周馥以洛阳孤危，上书请迁都寿春	扬州都督周馥因为洛阳孤单危险，上书请求迁都寿春
太傅越以馥不先白己而直上书，大怒，召馥及淮南太守裴硕	太傅司马越因为周馥不先通过自己而直接上书皇帝，勃然大怒，宣召周馥与淮南太守裴硕
馥不肯行，令硕帅兵先进	周馥不肯去，让裴硕率兵先去
硕诈称受越密旨，袭馥，为馥所败，退保东城	裴硕假称得到司马越的密令，袭击周馥
	结果被周馥打败，裴硕退到东城县防
石勒谋保据江、汉，参军都尉张宾以为不可	石勒图谋占据江、汉地区，参军都尉张宾认为不行
会军中饥疫，死者太半，乃渡沔、寇江夏，癸酉，拔之	正遇上军中饥乏又流行疾疫，有一大半都死了，于是渡过沔水，进犯江夏，癸酉，攻克江夏
乙亥，成太傅骧拔涪城，获谯登；太保始拔巴西，杀文石	乙亥，成汉太傅李骧攻克涪城，抓获了谯登
于是成主雄大赦，改元玉衡	太保李始攻克巴西，杀死文石
谯登至成都，雄欲宥之；登词气不屈，雄杀之	于是成汉君主李
裴硕求救于琅邪王睿，睿使扬威将军甘卓等攻周馥于寿春	裴硕向琅邪王司马睿求救，司马睿派扬威将军甘卓到寿春攻打周馥
馥众溃，奔项，豫州都督、新蔡王确执之，馥忧愤而卒	周馥的军队溃败，逃奔项县，豫州都督、新蔡王司马确抓住周馥，周馥忧愤而死
确，腾之子也	司马确是司马腾的儿子
扬州刺史刘陶卒	扬州刺史刘陶去世
琅邪王睿复以安东军谘祭酒王敦为扬州刺史，寻加都督征讨诸军事	琅邪王司马睿又以安东军咨祭酒王敦任扬州刺史，不久又加职都督征讨诸军事
庚辰，平原王薨	庚辰，平原王司马去世
二月，石勒攻新蔡，杀新蔡庄王确于南顿；进拔许昌，杀平东将军王康	二月，石勒攻打新蔡，在南顿杀新蔡王司马确，又进兵攻克许昌，杀了平东将军王康
益州将吏共杀暴重，表巴郡太守张罗行三府事	益州的武将和官吏一起杀了暴重，表奏巴郡太守张罗担任三府的职务
罗与隗文等战死，文等驱掠吏民，西降于成	张罗与隗文等人交战而死，隗文等人驱赶抢掠官吏和百姓，向西边的成汉投降
三府文武共表平西司马蜀郡王异行三府事，领巴郡太守	三府的文武官员共同表奏平西司马蜀郡人王异担任三府的职务，兼任巴郡太守
苟表请迁都仓垣，使从事中郎刘会将船数十艘、宿卫五百人、谷千斛迎帝	苟上奏表请求迁都仓垣，派从事中郎刘会带领几十艘船、五百禁卫兵、一千斛谷子去接怀帝
帝将从之，公卿犹豫，左右恋	怀帝打算听从这个安排，而公卿大臣们犹豫不决，左右随从
司徒傅祗建行台于河阴，司空荀藩在阳城，河南尹华荟在成皋，汝阴太守平阳李矩为之立屋，输谷以给之	司徒傅祗在河阴建立代表朝廷的行政机构&#0;&#0;行台，司空荀藩在阳城，河南尹华荟在成皋，汝阴太守平阳人李矩为傅祗建立房屋，并运送谷物来供给他
荟，歆之曾孙也	华荟是华歆的曾孙
初，南阳王模以从事中郎索为冯翊太守	当初，南阳王司马模任从事中郎索为冯翊太守
，靖之子也	索是索靖的儿子
模死，与安夷护军金城允、频阳令梁肃，俱奔安定	司马模死后，索与安夷护军金城人允、频阳县令梁肃，一起逃奔到安定
时安定太守贾疋与诸氐、羌皆送任子于汉，等遇之于阴密，拥还临泾，与疋谋兴复晋室，疋从之	当时安定太守贾疋与氐人、羌人都给汉送去了人质，索等人在阴密县遇到贾疋，簇拥着还归临泾，与贾疋商谋复兴晋朝，贾疋同意了
乃共推疋为平西将军，率众五万向长安	于是大家一起推举贾疋为平西将军，率领五万军队向长安进发
雍州刺史特、新平太守竺恢皆不降于汉，闻疋起兵，与扶风太守梁综帅众十万会之	雍州刺史特、新平太守竺恢都不向汉投降，听说贾疋起兵，就与扶风太守梁综一起率领十万军队与贾疋会合
综，肃之兄也	梁综是梁肃的哥哥
汉河内王粲在新丰，使其将刘雅、赵染攻新平，不克	汉河内王刘粲在新丰，派他的部将刘雅、赵染进攻新平，没有成功
索救新平，大小百战，雅等败退	索去救援新平，与汉军大小百余战，刘雅等人败退
中山王曜与疋等战于黄丘，曜众大败	中山王刘曜与贾疋在黄丘交战，刘曜的军队惨败
疋遂袭汉梁州刺史彭荡仲，杀之	贾疋于是袭击汉梁州刺史彭荡仲，把他杀了
特等击破粲于新丰，粲还平阳	特等人在新丰打败刘粲，刘粲还归平阳
于是疋等兵势大振，关西胡、晋翕然响应	这样，贾疋等人军威气势大振，关西地区的胡人以及晋人都纷纷响应
刘琨长于招怀而短于抚御，一日之中，虽归者数千，而去者亦相继	刘琨擅长于招揽安抚远方的人，却不擅长抚慰驾驭近处的人，一天之中，虽然归附的人有几千，但离开的人数也差不多
琨遣子遵请兵于代公猗卢，又遣族人高阳内史希合众于中山，幽州所统代郡、上谷、广宁之民多归之，众至三万	刘琨一面派儿子刘遵去向代公拓跋猗卢请求军队援助，一面又派同家族的高阳内史刘希在中山聚合部众，幽州所统辖的代郡、上谷、广宁等地的百姓大多归附刘希，部众达到三万人
王浚怒，遣燕相胡矩督诸军，与辽西公段疾陆眷共攻希，杀之，驱略三郡士女而去	王浚发怒，派燕相胡矩带领各军，与辽西公段疾陆眷一同攻打刘希，把他杀了，并且驱赶掠夺三个郡的男女后离去
疾陆眷，务勿尘之子也	段疾陆眷是段务勿尘的儿子
猗卢遣其子六将兵助琨戍新兴	拓跋猗卢派他儿子拓跋六带兵驻扎到新兴援助刘琨
春，正月，汉呼延后卒，谥曰武元	春季，正月，汉呼延皇后去世，谥号为武元
二月，壬子朔，日有食之	二月，壬子朔，出现日食
石勒筑垒于葛陂，课农造舟，将攻建业	石勒在葛陂修筑营垒，向农民征税修造舟船，打算进攻建业
琅邪王睿大集江南之众于寿春，以镇东长史纪瞻为扬威将军，都督诸军以讨之	琅邪王司马睿大规模调集江南的部队到寿春，任镇东长史纪瞻为扬威将军，统领各军队来征讨石勒
夏，四月，丙寅，征南将军山简卒	夏季，四月，丙寅，征南将军山简去世
汉主聪封其子敷为渤海王，骥为济南王，鸾为燕去，鸿为楚王，劢为齐王，权为秦王，操为魏王，持为赵王	汉主刘聪封他的儿子刘敷为渤海王，刘骥为济南王，刘鸾为燕王，刘鸿为楚王，刘劢为齐王，刘权为秦王，刘操为魏王，刘持为赵王
六月，汉主聪欲立贵嫔刘英为皇后；张太后欲立贵人张徽光，聪不得已，许之	六月，汉主刘聪打算立贵嫔刘英为皇后，而张太后要立贵人张徽光，刘聪没办法，只好同意
英寻卒	刘英不久就去世了
己卯，汉卫尉梁芬奔长安	己卯，汉的卫尉梁芬逃奔长安
代公猗卢遣其子六及兄子普根、将军卫雄、范班、箕澹帅众数万为前锋以攻晋阳，猗卢自帅众二十万继之，刘琨收散卒数千为之乡导	代公拓跋猗卢派他的儿子拓跋六修以及哥哥的儿子拓跋普根、将军卫雄、范班、箕澹带领几万军队作为前锋攻打晋阳，拓跋猗卢自己带领二十万军队跟在后面，刘琨召集了几千逃散的兵士作为拓跋六的向导
六与汉中山王曜战于汾东，曜兵败，坠马，中七创	拓跋六与汉中山王刘曜在汾东交战，刘曜的军队失败，他自己也负伤七处，掉下马
讨虏将军傅虎以马授曜，曜不受，曰：卿当乘以自免，吾创已重，自分死此	讨虏将军傅虎把自己的马交给刘曜，刘曜不接受，说：你应该骑上它突围，我伤得已很重，命该丧此
虎泣曰：虎蒙大王识拔至此，常思效命，今其时矣	傅虎哭着说：我蒙受您的赏识而被提拔到现在的地位，常常想着以自己的生命报效您，现在正是这样的时候了
且汉室初基，天下可无虎，不可无大王也	再说汉的朝廷刚刚建立，天下可以没有傅虎，而不能没有您啊
乃扶曜上马，驱令渡汾，自还战死	于是把刘曜扶上马，赶着马渡过汾水，自己又回去冲杀最后战死
曜入晋阳，夜，与大将军粲、镇北大将军丰掠晋阳之民，逾蒙山而归	刘曜进入晋阳，夜里与大将军刘粲、镇北大将军刘丰抢劫晋阳的百姓，然后翻过蒙山而撤回
十一月，猗卢追之，战于蓝谷，汉兵大败，擒刘丰，斩邢延等三千余级，伏尸数百里	十一月，拓跋猗卢追击他们的军队，在蓝谷交战，又大败汉军，擒获刘丰，杀了邢延等三千多人，尸横几百里
猗卢因大猎寿阳山，陈阅皮肉，山为之赤	拓跋猗卢因胜利而到寿阳山大规模打猎，将猎物的皮，肉摆放在山上观看，山因此而变为红色
刘琨自营门步入拜谢，固请进军	刘琨从军营门走进去拜谢拓跋猗卢，坚持请求拓跋猗卢继续进军
猗卢曰：吾不早来，致卿父母见害，诚以相愧	拓跋猗卢说：我没能早来，致使你父母被杀害，心里确实感到惭愧，现在你已收复了并州的辖境
今卿已复州境，吾远来，士马疲弊，且待后举，刘聪未可灭也	而我远道来此，兵士马匹都已疲惫，暂且等待以后再举事，刘聪不是一下子就能消灭的
遗琨马、牛、羊各千余疋，车百乘而还，留其将箕澹、段繁等戍晋阳	送给刘琨一千多匹马，牛羊各一千多头和一百辆车后回师，把部将箕澹、段繁等留下来戍守晋阳
彭仲荡之子天护帅群胡攻贾疋，天护阳不胜而走，疋追之，夜坠涧中，天护执而杀之	彭仲荡的儿子彭天护带领胡人们攻打贾疋，彭天护表面上假装失败而退走，贾疋追击，夜里掉到山涧中，彭天护把他抓住杀了
汉以天护为凉州刺史	汉让彭天护任凉州刺史
众推始平太守麴允领雍州刺史	大家推举始平太守麴允兼雍州刺史
阎鼎与京兆太守梁综争权，鼎遂杀综	阎鼎与京兆太守梁综争夺权力，阎鼎于是杀了梁综
麴允与抚夷护军索、冯太守梁肃合兵攻鼎，鼎出奔雍，为氐窦首所杀	麴允与扶夷护军索，冯太守梁肃联合兵力攻打阎鼎，阎鼎出奔雍州，被氐人窦首杀死
广平游纶、张豺拥众数万，据苑乡，受王浚假署；石勒遣夔安、支雄等七将攻之，破其外垒	广平人游纶、张豺拥有几万人，占据苑乡，王浚让他们在那儿暂时代理原官行使职权，石勒派遣夔安、支雄等七个将领攻打他们，攻破了外围的营垒
浚遣督护王昌帅诸军及辽西公段疾陆眷、疾陆眷弟匹、文鸯、从弟末部众五万攻勒于襄国	王浚派遣都护王昌率领各军，以及辽西公段疾陆眷，段疾陆眷的弟弟段匹、段文鸯、堂弟段末等人的部众五万人到襄国攻打石勒
是岁大疫	这一年，全国大肆流行传染病
王澄少与兄衍名冠海内，刘琨谓澄曰：卿形虽散朗，而内实动侠，以此处世，难得其死	王澄年轻时，名声就与哥哥王衍一起名扬海内，刘琨对王澄说：你外表虽然洒脱清朗，而内心实际易动而侠义，这样来处世，难得好死
及在荆州，悦成都内史王机，谓为己亚，使之内综心膂，外为爪牙	等王澄到荆州，喜欢成都内史王机，认为他仅次于自己，让他对内成为综理事务的心腹臂膀，对外成为得力帮手
澄屡为杜所败，望实俱损，犹傲然自得，无忧惧之意，但与机日夜纵酒博弈，由是上下离心；南平太守应詹屡谏，不听	王澄多次被杜打败，声望与实际都有所减损，但仍是傲然自得，心里没有一点忧虑惧怯，只是与王机日夜纵情喝酒对弈，因此上下都与他不一条心，南平太守应詹多次劝谏，而王澄不听
南安赤亭羌姚弋仲东徙榆眉，戎、夏襁负随之者数万，自称护羌校尉、雍州刺史、扶风公	南安赤亭羌人姚弋仲向东迁徙到榆眉，戎人、汉人携带妻儿老小跟随他的人有几万，姚弋仲自称护羌护尉、雍州刺史、扶风公
己卯，汉定襄忠穆公王彰卒	己卯，汉定襄忠穆公王彰去世
三月，汉主聪立贵嫔刘娥为皇后，为之起仪殿	三月，汉主刘聪把贵嫔刘娥立为皇后，为她建造仪殿
廷尉陈元达切谏，以为天生民而树之君，使司牧之，非以兆民之命穷一人之欲也	廷尉陈元达恳切地劝谏，认为：天生百姓而为他们树立君主，是让君主管理他们，并不是用千万百姓的生命满足一个人穷奢极欲
晋氏失德，大汉受之，苍生引领，庶几息肩	晋朝廷无道，大汉受命于天，百姓翘首以待，差不多可以稍加养息
是以光文皇帝身衣大布，居无重茵，后妃不衣锦绮，乘舆马不食粟，爱民故也	所以光文皇帝刘渊身穿粗布，居住的地方也没有双层的坐垫，皇后妃嫔也不穿绫罗绸缎，拉车的马匹不喂粟谷，这是爱惜百姓的缘故
陛下践阼以来，已作殿观四十余所，加之军旅数兴，馈运不息，饥馑、疾疫，死亡相继，而益思营缮，岂为民父母之意乎	陛下即位以来，已经建造了四十多处宫殿，加上一再兴兵作战，军粮运输不停，饥馑、疾病流行，造成人们死的死、逃的逃，但您还想大兴土木，这难道是作百姓的父母的想法吗
今有晋遗类，西据关中，南擅江表；李雄奄有巴、蜀；王浚、刘琨窥窬肘腋；石勒、曹嶷贡禀渐疏；陛下释此不忧，乃更为中宫作殿，岂目前之所急乎	现在晋朝的残余还在西边占据着关中地区，南边把持着江东地区；李雄占据着巴蜀地区；王浚、刘琨窥伺着我们的肘腋之处；石勒、曹嶷贡奉与禀告越来越少，陛下不为这一切担忧，却又在宫廷中建造殿堂，这难道是目前所急需的吗
昔太宗居治安之世，粟帛流衍，犹爱百金之费，息露台之役	过去汉文帝处于安定的社会，稻谷布帛十分丰盛，仍然珍惜百金的费用，停止修建露台的劳役
陛下承荒乱之余，所有之地，不过太宗之二郡，战守之备，非特匈奴、南越而已	陛下接受的是兵荒马乱的时代，所占有的地方，不过汉文帝时的两个郡，需要征战和防御的，也并不仅仅是匈奴、南越
而宫室之侈乃至于此，臣所以不敢不冒死而言也	而皇宫的奢侈却到了这个地步，所以我不敢不冒死来说这几句话
聪大怒曰：朕为天子，营一殿，何问汝鼠子乎，乃敢妄言沮众	刘聪勃然大怒说：朕身为天子，建造一个殿堂，为什么要问你这样的鼠辈呢
不杀此鼠子，朕殿不成	你竟敢胡说八道扰乱大家的情绪，不杀掉这个鼠辈，朕的殿堂就建不成
命左右：曳出斩之	向左右随从发出命令：拖出去杀了
并其妻子同枭首东市，使群鼠共穴	连他的妻、子一起在东市悬首示众，让这群老鼠进到一个墓穴里去
时聪在逍遥园李中堂，元达先锁腰而入，即以锁锁堂下树，呼曰：臣所言者，社稷之计，而陛下杀臣	当时刘聪在逍遥园的李中堂里，陈元达事先拿锁锁住腰进去，进去后便用锁把自己锁在堂下的树下，大声呼喊：我所说的，是为社稷大业考虑，而陛下却要杀掉我
朱云有言：臣得与龙逢、比干游，足矣	汉朝朱云说：我能够与龙逢、比干同游，这就满足了
左右曳之不能动	随从们拉不动他
汉中山王曜、司隶校尉乔智明寇长安，平西将军赵染帅众赴之，诏麴允屯黄白城以拒之	汉中山王刘曜、司隶校尉乔智明进犯长安，平西将军赵染带领军队也赶去参战，晋朝诏令麴允到黄白城去抵御
琅邪王睿以前庐江内史华谭为军谘祭酒	琅邪王司马睿任用前庐江内史华谭为军咨祭酒
谭尝在寿春依周馥	华谭曾经在寿春依附于周馥
睿谓谭曰：周祖宣何故反	司马睿对华谭说：周馥为什么反叛
谭曰：周馥虽死，天下尚有直言之士	华谭说：周馥虽然死了，天下仍还有直言之士
馥见寇贼滋蔓，欲移都以纾国难，执政不悦，兴兵讨之，馥死未逾时而洛都沦没	周馥看到强盗窃贼越来越多，想迁都来解除困难，当局不高兴，派兵征讨他，结果周馥死了还没有一个时辰，都城洛阳就沦陷了
若谓之反，不亦诬乎	如果说周馥反叛，不是冤枉吗
睿曰：馥位为征镇，握强兵，召之不入，危而不持，亦天下之罪人也	司马睿说：周馥身居征镇戍守地方的军事要职，掌握强大的兵力，朝廷召他而他不入朝，朝廷危险的时候而不能扶助，也算是天下的罪人
谭曰：然，危而不持，当与天下共受其责，非但馥也	华谭说：是这样，朝廷危险而不能扶助，他应该与全国的将领一起受到责难，不仅仅是周馥一个人
石勒攻李恽于上白，斩之	石勒在上白攻打李恽，把他杀了
王浚复以薄盛为青州刺史	王浚又任命薄盛为青州刺史
王浚使枣嵩督诸军屯易水，召段疾陆眷，欲与之共击石勒，疾陆眷不至	王浚派枣嵩督领各军在易水驻扎，召段疾陆眷，想与他一起攻打石勒，段疾陆眷不来
浚怒，以重币赂拓跋猗卢，并檄慕容等共讨疾陆眷	王浚发怒，用重金贿赂拓跋猗卢，并向慕容等人传发檄文，要共同讨伐段疾陆眷
猗卢遣右贤王六将兵会之，为疾陆眷所败	拓跋猗卢派右贤王拓跋六带领军队去与王浚会合，结果被段疾陆眷打败
遣慕容翰攻段氏，取徒河、新城，至阳乐，闻六败而还，翰因留镇徒河，壁青山	慕容派慕容翰去攻打段氏，攻取了徒河、新城，到达阳乐，听说拓跋六失败，慕容翰因此留在徒河镇守，在青山建立营垒
壬辰，以琅邪王睿为左丞相、大都督，督陕东诸军事；南阳王保为右丞相、大都督，督陕西诸军事	壬辰，朝廷以琅邪王司马睿担任左丞相、大都督，都督陕东诸军事；以南阳王司马保任右丞相、大都督，都督陕西诸军事
诏曰：今当扫除鲸鲵，奉迎梓宫	诏书说：现在应当扫除像刘聪那样的大鱼，奉迎怀帝的灵柩
令幽、并两州勒卒三十万直造平阳，右丞相宜帅秦、凉、梁、雍之师三十万径诣长安，左丞相帅所领精兵二十万径造洛阳，同赴大期，克成元勋	命令幽、并两州带领三十万兵率直接进兵平阳，右丞相应当率领秦州、凉州、梁州、雍州的军队三十万人直接到长安，左丞相率领所属的二十万精锐兵士直接到洛阳，共同奔赴约定的大业，完成伟大的功勋
汉中山王曜屯蒲坂	汉中山王刘曜在蒲坂屯兵
帝遣殿中都尉刘蜀诏左丞相睿以时进军，与乘舆会于中原	愍帝派遣殿中都尉刘蜀诏令左丞相司马睿按时进军，与皇帝的乘舆在中原相会
八月，癸亥，蜀至建康，睿辞以方平定江东，未暇北伐	八月，癸亥，刘蜀到达建康，司马睿推辞说，刚刚平定江东地区，没有余暇北伐
以镇东长史刁协为丞相左长史，从事中郎彭城刘隗为司直，邵陵内史广陵戴邈为军谘祭酒，参军丹阳张为从事中郎，尚书郎颍川雅为记室参军，谯国桓宣为舍人，豫章熊远为主簿，会稽孔愉为掾	司马睿让镇东长史刁协任丞相左长史，从事中郎彭城人刘隗任司直，邵陵内史广陵人戴邈任军咨祭酒，参军丹阳人张任从事中郎，尚书郎颍川人钟雅任记室参军，谯国人桓宣任舍人，豫章人熊远任主簿，会稽人孔愉任掾
刘隗雅习文史，善伺候睿意，故睿特亲爱之	刘隗平素熟习文史，善于体察司马睿的心意，所以司马睿特别亲近宠爱他
胡亢性猜忌，杀其骁将数人	胡亢性格猜忌多疑，因此杀了自己的骁勇部将多人
杜曾惧，潜引王冲之兵使攻亢	杜曾感到恐惧，暗自勾结王冲的军队让他们攻打胡亢
亢悉精兵出拒之，城中空虚，曾因杀亢而并其众	胡亢出动全部精锐部队阻击王冲，而城中空虚，杜曾趁机杀了胡亢，接管了他的部众
周屯浔水城，为杜所困；陶侃使明威将军朱伺救之，退保泠口	周屯兵浔水城，被杜围困，陶侃派明威将军朱伺前去救援，杜就退到泠口防卫
侃曰：必步向武昌	陶侃说：杜一定会移兵武昌
乃自径道还郡以待之，果来攻	就从近路回到郡中等待杜，杜果然来进攻了
侃使朱伺逆击，大破之，遁归长沙	陶侃派朱伺迎头痛击，大败杜，杜自己逃回长沙
周出浔水投王敦于豫章，敦留之	周离开浔水到豫章投奔王敦，王敦留下了他
陶侃使参军王贡告捷于敦，敦曰：若无陶侯，便失荆州矣	陶侃派参军王贡向王敦报捷，王敦说：如果没有陶候，就要失去荆州了
乃表侃为荆州刺史，屯沔江	于是表奏陶侃任荆州刺史，驻扎在沔江
左丞相睿召周，复以为军谘祭酒	左丞相司马睿征召周，又让他担任军咨祭酒
荀藩薨于开封	荀藩在开封去世
是岁，左丞相睿遣世子绍镇广陵，以丞相掾蔡谟为参军	这一年，左丞相司马睿派长子司马绍镇守广陵，让丞相掾蔡谟担任参军
谟，克之子也	蔡谟是蔡克的儿子
代公猗卢城盛乐以为北都，治故平城为南都；又作新平城于水之阳，使右贤王六镇之，统领南部	代公拓跋猗卢在盛乐县筑城作为北都，把旧平城作为南都，又在水的北面建新平城，派右贤王拓跋六镇守，总管南部地区事务
春，正月，辛未，有如日陨于地；又有三日相承，出西方而东行	春季，正月，辛未，有个像太阳似的东西殒落到地下，又接连出现三个太阳，从西方朝东行
丁丑，大赦	丁丑，宣布大赦
有流星出牵牛，入紫微，光烛地，坠于平阳北，化为肉，长三十步，广二十七步	有流星从牵牛星处出来，进入紫徽星座，星光照亮了地面，后坠落在平阳以北，变成肉，长三十步，宽二十七步
汉主聪恶之，以问公卿	汉主刘聪对此感到厌恶，就询问公卿大臣
陈元达以为女宠太盛，亡国之征	陈元达认为是后宫女宠太多，亡国的征兆
聪曰：此阴阳之理，何关人事	刘聪说：这是天象日月运转的道理，与人事有什么相关
聪后刘氏贤明，聪所为不道，刘氏每规正之	刘聪的皇后刘氏很贤慧明达，刘聪做得不符合道理，刘氏每次都规劝让他改正
己丑，刘氏卒，谥曰武宣	己丑，刘氏去世，谥号为武宣
自是嬖宠竞进，后宫无序矣	从此刘聪的宠女爱姬竞相争先，后宫中失去了秩序
聪置丞相等七公；又置辅汉等十六大将军，各配兵二千，以诸子为之；又置左右司隶，各领户二十余万，万户置一内史；单于左右辅，各主六夷十万落，万落置一都尉；左、右选曹尚书，并典选举	刘聪设置了丞相等七公；又设置辅汉等十六大将军，各配备二千兵士，让他的儿子们来担任；又设置左、右司隶，各辖领二十多万户，每万户设一个内史；又设置单于左右辅，各统领胡、羯、鲜卑、氐、羌、乌丸等六类共十万帐落，每一万帐落设一个都尉；设置左、右选曹尚书，共同负责选举事务
自司隶以下六官，皆位亚仆射	从司隶以下的六个官职，地位都仅次于仆射
以其子粲为丞相、领大将军、录尚书事，进封晋王	让自己的儿子刘粲担任丞相、兼大将军、录尚书事，进封为晋王
江都王延年录尚书六条事，汝阴王景为太师，王育为太傅，任为太保，马景为大司徒，朱纪为大司空，中山王曜为大司马	以江都王刘延年担任录尚书六条事，让汝阴王刘景任太师，王育任太傅，任任太保，马景任大司徒，朱纪任大司空，中山王刘曜任大司马
初，王浚以邵续为乐陵太守，屯厌次	当初，王浚以邵续任乐陵太守，驻扎在厌次县
浚败，续附于石勒，勒以续子为督护	王浚失败，邵续依附于石勒，石勒以邵续的儿子邵任督护
浚所署勃海太守东莱刘胤弃郡依续，谓续曰：凡立大攻，必杖大义	王浚所管辖的勃海太守东莱人刘胤弃职投奔邵续，对邵续说：凡是建立大功，一定要依仗大义
君，晋之忠臣，柰何从贼以自污乎	您是晋朝的忠臣，为什么顺从贼寇玷污自己呢
会段匹以书邀续同归左丞相睿，续从之	正好段匹来信邀请邵续一同投靠左丞相司马睿，邵续同意了这个邀请
其人皆曰：今弃勒归匹，其如何	他手下的人都说：现在离弃石勒而投靠段匹，那邵怎么办
续泣曰：我岂得顾子而为叛臣哉	邵续哭着说：我难道能为顾惜儿子而作叛臣吗
杀异议者数人	杀了几个持异议的人
勒闻之，杀	石勒听说后，杀了邵
续遣刘胤使江东，睿以胤为参军，以续为平原太守	邵续派遣刘胤作为使者到江东，司马睿让刘胤担任参军，任邵续为平原太守
石勒遣兵围续，匹使其弟文鸯救之，勒引去	石勒派兵包围邵续，段匹派他弟弟段文鸯救援邵续，石勒带兵离去
襄国大饥，谷二升直银一斤，肉一斤直银一两	襄国饥荒严重，二升谷子价值一斤银子，一斤肉价值一两银子
杜将王真袭陶侃于林障，侃奔滠中	杜带领王真到林障袭击陶侃，陶侃逃奔滠中
周访救侃，击兵，破之	周访救援陶侃，打败了杜的军队
秋，赵染攻北地，允拒之，染中弩而死	秋季，赵染攻打北地，遭到允阻击，赵染身中弩箭而死
石勒始命州郡阅实户口，户出帛二匹，谷二斛	石勒开始命令所据各州郡核实户口，每户征收二匹帛、二斛谷
冬，十月，以张为都督凉州诸军事、凉州刺史、西平公	冬季，十月，朝廷任张为都督凉州诸军事、凉州刺史、西平公
十一月，汉主聪以晋王粲为相国、大单于，总百揆	十一月，汉主刘聪任晋王刘粲为相国、大单于，总领文武百官
粲少有俊才，自为宰相，骄奢专恣，远贤亲佞，严刻愎谏，国人始恶之	刘粲年轻时有杰出的才能，但自从当了宰相后，骄纵奢侈独断专行，疏远贤能亲近奸诈机巧的人，严厉苛刻，一意孤行不听规劝，开始遭到国人的憎恶
诏平东将军宋哲屯华阴	朝廷诏令平东将军宋哲驻扎在华阴
成主雄立后任氏	成汉主李雄把任氏立为皇后
二月，丙子，以琅邪王睿为丞相、大都督、督中外诸军事，南阳王保为相国，荀组为太尉、领豫州牧，刘琨为司空、都督并、冀、幽三州诸军事	二月，丙子，朝廷任琅邪王司马睿为丞相、大都督、都督中外诸军事，任南阳王司马保为相国，荀组为太尉、兼豫州牧，任刘琨为司空、都督并、幽、冀三州诸军事
琨辞司空，不受	刘琨推辞司空的职务，不接受
汉大赦，改元建元	汉实行大赦，改年号为建元
汉青州刺史曹嶷尽得齐、鲁间郡县，自镇临,有众十余万，临河置戍	汉青州刺史曹嶷夺取了齐、鲁地区的全部郡县，自己镇守临，有十多万军队，沿黄河安排戍守
石勒表称：嶷有专据东方之志，请讨之	石勒上奏表说：曹嶷有独据东方的想法，请去征讨他
汉主聪恐勒灭嶷，不可复制，弗许	汉主刘聪担心石勒消灭了曹嶷，不能再控制石勒，因此不同意
夏，四月，大赦	夏季，四月，晋朝宣布大赦
辛巳，大赦	辛巳，宣布大赦
汉大司马曜攻上党，八月，癸亥，败刘琨之众于襄垣	汉大司马刘曜攻打上党，八月，癸亥，在襄垣打败刘琨的军队
曜欲进攻阳曲，汉主聪遣使谓之曰：长安未平，宜以为先	刘曜想进攻阳曲，汉主刘聪派使者对他说：长安还没有平定，应当把攻长安放在前面
曜乃远屯蒲坂	刘曜就回到蒲坂驻扎
初，朝廷闻张光死，以侍中第五猗为安南将军，监荆・梁・益・宁四州诸军事、荆州刺史，自武关出	当初，朝廷听说张光死了，就命侍中第五猗担任安南将军，监荆、梁、益、宁四州诸军事，荆州刺史，从武关出行
杜曾迎猗于襄阳，为兄子娶猗女，遂聚兵万人，与猗分据汉、沔	杜曾到襄阳迎接第五猗，并为哥哥的儿子娶了第五猗的女儿，于是聚集了军队一万人，与第五猗分别占据汉水、沔水地区
王敦嬖人吴兴钱凤，疾陶侃之功，屡毁之	王敦所宠信的吴兴人钱凤，嫉妒陶侃的功劳，多次诋毁陶侃
侃将还江陵，欲诣敦自陈	陶侃将要回江陵，想到王敦那儿去陈说解释
朱伺及安定皇甫方回谏曰：公入必不出	朱伺和安定人皇甫方回劝谏说：您进去以后就会出不来了
侃不从	陶侃不听
既至，敦留侃不遣，左转广州刺史，以其从弟丞相军谘祭酒为荆州刺史	到了以后，王敦果然扣留住陶侃不放，后来王敦让他降职担任广州刺史，而派自己的堂弟丞相军谘祭酒王任荆州刺史
荆州将吏郑攀、马隽等诣敦，上书留侃，敦怒，不许	荆州的武将官吏郑攀、马隽等拜访王敦，给王敦上书，挽留陶侃，王敦发怒，不同意
攀等以侃始灭大贼，而更被黜，众情愤惋；又以忌戾难事，遂帅其徒三千人屯口，西迎杜曾	郑攀等人因为陶侃刚刚消灭了大贼寇，却反而被贬黜，大家群情激愤；又因为王猜忌暴戾难以共事，郑攀于是率领部众三千人到口驻扎，向西迎接杜曾
为攀等所袭，奔于江安	王遭到郑攀等人的袭击，投奔到江安县
杜曾与攀等北迎第五猗以拒	杜曾与郑攀等人又向北迎接第五猗来抵御王
督诸军讨曾，复为曾所败	王督率各支军队讨伐杜曾，又被杜曾打败
敦意攀承侃风旨，被甲持矛将杀侃，出而复还者数四	王敦猜测郑攀是接受了陶侃暗中劝告的旨意，就身披铠甲手持长矛将要杀陶侃，把陶侃押出来又带进去，来回四次
侃正色曰：使君雄断，当裁天下，何此不决乎	陶侃表情严肃地说：您雄才大略善于决断，应该能够决断天下的大事，为什么这样犹豫不决呢
因起如厕	说完就站起来向厕所走去
谘议参军梅陶、长史陈颁言于敦曰：周访与侃亲姻，如左右手，安有断人左手而右手不应者乎	咨议参军梅陶、长史陈颁对王敦说：周访与陶侃是姻亲，就像左右手，哪里有截断人的左手而他的右手没有反应的呢
敦意解，乃设盛馔以饯之，侃便夜发，敦引其子瞻为参军	王敦于是放弃了猜测，就安排丰盛的宴席为陶侃饯行，陶侃便连夜出发，王敦提拔他的儿子陶瞻担任参军
九月，汉主聪使大鸿胪赐石勒弓矢，策命勒为陕东伯，得专征伐，拜刺史、将军、守宰，封列侯，岁尽集上	九月，汉主刘聪派遣大鸿胪给石勒赏赐弓箭，用策书封石勒为陕东伯，可以独立自行征战讨伐，任命刺史、将军、郡守县令、分封列侯，到年底时再集中上报
汉大司马曜寇北地，诏以允为大都督、骠骑将军以御之	汉大司马刘曜进犯北地郡，晋朝诏令命允担任大都督、骠骑将军，抵御刘曜
冬，十月，以索为尚书仆射、都督宫城诸军事	冬季，十月，晋朝以索担任尚书左仆射、都督宫城诸军事
曜进拔冯翊，太守梁肃奔万年	刘曜进军攻取了冯翊，太守梁肃逃奔到万年县
曜转寇上郡	刘曜转而进犯上郡
允去黄白城，军于灵武，以兵弱，不敢进	允离开黄白城，到灵武驻军，因为兵力微弱，不敢冒然前进
凉州军士张冰得玺，文曰皇帝行玺，献于张，僚属皆贺	凉州军士张冰拾得一方印玺，印文是皇帝行玺，献给了张，僚属们都来祝贺
曰：是非人臣所得留	张说：这不是作臣下的所能留存的
遣使归于长安	派使者送到长安
春，正月，司徒梁芬议追尊吴王晏，右仆射索等引魏明帝诏以为不可；乃赠太保，谥曰孝	春季，正月，司徒梁芬提议追封吴王司马晏尊号，右仆射索等人引用魏明帝的诏书为例，认为不能这样，于是追赠为太保，谥号为孝
初，代王猗卢爱其少子比延，欲以为嗣，使长子六出居新平城，而黜其母	当初，代王拓跋猗卢偏爱小儿子拓跋比延，想让他作为继承人，便让长子拓跋六出去居住在新平城，并废黜了他的母亲
六有骏马，日行五百里，猗卢夺之，以与比延	拓跋六有骏马，能日行五百里，拓跋猗卢便把马要过来送给拓跋比延
六来朝，猗卢使拜比延，六不从	拓跋六来朝见，拓跋猗卢让他给拓跋比延行礼，拓跋六不答应
猗卢乃坐比延于其步辇，使人导从出游	拓跋猗卢于是让拓跋比延乘坐自己辇乘，派人当先导和随从，出去巡游
六望见，以为猗卢，伏谒路左；至，乃比延，六惭怒而去	拓跋六远远看见，还以为是拓跋猗卢，便在路左边伏首拜谒，来了一看，原来是拓跋比延，拓跋六羞惭愤怒地扬长而去
猗卢召之不至，大怒，帅众讨之，为六所败	拓跋猗卢宣召他而不来，勃然大怒，率领军队讨伐拓跋六，结果被拓跋六打败
猗卢微服逃民间，有贱妇人识之，遂为六所弑	拓跋猗卢穿上百姓的衣服逃到百姓中，有一个贫贱的妇人认出了他，于是被拓跋六杀了
拓跋普根先守外境，闻难来赴，攻六，灭之	拓跋普根原先在外面镇守，听说后便来赴难，攻打拓跋六，把他消灭了
宁州刺史王逊，严猛喜诛杀	宁州刺史王逊，严厉凶猛喜好杀人
五月，平夷太守雷、平乐太守董霸帅三千余余家叛，降于成	五月，平夷太守雷、平乐太守董霸，带领三千多人家叛离，向成汉投降
六月，丁巳朔，日有食之	六月，丁巳朔，出现日食
八月，汉大司马曜逼长安	八月，汉大司马刘曜进逼长安
石勒围乐平太守韩据于坫城，据请救于刘琨	石勒在坫城围攻乐平太守韩据，韩据向刘琨请求救援
琨新得拓跋猗卢之众，欲因其锐气以讨勒	刘琨刚刚得到拓跋猗卢的军队，想靠着这支军队的锐气来讨伐石勒
箕澹、卫雄谏曰：此虽晋民，久沦异域，未习明公之恩信，恐其难用	箕澹、卫雄劝谏说：这些人虽然是晋朝的百姓，但长时间沦落在异族地区，不了解您的恩德信义，恐怕他们难以使用
不若且内收鲜卑之余谷，外抄胡贼之牛羊，闭关守险，务农息兵，待其服化感义，然后用之，则功无不济矣	不如暂且在内收取鲜卑人的剩余谷物，在外抢夺胡人贼寇的牛羊，关闭关卡守住险要之地，开展农业生产，停止军事行动，等待拓跋猗卢的军队受到信义的教化感召，然后使用他们，那么功业没有不完成的
琨不从，悉发其众，命澹帅步骑二万为前驱，琨屯广牧，为之声援	刘琨不接受，把这些人全部调遣出去，命令箕澹率领二万步兵、骑兵作为前锋，刘琨驻扎在广牧，为他们声援
十二月，乙卯朔，日有食之	十二月，乙卯朔，发生日食
司空长史李弘以并州降石勒	司空长史李弘率并州向石勒投降
刘琨进退失据，不知所为，段匹遣信邀之，己未，琨帅众从飞狐奔蓟	这样刘琨失去据点进退两难，不知所措，段匹派使者邀请他，己未，刘琨率领部众从飞狐奔往蓟城
匹见琨，甚相亲重，与之结婚，约为兄弟	段匹见了刘琨，非常亲近敬重，与他联姻，并结拜为兄弟
勒分徙阳曲、乐平民于襄国，置守宰而还	石勒分别迁徙阳曲、乐平的百姓到襄国，安排了郡守县令等地方长官而回师
丞相睿以邵续为冀州刺史	丞相司马睿以邵续担任冀州刺史
续女婿广平刘遐聚众河、济之间，睿以遐为平原内史	邵续的女婿广平人刘遐在河、济地区聚集了一些人马，司马睿就让刘遐担任平原内史
托跋普根之子又卒，国人立其从父郁律	拓跋普根的儿子又去世了，国人又把他的叔父拓跋郁律立为首领
春，正月，汉兵东略弘农，太守宋哲奔江东	春季，正月，汉军向东进攻弘农郡，太守宋哲逃奔江东
五月，壬午，日有食之	五月，壬午，发生日食
汉主聪立晋王粲为皇太子，领相国、大单于，总摄朝政如故	汉主刘聪立晋王刘粲为皇太子，领相国职务、大单于称号，总摄朝政一如往昔
大赦	实行大赦
段匹推刘琨为大都督，檄其兄辽西公疾陆眷及叔父涉复辰、弟末等会于固安，共讨石勒	段匹推举刘琨为大都督，用檄书邀请其兄长辽西公疾陆眷、叔父涉复辰、弟段末等在固安聚会，共同征讨石勒
末说疾陆眷、涉复辰曰：以父兄而从子弟，耻也；且幸而有功，匹独收之，吾属何有哉	段末游说疾陆眷、涉复辰说：以父辈、兄长的身份追从子侄、兄弟，是一种耻辱；况且侥幸立功，段匹独收其利，我们能得到什么
各引兵还	于是疾陆眷、涉复辰、段末各自领军退还
琨、匹不能独留，亦还蓟	刘琨、段匹不能单独留守固安，也回师蓟州
以荀组为司徒	晋王任荀组为司徒
八月，汉赵固袭卫将军华荟于临颍，杀之	八月，汉将赵固在临颍击杀卫将军华荟
郑攀等相与拒王，众心不一，散还横桑口，欲入杜曾	郑攀等人共同抗拒王，因众心不齐，退散至横桑，打算投靠杜曾
王敦遣武昌太守赵诱、襄阳太守朱轨击之，攀等惧，请降	王敦派遣武昌太守赵诱、襄阳太守朱轨率军攻击，郑攀等人畏惧，请求归降
杜曾亦请击第五猗于襄阳以自赎	杜曾也自请袭击襄阳第五猗的军队，以赎其罪
冬，十月，丁未，琅邪王裒薨	冬季，十月，丁未，琅邪王司马裒去世
十一月，己酉朔，日有食之	十一月，己酉朔，出现日食
丁卯，以刘琨为侍中、太尉	丁卯，晋王任命刘琨为侍中、太尉
汉主聪出畋，以愍帝行车骑将军，戎服执戟前导	汉主刘聪出猎，让已经投降的西晋愍帝权充车骑将军，穿上军服手持画戟作为先导
见者指之曰：此故长安天子也	看见的人指着他说：这就是过去在长安的皇帝
聚而观之，故老有泣者	众人聚集观望，西晋遗老有的潸然泪下
太子粲言于聪曰：昔周武王岂乐杀纣乎	太子刘粲对刘聪说：古时周武王怎会以杀商纣为乐事呢
正恐同恶相求，为患故也	只是惟恐恶人聚集其身边，酿成祸患
今兴兵聚众者，皆以子业为名，不如早除之	现在聚众起兵之人，莫不以降帝司马邺之名相号召，不如早些除掉他
聪曰：吾前杀庾珉辈，而民心犹如是，吾未忍复杀也，且小观之	刘聪说：当年我虽杀了庾珉、王隽及晋怀帝等人，但民心仍然如此，我不忍再杀司马邺，暂且观察一段时间
十二月，聪飨群臣于光极殿，使愍帝行酒洗爵；已而更衣，又使之执盖	十二月，刘聪在光极殿大宴群臣，让愍帝斟酒洗杯，又让他拿盖
晋臣多涕泣，有失声者	晋旧臣见了，不少人潸然泪下，有的甚至哭出了声
尚书郎陇西辛宾起，抱帝大哭，聪命引出，斩之	尚书郎陇西人辛宾起身，抱着愍帝大哭，刘聪令人将他带出斩首
是岁，王命课督农功，二千石、长吏以入谷多少为殿最，诸军各自佃作，即以为禀	这年，晋王下令考核、督促农业生产，俸禄二千石的官员、长官依据交纳谷物的数量多少考评政绩高下，各地驻军各自耕作，所获充当军队给养
汉螽斯则百堂灾，烧杀汉主聪之子会稽王康等二十一人	汉国螽斯则百堂发生火灾，烧死汉主刘聪的儿子会稽王刘康等二十一人
聪以其子济南王骥为大将军、都督中外诸军事、录尚书，齐王劢为大司徒	刘聪任命其子济南王刘骥为大将军、都督中外诸军事、录尚书，任命齐王刘劢为大司徒
夏，四月，丁丑朔，日有食之	夏季，四月，丁丑朔，出现日食
加王敦江州牧，王导骠骑大将军、开府仪同三司	元帝加任王敦为江州牧，王导为骠骑大将军、开府仪同三司
成丞相范长生卒；成主雄以长生子侍中贲为丞相	成汉丞相范长生故去，成汉主李雄任命其子侍中范贲为丞相
长生博学，多艺能，年近百岁，蜀人奉之如神	范长生博学多能，享年近百岁，蜀地人民尊奉他有如神灵
汉中常侍王沈养女有美色，汉主聪立以为左皇后	汉国中常侍王沈的养女容颜美丽，汉主刘聪立她为左皇后
尚书令王鉴、中书监崔懿之、中书令曹恂谏曰：臣闻王者立后，比德乾坤，生承宗庙，没配后土，必择世德名宗，幽闲令淑，乃副四海之望，称神祗之心	尚书令王鉴、中书监崔懿之、中书令曹恂进谏说：臣听说帝王册立王后，效法乾坤相配之理，在世时承嗣宗庙祭祀，去世后配祀土神，必须选择道德传家、名门显族的女子，本人也应幽闲贤淑，才能与四海之民的期望相称，使神祗满意
孝成帝以赵飞燕为后，使继嗣绝灭，社稷为墟，此前鉴也	汉成帝立赵飞燕为皇后，结果使子嗣灭绝，社稷毁为废墟，这是前代的教训
自麟嘉以来，中宫之位，不以德举	本期从麟嘉年间开始，选立皇后不以道德为准绳
借使沈之弟女，刑余小丑，犹不可以尘污椒房，况其有婢邪	即便是王沈的妹妹或亲女儿，也不过如同阉宦丑类，尚且不能让她们沾污后妃之位，更何况王沈的婢女呢
六宫妃嫔，皆公子公孙，奈何一旦以婢主之	君王六宫的嫔妃，都是王公贵胄的子孙，怎能轻率地让婢女做她们的主人
臣恐非国家之福也	臣恐怕这不是国家的福兆
聪大怒，使中常侍宣怀谓太子粲曰：鉴等小子，狂言侮慢，无复君臣上下之礼，其速考实	刘聪大为生气，让中常侍宣怀对太子刘粲说：王鉴这帮小子，口出狂言，侮慢尊上，不再有君臣上下的礼节，望从速定罪
于是收鉴等送市，皆斩之	于是收捕王鉴等人送往刑场斩首
金紫光禄大夫王延驰，将入谏，门者弗通	金紫光禄大夫王延骑马赶来，要进宫规谏，守门者不给通报
戊戌，封皇子为武陵王	戊戌，元帝封皇子司马为武陵王
十一月，乙卯，日夜出，高三丈	十一月，乙卯，夜间出现太阳，高三丈
彭城内史周抚杀沛国内史周默，以其众降石勒	彭城内史周抚杀沛国内史周默，率其部众投降石勒
诏下邳内史刘遐领彭城内史，与徐州刺史蔡豹、泰山太守徐龛共讨之	晋元帝下诏令下邳内史刘遐兼任彭城内史职，和徐州刺史蔡豹、泰山太守徐龛共同讨伐他
豹，质之玄孙也	蔡豹是蔡质的玄孙
春，二月，刘遐，徐龛击周抚于寒山，破斩之	春季，二月，刘遐、徐龛在寒山攻击周抚，攻破并杀死周抚
初，掖人苏峻帅乡里数千家结垒以自保，远近多附之	当初，掖县人苏峻率领乡里数千家民众营造壁垒自保，远近民众大多附从
曹嶷恶其强，将攻之，峻率众浮海来奔	曹嶷恨苏峻势力强大，准备攻击他，苏峻率部众渡海投奔东晋
帝以峻为鹰扬将军，助刘遐讨周抚有功；诏以遐为临淮太守，峻为淮陵内史	元帝任苏峻为鹰扬将军，因为帮助刘遐讨伐周抚有功，下诏任刘遐为临淮太守，苏浚为淮陵内史
石勒遣左长史王献捷于汉，汉主曜遣兼司徒郭汜授勒太宰、领大将军，进爵赵王，加殊礼，出警入跸，如曹公辅汉故事；拜王及其副刘茂皆为将军，封列侯	石勒派左长史王向汉主献俘告捷，汉主刘曜派兼司徒郭汜授石勒为太宰、领大将军，晋升爵位为赵王，给予特殊礼遇，出入宫禁，如同曹操辅佐汉室的旧制
舍人曹平乐从至粟邑，因留仕汉，言于曜曰：大司马遣等来，外表至诚，内觇大驾强弱，俟其复命，将袭乘舆	拜王和他的副将刘茂为将军，封为列侯
时汉兵实疲弊，曜信之	王的舍人曹平乐随从王到粟邑，顺势留在汉国做官，他对刘曜说：大司马石勒派王等人前来，外表至为忠诚，实则是窥察您的强弱，等他回去报告后，将要袭击您
乃追汜还，斩于市	当时汉军的确疲敝，刘曜相信了曹平乐所言，于是命人追回郭汜，在街市上杀了王
三月，勒还至襄国	三月，石勒回到襄国
刘茂逃归，言死状	刘茂逃回，告知王死的情况，石勒大怒，说：孤侍奉刘氏，已经超过了臣下该尽的本职
勒大怒曰：孤事刘氏，于人臣之职有加矣	刘氏的基业，都是我所创下的
彼之基业，皆孤所为，今既得志，还欲相图	现在他志得意满，却反过来想算计我
赵王、赵帝，孤自为之，何待于彼邪	赵王、赵帝，孤自己就能做，哪里还要等他呢
乃诛曹平乐三族	于是诛杀曹平乐三族
周抚之败走也，徐龛部将于药追斩之；及朝廷论功，而刘遐先之	周抚败逃时，是徐龛的部将于药追上并杀了周抚，等到朝廷论功时，却是刘遐占先
龛怒，以泰山叛，降石勒，自称兖州刺史	徐龛生气，占据泰山背叛，投降石勒，自称兖州刺史
南阳王保自称晋王，改元建康，置百官，以张为征西大将军、开府仪同三司	南阳王司马保自称晋王，改年号为建康，设置百官，任张为征西大将军，开府仪同三司
陈安自称秦州刺史，降于汉，又降于成	陈安自称秦州刺史，投降汉，后又投降成汉
上大饥，士众困迫，张春奉保之南安祁山	上发生严重饥荒，士民困迫，张春侍奉司马保去南安的祁山
遣韩璞帅步骑五千救之；陈安退保绵诸，保归上	张派遣韩璞率领步、骑兵五千救援司马保，陈安退守绵诸，司马保回到上
未几，保复为安所逼，遣其将宋毅救之，安乃退	不久，司马保又被陈安进逼，张派部将宋毅救援，陈安才退军
江东大饥，诏百官各上封事	江南发生严重饥荒，元帝下诏让百官各自上书奏事
益州刺史应詹上疏曰：元康以来，贱《经》尚道，以玄虚弘放为夷达，以儒术清俭为鄙俗，宜崇奖儒官，以新俗化	益州刺史应詹上疏说：自元康年间以来，轻视经典，崇尚道学，把玄虚弘放视作平达，把儒术、清俭看作鄙俗，应当尊崇和奖掖儒官，来革新风俗教化
祖逖攻陈川于蓬关，石勒遣石虎将兵五万救之，战于浚仪，逖兵败，退屯梁国	祖逖在蓬关进攻陈川，石勒派石虎率兵五万救援，两军在浚仪交战，祖逖兵败，退军驻屯梁国
勒又遣桃豹将兵至蓬关，逖退屯淮南	石勒又派桃豹率兵到达蓬关，祖逖退守淮南
虎徙川部众五千户于襄国，留豹守川故城	石虎将陈川部众五千户迁徙到襄国，留下石豹守卫陈川故城
石勒遣石虎击鲜卑日六延于朔方，大破之，斩首二万级，俘虏三万余人	石勒派遣石虎在朔方重创鲜卑族日六延，斩首二万，俘虏三万多人
孔苌攻幽州诸郡，悉取之	孔苌攻取了幽州诸郡
段匹士众饥散，欲移保上谷，代王郁律勒兵将击之，匹弃妻子奔乐陵，依邵续	段匹的士众因饥饿离散，段匹想移军保守上谷，代王郁律领兵准备攻击他，段匹丢弃妻子儿女逃奔乐陵，依附邵续
曹嶷遣使赂石勒，请以河为境，勒许之	曹嶷派使者给石勒送去财物，请求以黄河作为分界，石勒答应了
徐龛寇掠济、岱，破东莞	徐龛寇掠济水、泰山之间，攻破东莞
帝问将帅可以讨龛者于王导，导以为太子左卫率泰山羊鉴，龛之州里冠族，必能制之	元帝向王导询问将帅中有谁能够征讨徐龛，王导认为太子左卫率泰山人羊鉴，是徐龛州里的显贵豪族，必能制服徐龛
鉴深辞，才非将帅；郗鉴亦表鉴非才，不可使；导不从	羊鉴恳切地推辞，认为自己不是将帅之才；郗鉴也上表认为羊鉴不是合适的人选，不能委派，王导不听
秋，八月，以羊鉴为征虏将军、征讨都督，督徐州刺史蔡豹、临淮太守刘遐、鲜卑段文鸯等讨之	秋季，八月，任羊鉴为征虏将军、征讨都督，总领徐州刺史蔡豹、临淮太守刘遐、鲜卑部段文鸯等讨伐徐龛
冬，石勒左、右长史张敬、张宾，左、右司马张屈六、程遐等劝勒称尊号，勒不许	冬季，石勒的左、右长史张敬、张宾，左、右司马张屈六、程遐等劝石勒称皇帝尊号，石勒不同意
十一月，将佐等复请勒称大将军、大单于、领冀州牧、赵王，依汉昭烈在蜀、魏武在邺故事，以河内等二十四郡为赵国，太守皆为内史，准禹贡，复冀州之境，以大单于镇抚百蛮，罢并、朔、司三州，通置部司以监之；勒许之	十一月，将佐们又请求石勒称大将军、大单于、领冀州牧、赵王，依照蜀汉昭烈帝刘备在蜀、魏武帝曹操在邺的旧例，以河内等二十四郡为赵国，太守都改为内史，根据《尚书・禹贡》，恢复冀州的行政区划，以大单于的身份镇抚众蛮族；撤销并州、朔州、司州的建置，合置部司监管，石勒同意了
戊寅，即赵王位，大赦；依春秋时列国称元年	戊寅，石勒即后赵王位，大赦天下，依照春秋时列国旧例称元年
十二月，乙亥，大赦	十二月，乙亥，东晋大赦天下
是岁，蒲洪降赵，赵主曜以洪为率义侯	这年，蒲洪投降前赵，前赵主刘曜封蒲洪为率义侯
春，正月，曜攻陈仓，王连战死，杨曼奔南氐	春季，正月，刘曜进攻陈仓，王连战死，杨曼逃奔南氐
曜进拔草壁，路松多奔陇城；又拔阴密	刘曜进而攻取草壁，路松多逃往陇城
晋王保惧，迁于桑城	刘曜又攻取阴密，晋王司马保恐惧，迂都于桑城
曜还长安，以刘雅为大司徒	刘曜回到长安，任刘雅为大司徒
赵将尹安、宋始、宋恕、赵慎四军屯洛阳，叛，降后赵	前赵将军尹安、宋始、宋恕、赵慎的四支军队驻屯洛阳，叛国投降后赵
后赵将石生引兵赴之；安等复叛，降司州刺史李矩	后赵将领石生率军前往洛阳，尹安等人又背叛后赵，向晋的司州刺史李矩投降
矩使颍川太守郭默将兵入洛	李矩让颍川太守郭默带兵进入洛阳
石生虏宋始一军，北渡河	石生俘获宋始这支军队，向北渡过黄河
于是河南之民皆相帅归矩，洛阳遂空	于是黄河以南的民众都相互牵引归附李矩，洛阳城为之一空
闰月，以周为尚书左仆射	闰月，晋任周为尚书左仆射
羊鉴讨徐龛，顿兵下邳，不敢前	羊鉴征讨徐龛，在下邳停兵，不敢前进
蔡豹败龛于檀丘，龛求救于后赵	蔡豹在檀丘击败徐龛，徐龛向后赵求救
后赵王勒遣其将王伏都救之，又使张敬将兵为之后继	后赵王石勒派部将王伏都救援，又让张敬率军作为后援
勒多所邀求，而伏都淫暴，龛患之	石勒向徐龛多有索求，而王伏都又淫荡残暴，徐龛为之忧患
张敬至东平，龛疑其袭己，乃斩伏都等三百余人，复来请降	张敬部到达东平，徐龛怀疑他是来袭击自己，于是将王伏都等三百多人斩首，又向东晋请降
勒大怒，命张敬据险以守之	石勒勃然大怒，命令张敬占据险要地形固守
帝亦恶龛反覆，不受其降，敕鉴、豹以时进讨	元帝也憎恶徐龛反覆无常，不接受他的请降，敕令羊鉴、蔡豹按原计划进发征讨
鉴犹疑惮不进，尚书令刁协劾奏鉴，免死除名，以蔡豹代领其兵	羊鉴仍然疑虑、忌惮，停止不前，尚书令刁协上疏弹劾羊鉴，敕令免除职务，饶其不死，让蔡豹代为指挥军队
王导以所举失人，乞自贬，帝不许	王导因为自己荐举的人选不当，自请贬职，元帝不同意
六月，后赵孔苌攻段匹，恃胜而不设备，段文鸯袭击，大破之	六月，后赵孔苌进攻段匹，恃仗取得的胜利便不再防备，段文鸯趁势攻击，孔苌大败
丙辰，赵将解虎及长水校尉尹车谋反，与巴酋句徐、厍彭等相结；事觉，虎、车皆伏诛	丙辰，前赵将领解虎和长水校尉尹车谋反，与巴族酋长句徐、厍彭等人相勾结，事发后，解虎、尹车都被处决
赵主曜囚徐、彭等五十余人于阿房，将杀之；光禄大夫游子远谏曰：圣王用刑，惟诛元恶而已，不宜多杀	前赵主刘曜将句徐、厍彭等五十多人囚禁在阿房，准备统统杀掉
争之，叩头流血	光禄大夫游子远进谏说：圣贤的君主施用刑罚，只不过诛杀元凶而已，不宜滥杀
曜怒，以为助逆而囚之；尽杀徐、彭等，尸诸市十日，乃投于水	为此直言诤谏，以至叩头流血
于是巴众尽反，推巴酋句渠知为主，自称大秦，改元曰平赵	刘曜发怒，认为这是帮助叛逆因而把游子远囚禁起来，尽杀句徐、厍彭等五十多人，暴尸于街市达十天，然后将尸首投弃水中
四山氐、羌、巴、羯应之者三十余万，关中大乱，城门昼闭	于是巴族民众都起来造反，推举巴族酋长句渠知为首，自称大秦，改年号为平赵
子远又从狱中上表谏争，曜手毁其表曰：大荔奴，不忧命在须臾，犹敢如此，嫌死晚邪	四山的氐族、羌族、巴族、羯族人有三十多万群起响应，关中因此大乱，城门白天也关闭
叱左右速杀之	游子远又从狱中上表诤谏，刘曜撕毁表文说：这个大荔的奴仆，不担忧自己命在须臾，还敢如此，是嫌死得晚吗
中山王雅、郭汜、朱纪、呼延晏等谏曰：子远幽囚，祸在不测，犹不忘谏争，忠之至也	叱令手下人立即杀掉他
陛下纵不能用，奈何杀之	中山王刘雅、郭汜、朱纪、呼延晏等人规谏说：游子远遭幽禁，朝不保夕，依然不忘诤谏，这是最大的忠贞
若子远朝诛，臣等亦当夕死，以彰陛下之过	陛下即使不能听用其言，又怎么能杀他呢
天下将皆舍陛下而去，陛下谁与居乎	如果游子远早上被杀死，我们也当在晚上死去，以此显示陛下的过错，这样天下人都将舍弃陛下而离去，陛下与谁为伍呢
曜意解，乃赦之	刘曜怒意缓和，于是赦免了游子远
八月，辛未，梁州刺史周访卒	八月，辛未，梁州刺史周访去世
访善于抚士，众皆为致死	周访善于抚慰军士，大家都愿为他效命
知王敦有不臣之心，私常切齿，敦由是终访之世，未敢为逆	周访知道王敦有不甘为臣的心志，私下经常切齿为恨，王敦因此在周访活着的时候，一直不敢反叛
敦遣从事中郎郭舒监襄阳军，帝以湘州刺史甘卓为梁州刺史，督沔北诸军事，镇襄阳	王敦派遣从事中郎郭舒到襄阳监察军队，元帝让湘州刺史甘卓为梁州刺史，总领沔水以北地区所有军事事务，镇守襄阳
舒既还，帝征为左丞；敦留不遣	郭舒回去后，元帝征召他任右丞，王敦却留住不放行
后赵王勒遣中山公虎帅步骑四万击徐龛，龛送妻子为质，乞降，勒许之	后赵王石勒派遣中山公石虎率步兵、骑兵四万攻击徐龛，徐龛把妻子、儿子送到后赵为人质，乞求投降，石勒答应了
蔡豹屯卞城，石虎将击之，豹退守下邳，为徐龛所败	蔡豹屯军于卞城，石虎准备攻击他，蔡豹退守到下邳，被徐龛击败
虎引兵城封丘而旋，徙士族三百家置襄国崇仁里，置公族大夫以领之	石虎率领军队在封丘修建城堡，然后回军，迁徙三百家士族安置在襄国的崇仁里，设置了公族大夫来统领他们
西平公张茂立兄子骏为世子	西平公张茂立兄长张的儿子张骏为世子
蔡豹既败，将诣建康归罪，北中郎将王舒止之	蔡豹战败之后，准备到建康领受罪责，被北中郎将王舒制止
帝闻豹退，遣使收之	元帝听说蔡豹退还不来，派使者前去拘捕他
舒夜以兵围豹，豹以为他寇，帅麾下击之，闻有诏，乃止	王舒夜间派兵包围蔡豹，蔡豹以为是别的敌寇，率领麾下士兵攻击，听说有元帝诏书，这才停止
舒执豹送建康，冬，十月，丙辰，斩之	王舒抓住蔡豹送到建康，冬季，十月，丙辰，蔡豹被斩首
王敦杀武陵内史向硕	王敦杀死武陵内史向硕
高句丽寇辽东，慕容仁与战，大破之，自是不敢犯仁境	高句丽进犯辽东，慕容仁与他们作战，大败来犯之敌，高句丽从此不敢侵犯慕容仁的边境
春，二月，徐龛复请降	春季，二月，徐龛再次向东晋请降
五月，庚申，诏免中州良民遭难为扬州诸郡僮客者，以备征役	五月，庚申，中州的良民因为战乱，有不少沦为扬州诸郡豪强士族的家僮、佃客，元帝下诏免除他们的奴仆身份，准备战争时征召服役
尚令刁协之谋也，由是众益怨之	这是尚书令刁协的主意，因此豪门士族都更怨恨他
终南山崩	终南山出现山崩
八月，常山崩	八月，常山山崩
十一月，皇孙衍生	十一月，皇孙司马衍出生
十二月，以慕容为都督幽・平二州・东夷诸军事、车骑将军、平州牧，封辽东公，单于如故，遣谒者即授印绶，听承制置官司守宰	十二月，元帝任命慕容为都督幽州、平州、东夷诸军事及车骑将军、平州牧，封为辽东公，仍旧保留单于的称号，派遣谒者当即授予印绶，允许他秉承皇帝旨意设置官府机构、委任官员
于是备置僚属，以裴嶷、游邃为长史，裴开为司马，韩寿为别驾，阳耽为军谘祭酒，崔焘为主簿，黄泓、郑林参军事	慕容于是配置了完备的僚属，任用裴嶷、游邃为长史，裴开为司马，韩寿为别驾，阳耽为军谘祭酒，崔焘为主簿，黄泓、郑林参与军事
立子为世子	慕容又立儿子慕容为世子，并建造学舍，让平原人刘出任祭酒，让慕容和学子们一块从师学习
作东横，以平原刘赞为祭酒，使与诸生同受业，得暇，亦亲临听之	慕容闲暇时，自己也前来听讲
雄毅多权略，喜经术，国人称之	慕容性格勇敢坚定，处事颇多权略，爱好研习经义，受到国人的称赞
徙慕容翰镇辽东，慕容仁镇平郭	慕容调慕容翰镇守辽东，让慕容仁镇守平郭
翰抚安民夷，甚有威惠；仁亦次之	慕容翰安顿、抚慰百姓和胡夷，恩威并重；慕容仁也追随效仿他
春，正月，郭璞复上疏，请因皇孙生，下赦令，帝从之	春季，正月，郭璞再次上疏，请求以元帝皇孙司马衍出世为契机，颁布赦免令，元帝允准
乙卯，大赦，改元	乙卯，大赦天下罪犯，改年号为永昌
二月，甲午，封皇子昱为为琅邪王	二月，甲午，元帝封皇子司马昱为琅邪王
帝征戴渊、刘隗入卫建康	元帝征召戴渊、刘隗来建康参与防卫
隗至，百官迎于道，隗岸帻大言，意气自若	刘隗到达之时，百官们在道路上迎接，刘隗把头帻掀起露出前额，高谈阔论，意气昂扬
及入见，与刁协劝帝尽诛王氏；帝不许，隗始有惧色	等到入见元帝，和刁协一起劝元帝将王氏宗族尽数诛杀，元帝不同意，刘隗才显露出畏惧的神色
甲午，前赵羊后卒，谥曰献文	甲午，前赵的羊后去世，谥号献文
甘卓家人皆劝卓备王敦，卓不从，悉散兵佃作，闻谏，辄怒	甘卓的家人都劝甘卓防备王敦，甘卓不听，把兵众悉数遣散从事佃作，一听到有人谏诤就发怒
襄阳太守周虑密承敦意，诈言湖中多鱼，劝卓遣左右悉出捕鱼	襄阳太守周虑秘密接受王敦的旨意，诈称湖中有许多鱼，劝甘卓派身边的侍从人众都下湖捕鱼
五月，乙亥，虑引兵袭卓于寝室，杀之，传首于敦，并杀其诸子	五月，乙亥，周虑带兵偷袭，把甘卓杀死于寝室，将首级传送给王敦，同时杀掉甘卓诸子
敦以从事中郎周抚督沔北诸军事，代卓镇沔中	王敦让从事中郎周抚督察沔北地区军务，代替甘卓镇守沔中
抚，访之子也	周抚是周访之子
兖州刺史郗鉴在邹山三年，有众数万	兖州刺史郗鉴留住邹山三年，拥有士众数万
战争不息，百姓饥馑，掘野鼠、蛰燕而食之，为后赵所逼，退屯合肥	因为当时争战不息，百姓饥馑难忍，以至挖掘田鼠和藏伏避寒的燕子作为食物，后赵乘机进逼，郗鉴退守合肥，尚书右仆射纪瞻认为郗鉴名望不错，道德高尚，应当在朝中施展才能，于是上疏请求征用他
尚书右仆射纪瞻，以鉴雅望清德，宜从容台阁，上疏请征之；乃征拜尚书	元帝便征召郗鉴任尚书
徐、兖间诸坞多降于后赵，后赵置守宰以抚之	徐州、兖州地区的坞堡大多投降后赵，后赵在当地设置官员加以抚慰
王敦自领宁、益二州都督	王敦自任宁州、益州都督
祖逖既卒，后赵屡寇河南，拔襄城、城父，围谯	祖逖死后，后赵屡屡侵犯黄河以南，拔取襄城、城父，又围攻谯
豫州刺史祖约不能御，退屯寿春	豫州刺史祖约抵挡不住，退守寿春
后赵遂取陈留，梁、郑之间复骚然矣	后赵于是攻取了陈留，梁州、郑州地区的形势又变得动荡不安
罢司徒，并丞相府	东晋取消司徒这种官衔，将其执掌的事务并入丞相府管辖
王敦以司徒官属为留府	王敦把原司徒官属成员组成留守府
十二月，赵主曜葬其父母于粟邑，大赦	十二月，前赵主刘曜将其父母安葬在粟邑，大赦天下
陵下周二里，上高百尺，计用六万夫，作之百日乃成	陵墓基长周圆二里，上高百尺，共计动用六万人，建造了一百天才成
役者夜作，继以脂烛，民甚苦之	从事劳役的人挑灯夜作，不分昼夜，百姓深感劳苦
游子远谏，不听	游子远谏诤，刘曜不听
张茂使将军韩璞帅众取陇西、南安之地，置秦州	张茂让将军韩璞率领部众攻取陇西、南安地区，设置秦州
幕容遣其世子袭段末，入令支，掠其居民千余家而还	慕容派世子慕容袭击段末，攻入令支，劫掠一千多家居民后返回
春，正月，成李骧、任回寇台登，将军司马玖战死，越太守李钊、汉嘉太守王载皆以郡降于成	春季，正月，成汉李骧、任回侵犯台登，将军司马玖战死，赵太守李钊、汉嘉太守王载都献纳本郡投降成汉
二月，庚戌，葬元帝于建平陵	二月，庚戌，，元帝入葬建平陵
三月，戊寅朔，改元	三月，戊寅朔，改年号为太宁
饶安、东光、安陵三县灾，烧七千余家，死者万五千人	饶安、东光、安陵三县发生火灾，烧毁七千多家住房，死者达一万五千人
后赵寇鼓城、下邳，徐州刺史卞敦与征北将军王邃退保盱眙	后赵侵犯彭城、下邳，徐州刺史卞敦和征北将军王邃退守盱眙
敦，之从父兄也	卞敦是卞壶的堂兄
后赵王勒遣使结好于慕容，执送建康	后赵王石勒派遣使者与慕容通好，慕容将来使拘捕，送至建康
六月，壬子，立妃庾氏为皇后；以后兄中领军亮为中书监	六月，壬子，明帝立妃子庾氏为皇后，让皇后的兄长中领军庾亮任中书监
王敦从子允之，方总角，敦爱其聪警，常以自随	王敦的侄子王允之，正当童年，王敦因他聪明机警，异常宠爱，经常让他跟随自己
敦尝夜饮，允之辞醉先卧	王敦有次在夜晚饮酒，王允之以醉酒为由告辞先睡，王敦便和钱凤一起商讨叛乱之事，被王允之原原本本听到
敦与钱凤谋为逆，允之悉闻其言；即于卧处大吐，衣面并污	王允之随即在睡卧的地方大吐，衣物、脸面都沾上了污秽
凤出，敦果照视，见允之卧于吐中，不复疑之	钱凤走后，王敦果然持灯前来察看，见王允之睡卧在呕吐的污物中，便不再有疑心
会其父舒拜廷尉，允之求归省父，悉以敦、凤之谋白舒	不久，适逢王允之的父亲王舒升任廷尉，王允之请求归省父亲，便将王敦、钱凤密谋的内容全部告诉了王舒
舒与王导俱启帝，阴为之备	王舒与王导一块儿禀报皇帝，私下为应付突变做准备
后赵王勒以参军樊坦为章武内史，勒见其衣冠弊坏，问之	后赵王石勒让参军樊坦任章武内史，石勒见他衣帽破旧，询问原因
坦率然对曰：顷为羯贼所掠，资财荡尽	樊坦未加思索，回答说：不久前遭到羯族贼寇的抢劫，财物荡然无存
勒笑曰：羯贼乃尔无道邪	石勒笑着说：羯族贼寇竞然这样蛮横无道吗
今当相偿	现在我会偿还给你
坦大惧，叩头泣谢	樊坦大为恐惧，流着眼泪叩头陪罪
勒赐车马、衣服、装钱三百万而遣之	石勒赐给他车马、衣服及办装费三百万，派遣他上任
是岁，越斯叟攻成将任回，成主雄遣征南将军费黑讨之	这年，赵人斯叟进攻成汉的将领任回，成汉国主李雄派遣征南将军费黑征讨斯叟
会稽内史周札，一门五侯，宗族强盛，吴士莫与为比；王敦忌之	会稽内史周札，一族之中有五人封侯，宗族势力强盛，吴地人士中无人可以比拟，王敦为此忌惮
敦有疾，钱凤劝敦早除周氏，敦然之	王敦生病，钱凤劝王敦早日除灭周氏，得到王敦赞同
周嵩以兄之死，心常愤愤	周嵩因为兄长周被王敦所杀，心中经常愤愤不平
敦无子，养王含子应为嗣，嵩尝于众中言应不宜统兵，敦恶之	王敦没有儿子，收养王含之子王应为子嗣，周嵩曾当众说王应不适合统领军队，王敦为此憎恶周嵩
嵩与札兄子皆为敦从事中郎	周嵩和周札兄长的儿子周都任王敦的从事中郎
会道士李脱以妖术惑众，士民颇信事之	适逢道士李脱利用妖术盅惑民众，不少士民都相信追随他
后赵将兵都尉石瞻寇下邳、彭城，取东莞、东海，刘遐退保泗口	后赵的将兵都尉石瞻侵犯下邳、彭城，攻取东莞、东海，刘遐退保泗口
夏，五月，甲申，张茂疾病，执世子骏手泣曰：吾家世以孝友忠顺著称，今虽天下大乱，汝奉承之，不可失也	夏季，五月，甲申，张茂病重，拉着王世子张骏的手哭泣说：我家世代以孝友忠顺著称于世，如今虽然天下大乱，但你必须继承家族遗风，不可或失
且下令曰：吾官非王命，苟以集事，岂敢荣之	并且下令说：我的官职本非朝廷任命，为顺应事变而苟且自任，怎能以此为荣
死之日，当以白入棺，勿以朝服敛	我死的时候，应当戴着白色便帽入棺，不要用朝服殡殓
是日，薨	这天，张茂故去
愍帝使者史淑在姑臧，左长史、右长史马谟等，使淑拜骏大将军、凉州牧、西平公，赦其境内	愍帝时的使者史淑留居在姑臧，左长史、右长史马谟等让史淑授予张骏大将军、凉州牧、西平公，赦免境内罪犯
前赵主曜遣使赠茂太宰，谥曰成烈王；拜骏上大将军、凉州牧、凉王	前赵主刘曜派遣使者赠给张茂太宰的名号，谥号为成烈王；授张骏为上大将军、凉州牧、凉王
王敦疾甚，矫诏拜王应为武卫将军以自副，以王含为骠骑大将军、开府仪同三司	王敦病情加剧，矫称诏令任命王应为武卫将军，做自己的副职，任命王含为骠骑大将军、开府仪同三司
钱凤谓敦曰：脱有不讳，便当以后事付应邪	钱凤对王敦说：倘若您有不幸，是否将把身后之事托付王应
敦曰：非常之事，非常人所能为	王敦说：非常之事，不是平常的人所能够胜任的
且应年少，岂堪大事	何况王应年轻，哪能承担大事
我死之后，莫若释兵散众，归身朝廷，保全门户，上计也；退还武昌，收兵自守，贡献不废，中计也；及吾尚存，悉众而下，万一侥幸，下计也	我死以后，不如放下武器、遣散兵众，归顺朝廷，以保全宗族门户，这是上策；退回到武昌，集中军队谨慎自守，给朝廷贡献的物品无所缺废，这是中策；乘我还活着的时候，发遣所有的兵力攻打京城，寄希望于侥幸取胜，这是下策
凤谓其党曰：公之下计，乃上策也	钱凤对其党羽说：王公所谓下策，其实正是上策
遂与沈充定谋，俟敦死，即作乱	于是与沈充谋议商定，等王敦一死便作乱
又以宿卫尚多，奏令三番休二	又认为宿卫士卒太多，奏令停值三分之二
十二月，凉州将辛晏据罕，不服，张骏将讨之	十二月，凉州将领辛晏占据罕县，不听从张骏号令，张骏准备讨伐他
从事刘庆谏曰：霸王之师，必须天时、人事相得，然后乃起	从事刘庆劝谏说：霸王的军队，必须占有天时、人事，然后才能出动
辛晏凶狂安忍，其亡可必，奈何以饥年大举，盛寒攻城乎	辛晏凶狂残忍，必定败亡，何必在饥荒的年份大举兴兵，在严寒的时节攻城呢
骏乃止	张骏这才作罢
是岁，代王贺始亲国政，以诸部多未服，乃筑城于东木根山，徙居之	这年，代王贺开始亲政，因为下属各部大多不服号令，便在东木根山修筑城堡，移居那里
春，二月，张骏承元帝凶问，大临三日	春季，二月，张骏禀受元帝死讯，隆重哀吊三天
会黄龙见嘉泉，等请改年以章休祥；骏不许	正逢嘉泉出现黄龙，等人请求改年号以彰显吉祥，张骏不同意
辛晏以罕降，骏复收河南之地	辛晏献交罕请降，张骏又收复了黄河以南失地
后赵王勒加宇文乞得归官爵，使之击慕容	后赵王石勒授予宇文乞得归官爵，让他攻击慕容
遣世子、索头、段国共击之，以辽东相裴嶷为右翼，慕容仁为左翼	慕容派遣世子慕容和索头、段国共同抗击，以辽东相裴嶷为右翼，慕容仁为左翼
乞得归据浇水以拒，遣兄子悉拔雄拒仁	宇文乞得归占据浇水拒抗慕容，派兄长子之子宇文悉拔雄抵御慕容仁
仁击悉拔雄，斩之；乘胜与攻乞得归，大破之	慕容仁攻击宇文悉拔雄，将他斩杀，乘胜和慕容合力攻击宇文乞得归，大败敌军
乞得归弃军走，、仁进入其国城，使轻兵追乞得归，过其国三百余里而还，尽获其国重器，畜产以百万计，民之降附者数万	宇文乞得归丢下军队逃跑，慕容、慕容仁进入他的都城，派轻兵追袭宇文乞得归，越过国界三百多里才返回，尽数获得其国家的重宝，数以百万的畜产，归降的人民有数万
三月，段末卒，弟牙立	三月，段末故去，弟段牙继立
戊辰，立皇子衍为太子，大赦	戊辰，明帝立皇子司马衍为皇太子，大赦天下
赵主曜立皇后刘氏	前赵主刘曜册立皇后刘氏
杨难敌袭仇池，克之；执田崧，立之于前，左右令崧拜；崧目叱之曰：氐狗	杨难敌攻取仇池，抓获田崧，带到面前
安有天子牧伯而向贼拜乎	左右侍从命令田崧跪拜，田崧瞪着眼睛斥骂说：你们这些氐族狗
难敌字谓之曰：子岱，吾当与子共定大业，子忠于刘氏，岂不能忠于我乎	哪有身为天子大员却向叛贼跪拜的
崧厉色大言曰：贼氐，汝本奴才，何谓大业	杨难敌对他说：田子岱，我将和你共同建立国家大业，你能忠于刘氏，怎么不能忠于我呢
我宁为赵鬼，不为汝臣	田崧厉色高声说：氐族贼子，你本为奴才，谈什么大业
顾排一人，夺其剑，前刺难敌，不中	我宁愿作赵国的死鬼，不作你的臣下
难敌杀之	回身推开一人，夺下他的剑，向前刺击杨难敌，没有刺中，被杨难敌所杀
都尉鲁潜以许昌叛，降于后赵	晋都尉鲁潜占据许昌反叛，投降后赵
夏，四月，后赵将石瞻攻兖州刺史檀斌于邹山，杀之	夏季，四月，后赵将领石瞻攻袭在邹山的兖州刺史檀斌，檀斌被杀
后赵西夷中郎将王腾杀并州刺史崔琨、上党内史王，据并州降赵	后赵的西夷中郎将王腾杀死并州刺史崔琨、上党内史王，占据并州，投降前赵
赵主曜以永安王胤为大司马、大单于，徙封南阳王，置单于台于渭城，其左、右贤王以下，皆以胡、羯、鲜卑、氐、羌豪桀为之	前赵主刘曜任命永安王刘胤为大司马、大单于，改封南阳王，在渭城设置单于台，左、右贤王以下，都由匈奴、羯族、鲜卑族、氐族和羌族的豪杰之士充任
秋，七月，辛未，以尚书令郗鉴为车骑将军、都督徐・兖・青三州诸军事、兖州刺史，镇广陵	秋季，七月，辛未，朝廷任命尚书令郗鉴为车骑将军，都督徐、兖、青三州军事，兖州刺史，镇守广陵
闰月，以尚书左仆射荀松为光禄大夫、录尚书事，尚书邓攸为左仆射	闰月，任尚书左仆射荀松为光禄大夫、录尚书事，尚书邓攸为左仆射
辛丑，葬明帝于武平陵	辛丑，明帝入葬武平陵
荆州刺史陶侃以宁州刺史王坚不能御寇，是岁，表零陵太守南阳尹奉为宁州刺史以代之	荆州刺史陶侃因为宁州刺史王坚不能抵御敌寇，这年，上表荐举零陵太守，南阳人尹奉为宁州刺史，以取代王坚
先是，王逊在宁州，蛮酋梁水太守爨量、益州太守李，皆叛附于成，逊讨之不能克	早先，王逊任职宁州时，蛮夷首领、梁水太守爨量、益州太守李逖都背叛朝廷，归附成汉，王逊进讨，不能取胜
奉至州，重募徼外夷刺爨量，杀之，谕降李，州境遂安	尹奉到宁州后，重金聘募境外夷人刺杀爨量成功，又劝谕李逖归降，于是州内安定
代王贺卒，弟纥那立	代王拓跋贺死，弟拓跋纥那继立
春，二月，大赦，改元	春季，二月，大赦天下，改年号为咸和
三月，后赵王勒夜微行，检察诸营卫，赍金帛以赂门者，求出	三月，后赵王石勒夜间微服出行，检视察看各营帐守卫，他拿着金帛去送给守门人，请求出门
永昌门候王假欲收捕之，从者至，乃止	永昌门守令王假要拘捕他，因随从人员到来才停手
旦，召假，以为振忠都尉，爵关内侯	清晨，石勒召见王假，任命他为振忠都尉，赐给关内侯的爵位
勒召记室参军徐光，光醉不至，黜为牙门	石勒召见记室参军徐光，徐光因酒醉未到，被贬职为牙门
光侍直，有愠色，勒怒，并其妻子囚之	徐光当值侍卫时，面带怨怒的容色，石勒发怒，将他连同妻子儿女一起囚禁起来
夏，四月，后赵将石生寇汝南，执内史祖济	夏季，四月，后赵将领石生侵犯汝南，执获汝南内史祖济
六月，癸亥，泉陵公刘遐卒	六月，癸亥，泉陵公刘遐死
癸酉，以车骑大将军郗鉴领徐州刺史；征虏将军郭默为北中郎将、监淮北诸军事，领遐部曲	癸酉，任命车骑大将军郗鉴兼领徐州刺史，任征虏将军郭默为北中郎将、监察淮北军务，统领刘遐的部曲
遐子肇尚幼，遐妹夫田防及故将史迭等不乐他属，共以肇袭故位而叛	刘遐之子刘肇年龄还小，刘遐的妹夫田防及刘遐的旧将史迭等人不愿归属他人，共同让刘肇承袭刘遐的旧位，而后反叛
临淮太守刘矫掩袭遐营，斩防等	临淮太守刘矫偷袭刘遐的军营，杀死田防等人
遐妻，邵续女也，骁果有父风	刘遐的妻子是邵续的女儿，骁勇果敢，颇有父亲遗风
遐尝为后赵所围，妻单将数骑，拔遐出于万众之中	刘遐曾经被后赵围困，刘遐妻子一人带领数骑，从万众之中把刘遐救出
及田防等欲作乱，遐妻止之，不从，乃密起火，烧甲仗都尽，故防等卒败	等到田防等人打算作乱，刘遐妻子制止他们，他们不听，于是刘遐妻子暗地里点火，把铠甲兵仗全都烧光，所以田防等人很快失败
诏以肇袭遐爵	成帝下诏让刘肇承袭刘遐的爵位
成人讨越斯叟，破之	成汉人征讨越隽人斯臾，战败了他
秋，七月，癸丑，观阳烈侯应詹卒	秋季，七月，癸丑，观阳烈侯应詹故去
冬，十月，立帝母弟岳为吴王	冬季，十月，立成帝母后的弟弟庾岳为吴王
赵将黄秀等寇，顺阳太守魏该帅众奔襄阳	前赵将领黄秀等侵犯县，顺阳太守魏该帅士众逃奔襄阳
后赵王勒用程遐之谋，营邺宫，使世子弘镇邺，配禁兵万人，车骑所统五十四营悉配之，以骁骑将军领门臣祭酒王阳专统六夷以辅之	后赵王石勒用程遐的计谋，营建邺地宫室，让王世子石弘镇守邺，配备禁兵万人，车骑将军所统领的五十四营全部配署在那里，并让骠绮将军兼门臣祭酒王阳专门统领六夷辅佐石弘
中山公虎自以功多，无去邺之意，及修三台，迁其家室，虎由是怨程遐	中山公石虎自认为功劳多，没有离开邺地的意思，等到修筑三台，让石虎家迁移，石虎因此怨恨程遐
十一月，后赵石聪攻寿春，祖约屡表请救，朝廷不为出兵	十一月，后赵石聪进攻寿春，祖约屡次上表请求救援，朝廷不出兵
聪遂寇逡遒、阜陵，杀掠五千余人	石聪便侵犯逡遒、阜陵，杀死、掠夺五千多人
建康大震，诏加司徒导大司马、假黄、都督中外诸军事以御之，军于江宁	建康为此大为震惊，朝廷下诏授司徒王导大司马、假黄、都督中外诸军事来抵御石聪，驻军在江宁
苏峻遣其将韩晃击石聪，走之；导解大司马	苏峻派部将韩晃进击石聪，将他赶走，王导解除大司马职务
朝议又欲作涂塘以遏胡寇，祖约曰：是弃我也	朝廷议论又想兴修涂塘，用以阻遏胡夷寇掠，祖约说：这是弃我不顾
益怀愤恚	更加心怀愤恚
后赵王勒以牙门将王波为记室参军，典定九流，始立秀、孝试经之制	后赵王石勒任命牙门将王波为记室参军，典掌评定九流高下，开始设立秀才、孝廉考试经策的制度
张骏畏赵人之逼，是岁，徙陇西、南安民二千余家于姑臧，又遣使修好于成，以书劝成主雄去尊号，称藩于晋	张骏畏惧赵人的逼迫，这年，由陇西、南安迁徙民众二千多家到姑臧，又派使者和成汉修好，写信劝成汉主李雄除去皇帝尊号，成为东晋的藩臣
雄复书曰：吾过为士大夫所推，然本无心于帝王，思为晋室元功之臣，扫除氛埃；而晋室陵迟，德声不振，引领东望，有年月矣	李雄复信说：我过分地被士大夫们推举，但我自己本来无心当帝王，想成为晋皇帝的首功大臣，扫除世间的妖气和尘埃；但晋王室国运衰微，恩泽和声望不振，我翘首东望晋王室，已经有些年月了
会获来贶，情在暗至，有何已已	正巧接获您的赐札，情理与我心中所想暗合，还有什么可疑虑的呢
自是聘使相继	从此相互使者交聘不断
春，正月，朱提太守杨术与成将罗恒战于台登，兵败，术死	春季，正月，朱提太守杨术和成汉将领罗恒在台登交战，杨术兵败身死
夏，五月，甲申朔，日有食之	夏季，五月，甲申朔，出现日食
赵武卫将军刘朗帅骑三万袭杨难敌于仇池，弗克，掠三千余户而归	前赵的武卫将军刘朗率领骑兵三万人攻袭在仇池的杨难敌，不能取胜，劫掠民众三千多户返回
丙寅，徙琅邪王昱为会稽王，吴王岳为琅邪王	丙寅，成帝改封琅邪王司马昱为会稽王，改封吴王司马岳为琅邪王
是岁，后赵中山公虎击代王纥那，战于句注陉北；纥那兵败，徙都大宁以避之	这年，后赵中山公石虎攻击代王拓跋纥那，双方战于句注山陉北，拓跋纥那战败，迁都至大宁以避敌祸
代王郁律之子翳槐居于其舅贺兰部，纥那遣使求之，贺兰大人蔼头拥护不遣	代王拓跋郁律之子拓跋翳槐居住在舅父的贺兰部，拓跋纥那派使者要他，贺兰大人蔼头卫护着不让走
纥那与宇文部共击蔼头，不克	拓跋纥那和宇文部共同攻击蔼头，不能取胜
春，正月，温峤入救建康，军于寻阳	春季，正月，温峤来救援建康，屯军寻阳
后赵大赦，改元太和	后赵实行大赦，改年号为太和
三月，丙子，庾太后以忧崩	三月，丙子，庾太后因忧愁驾崩
苏峻南屯于湖	苏峻向南屯兵于湖
夏，四月，后赵将石堪攻宛，南阳太守王国降之；遂进攻祖约军于淮上	夏季，四月，后赵将领石堪攻宛，南阳太守王国投降；石堪随即进攻驻于淮水岸边的祖约
约将陈光起兵攻约，约左右阎秃，貌类约，光谓为约而擒之，约逾垣获免	祖约部将陈光发兵攻击祖约，祖约的侍从闫秃，相貌与祖约相像，陈光以为是祖约，把他擒获，祖约越墙逃脱
光奔后赵	陈光逃奔后赵
壬申，葬明穆皇后于武平陵	壬申，明穆皇后入葬武平陵
庾亮、温峤将起兵讨苏峻，而道路断绝，不知建康声闻	庾亮、温峤准备起兵讨伐苏峻，但道路阻断，不知道建康的消息
会南阳范汪至寻阳，言峻政令不一，贪暴纵横，灭亡已兆，虽强易弱，朝廷有倒悬之急，宜时进讨	适逢南阳人范汪到寻阳，说：苏峻政令混乱不一，贪婪强暴，肆无忌惮，已显现出灭亡的征兆，虽然暂时强大，但很容易转化为弱小，朝廷到了千钧一发的危急时刻，应当及时进攻讨伐
峤深纳之	温峤深以为然
亮辟汪参护军事	庾亮征召范汪为参护军事
后赵中山公虎帅众四万自轵关西入，击赵河东，应之者五十余万，遂进攻蒲阪	后赵中山公石虎率士众四万人从轵关西进，攻击前赵的河东，有五十多个县应从，石虎于是进攻蒲阪
赵主曜遣河间王述发氐、羌之众屯秦州以备张骏、杨难敌，自将中外精锐水陆诸军以救蒲阪，自卫关北济；虎惧，引退	前赵主刘曜派河间王刘述调遣氐族、羌族士众屯驻在秦州，防备张骏和杨难敌，自己率领中外精锐的水、陆各军救援蒲阪，从卫关北渡黄河
曜追之，八月，及于高候；与虎战，大破之，斩石瞻，枕尸二百余里，收其资仗亿计	石虎畏惧，率军退走，刘曜追击
虎奔朝歌	八月，在高候追上石虎，与石虎交战，石虎大败，石瞻被杀，尸体枕籍达二百多里，刘曜缴获的军资上亿
曜济自大阳，攻石生于金墉，决千金以灌之	石虎逃奔朝歌
分遣诸将攻汲郡、河内，后赵荥阳太守尹矩、野王太守张进等皆降之	刘曜从大阳渡过黄河，攻击驻守金墉的石生，开决千金的蓄水淹灌他们，又分别派遣诸将进攻汲郡、河内，后赵的荥阳太守尹矩、野王太守张进等都归降刘曜
襄国大震	襄国大为震惊
张骏治兵，欲乘虚袭长安	张骏整备军队，想乘虚偷袭长安
理曹郎中索询谏曰：刘曜虽东征，其子胤守长安，未易轻也	理曹郎中索询劝谏说：刘曜虽然东征，他儿子刘胤防守长安，不能轻视
借使小有所获，彼若释东方之图，还与我校；祸难之期，未可量也	即使小有所获，但如果刘曜放弃对东方的图谋，回军与我方较量，祸难临头的时候就难以预测了
骏乃止	张骏这才罢休
冬，十一月，后赵王勒欲自将救洛阳，僚佐程遐等固谏曰：刘曜悬军千里，势不支久	冬季，十一月，后赵王石勒想自己率兵救援洛阳，僚佐程遐等极力劝谏说：刘曜孤军深入千里之外，势必不能持久
大王不宜亲动，动无万全	大王不应当亲自出动，一旦出动难保万全
勒大怒，按剑叱遐等出	石勒大怒，手按佩剑呵叱程遐等人出去
乃赦徐光，召而谓之曰：刘曜乘一战之胜，围守洛阳，庸人之情皆谓其锋不可当	于是赦免徐光的罪过，把他召来对他说：刘曜凭借一仗的胜利，围攻并占据洛阳，庸人的想法都说他的锋芒不可抵挡
曜带甲十万，攻一城而百日不克，师老卒怠，以我初锐击之，可一战而擒也	刘曜带领十万甲士，攻打一座城池却一百天不能取胜，军队疲惫、士卒懈怠，用我方精锐的生力军攻击，一战便可擒获他
若洛阳不守，曜必送死冀州，自河已北，席卷而来，吾事去矣	如果洛阳失守，刘曜必定会进攻冀州，由黄河北边席卷而来，我们就完了
程遐等不欲吾行，卿以为何如	程遐等人不想让我去，您以为怎么样
对曰：刘曜乘高候之势，不能进临襄国，更守金墉，此其无能为可知也	徐光回答说：刘曜乘着在高候战胜石虎的势头，不能进军逼迫襄国，反而据守金墉，由此可知他不会有什么作为
以大王威略临之，彼必望旗奔败	凭着大王您的威风胆略进逼他，他必定是望风败逃
平定天下，在今一举，不可失也	平定天下，就在今天这一战，时机不能错过
勒笑曰：光言是也	石勒笑着说：你说的对
乃使内外戒严，有谏者斩	于是让宫室内外戒严，有敢于劝谏的斩首
命石堪、石聪及豫州刺史桃豹等各统见众会荥阳；中山公虎进据石门，勒自统步骑四万趣金墉，济自大	命令石堪、石聪和豫州刺史桃豹等各自统领现有士众会聚荥阳，又令中山公石虎进军占据石门，石勒自己率步、骑兵四万人赶赴金墉，从大渡过黄河
是岁，成汉献王骧卒，其子征东将军寿以丧还成都	这年，成汉的汉献王李骧死，他的儿子、征东将军李寿因父丧返回成都
成主雄以李为征北将军、梁州刺史，代寿屯晋寿	成汉主李雄任李为征北将军、梁州刺史，代替李寿驻屯晋寿
春，正月，光禄大夫陆晔及弟尚书左仆射玩说匡术，以苑城附于西军；百官皆赴之，推晔督宫城军事	春季，正月，光禄大夫陆晔和兄弟、尚书左仆射陆玩劝说匡术，献出苑城归附西军，百官都赶来，推举陆晔督察宫城军事
陶侃命毛宝守南城，邓岳守西城	陶侃令毛宝戍守苑城的南城，邓岳戍守西城
冠军将军赵胤遣部将甘苗击祖约于历阳，戊辰，约夜帅左右数百人奔后赵，其将牵腾率众出降	冠军将军赵胤派部将甘苗在历阳攻击祖约，戊辰，祖约乘夜率左右侍从几百人投奔后赵，部将牵腾率众出城投降
苏逸、苏硕、韩晃并力攻台城，焚太极东堂及秘阁，毛宝登城，射杀数十人	苏逸、苏硕、韩晃合力进攻台城，焚毁了太极东堂和秘阁，毛宝登上城墙，射死几十人
晃谓宝曰：君名勇果，何不出斗	韩晃对毛宝说：你以勇猛果敢闻名，为何不出来斗斗
宝曰：君名健将，何不入斗	毛宝说：你号称是英勇善战的将领，为何不进来斗斗
晃笑而退	韩晃含笑退还
二月，丙戌，诸军攻石头	二月，丙戌，各路军队进攻石头
建威长史滕含击苏逸，大破之	建威长史滕含重创苏逸，苏硕率领骁勇士卒数百人渡过秦淮河作战，被温峤击败斩杀
苏硕帅骁勇数百，渡淮而战，温峤击斩之	韩晃等人恐惧，带着部众前往曲阿依附张健，门道狭窄不便进出，士卒互相踩踏，死者上万
韩晃等惧，以其众就张健于曲阿，门隘不得出，更相蹈藉，死者万数	西军擒获苏逸，将他斩首
西军获苏逸，斩之，滕含部将曹据抱帝奔温峤船，群臣见帝，顿首号泣请罪	滕含部将曹据抱着成帝逃到温峤船上，群臣见到皇帝，叩头至地号泣请罪
杀西阳王，并其二子播、充、孙崧及彭城王雄	随即杀死西阳王司马、其子司马播、司马充、其孙司马崧以及彭城王司马雄
陶侃与任让有旧，为请其死	陶侃和任让有旧交，为他求情免死
帝曰：是杀吾侍中、右卫者，不可赦也	成帝说：此人杀害了我的侍中钟雅和右卫将军刘超，罪不可赦
乃杀之	于是杀死任让
司徒导入石头，令取故节，陶侃笑曰：苏武节似不如是	司徒王导进入石头，让人取出他的旧有符节，侃笑着说：苏武的符节好像不如你这个
导有惭色	王导面有愧色
丁亥，大赦	丁亥，大赦天下
壬寅，以湘州并荆州	壬寅，晋将湘州并入荆州
三月，壬子，论平苏峻功，以陶侃为侍中、太尉，封长沙郡公，加都督交、广、宁州诸军事；郗鉴为侍中、司空、南昌县公；温峤为骠骑将军、开府仪同三司，加散骑常侍、始安郡公；陆晔进爵江陵公；自余赐爵侯、伯、子、男者甚众	三月，壬子，评议平定苏峻的功绩，任陶侃为侍中、太尉，封长沙郡公，加授都督交州、广州、宁州诸军事；郗鉴为侍中、司空、南昌县公；温峤为骠骑将军、开府仪同三司，加授散骑常侍、始安郡公；陆晔进爵为江陵公；其余赐封爵位为侯、伯、子、男的很多
卞及二子、盱、桓彝、刘超、钟雅、羊曼、陶瞻，皆加赠谥	卞壶及二子卞、卞盱、桓彝、刘超、钟雅、羊曼、陶瞻，都追赐谥号
路永、匡术、贾宁，皆苏峻之党也；峻未败，永等去峻归朝廷；王导欲赏以官爵	路永、匡术、贾宁，都是苏峻旧党，苏峻没有败亡时，路永等人叛离苏峻归附朝廷
温峤曰：永等皆峻之腹心，首为乱阶，罪莫大焉	王导想赏给他们官爵，温峤说：路永等人都是苏峻的心腹，首先参与并导致祸乱的，没有比这更大的罪过了
晚虽改悟，未足以赎前罪；得全首领，为幸多矣，岂可复褒宠之哉	后来虽然觉悟改正，但不足以全赎以往的罪孽，能够保全首级，已经是很大的侥幸了，怎能再褒扬宠爱他们呢
导乃止	王导这才停止
徙高密王为彭城王	成帝改封高密王司马为彭城王
，雄之弟也	司马即司马雄的兄弟
夏，四月，乙未，始安忠武公温峤卒，葬于豫章	夏季，四月，乙未，始安忠武公温峤故去，葬在豫章
朝廷欲为之造大墓于元、明二帝陵之北，太尉侃上表曰：峤忠诚著于圣世，勋义感于人神，使亡而有知，岂乐今日劳费之事	朝廷想在元帝、明帝的陵墓北边为他建造大墓，太尉陶侃上表说：温峤的忠诚著称于圣世，功勋节义让人神感动，假如人死有知，难道会为今天这种劳民伤财的事情高兴吗
愿陛下慈恩，停其移葬	希望陛下慈爱有恩，停止移葬之事
诏从之	成帝下诏听从了他的意见
初，陇西鲜卑乞伏述延居于苑川，侵并邻部，士马强盛	当初，陇西的鲜卑族乞伏述延部居住在苑川，侵犯吞并邻近部落，人马强盛
及赵亡，述延惧，迁于麦田	等到前赵灭亡，乞伏述延畏惧，迁至麦田
述延卒，子大寒立；大寒卒，子司繁立	乞伏述延死后，儿子乞伏大寒继立；乞伏大寒死后，儿子乞伏司繁继立
是岁，贺兰部及诸大人共立拓拔翳槐为代王，代王纥那奔宇文部	这年，贺兰部及诸位大人头领共同推立拓拔翳槐为代王，代王拓拔纥那逃奔宇文部
翳槐遣其弟什翼犍质于赵以请和	拓拔翳槐派兄弟拓拔什翼犍到后赵作人质，请求和好
郭默欲南据豫章，会太尉侃兵至，默出战不利，入城固守，聚米为垒，以示有余	郭默想向南占据豫章，适逢太尉陶侃的军队到达，郭默出战不利，进城固守，用米堆成垒堡，显示自己粮食有余
侃筑土山临之	陶侃修筑土山对着他
三月，庾亮兵至湓口，诸军大集	三月，庾亮的军队到达湓口，各路军队会齐
夏，五月，乙卯，默将宋侯缚默父子出降	夏季，五月，乙卯，郭默部将宋侯捆绑着郭默父子出城投降
侃斩默于军门，传首建康，同党死者四十人	陶侃在军门将郭默斩首，把首级传送到建康，同党被处死的有四十人
诏以侃都督江州，领刺史；以邓岳督交、广诸军事，领广州刺史	朝廷下诏让陶侃都督江州，兼领刺史，让邓岳督察交州、广州诸军事，兼领广州刺史
侃还巴陵，因移镇武昌	陶侃回到巴陵，接着迁移镇守武昌
庾亮还芜湖，辞爵赏不受	庾亮回到芜湖，拒绝接受爵禄赏赐
赵将刘徵帅众数千，浮海抄东南诸县，杀南沙都尉许儒	后赵的将领刘徵率领数千士众，渡海抢掠东南各县，杀死南沙都尉许儒
张骏因前赵之亡，复收河南地，至于狄道，置五屯护军，与赵分境	张骏乘着前赵的灭亡，又收复黄河以南的失地，直至狄道，设置五屯护军，与后赵接壤
六月，赵遣鸿胪孟毅拜骏征西大将军、凉州牧，加九锡	六月，后赵派鸿胪孟毅授予张骏征西大将军、凉州牧、赐给九锡的礼遇
骏耻为之臣，不受，留颜不遣	张骏把做后赵的臣子看作耻辱，不接受封职，扣留孟毅不遣返
初，丁零翟斌，世居康居，后徙中国，至是入朝于赵；赵以斌为句町王	当初，丁零人翟斌世代居住在康居，后来迁入中原，至此时前来后赵朝见，后赵让翟斌当句町王
赵群臣固请正尊号，秋，九月，赵王勒即皇帝位	后赵群臣坚持请求石勒扶正皇帝尊号，秋季，九月，后赵王石勒即帝位
大赦，改元建平	大赦天下，改年号为建平
文武封进各有差	文武官员封职擢升，各有等秩
立其妻刘氏为皇后，太子弘为皇太子	册立妻子刘氏为皇后，太子石弘为皇太子
休屠王羌叛赵，赵河东王生击破之，羌奔凉州	休屠王石羌背叛后赵，河东王石生攻破他，石羌逃奔凉州
西平公骏惧，遣孟毅还，使其长史马诜称臣入贡于赵	西平公张骏恐惧，遣返孟毅，让自己的长史马诜向后赵称臣进贡
更造新宫	建康重新建造新的皇宫
甲辰，徙乐成王钦为河间王，封彭城王子俊为高密王	甲辰，晋改封乐成王司马钦为河间王，封彭城王司马的儿子司马俊为高密王
冬，十月，成大将军寿督征南将军费黑等攻巴东建平，拔之	冬季，十月，成汉的大将军李寿督察征南将军费黑等人攻取巴东的建平
巴东太守杨谦、监军丘奥退保宜都	巴东太守扬谦、监军丘奥退走保守宜都
春，正月，赵刘徵复寇娄县，掠武进，郗鉴击却之	春季，正月，后赵刘徵又侵犯娄县，劫掠武进县，郗鉴将其击退
三月，壬戌朔，日有食之	三月，壬戌朔，出现日食
秋，七月，成大将军寿攻阴平、武都，杨难敌降之	秋季，七月，成汉的大将军李寿进攻阴平、武都，杨难敌投降
春，正月，辛未，大赦	春季，正月，辛未，东晋大赦天下
秋，赵郭敬南掠江西，太尉侃遣其子平西参军斌，及南中郎将桓宣乘虚攻樊城，悉俘其众	秋季，后赵郭敬向南攻掠长江以西，太尉陶侃派儿子、平西参军陶斌及南中郎将桓宣乘虚进攻樊城，全数俘虏留守士众
敬旋救樊，宣与战于涅水，破之，皆得其所掠	郭敬回军救援樊城，桓宣和他在涅水接战，郭敬战败，桓宣夺回被郭敬劫掠的全部人员、物品
侃兄子臻及竟陵太守李阳攻新野，拔之	陶侃的兄长之子陶臻和竟陵太守李阳攻克新野
敬惧，遁去；宣遂拔襄阳	郭敬恐惧遁逃，桓宣随即夺取了襄阳
成大将军寿寇宁州，以其征东将军费黑为前锋，出广汉，镇南将军任回出越，以分宁州之兵	成汉的大将军李寿侵犯宁州，让其征东将军费黑为前锋，由广汉出击，又让镇南将军任回由越隽出击，使宁州兵力分散
十二月，庚戌，帝迁于新宫	十二月，庚戌，成帝迁入新建的宫室
春，正月，成大将军李寿拔朱提，董炳、霍彪皆降，寿威震南中	春季，正月，成汉的大将军李寿攻下朱提，董炳、霍彪都投降，李寿威震南中
丙子，赵主勒遣使来修好，诏焚其币	丙子，后赵国主石勒派使者来与晋重归修好，成帝下诏令焚烧他带来的礼物
夏，五月，甲寅，辽东武宣公慕容卒	夏季，五月，甲寅，辽东武宣公慕容死
六月，世子以平北将军行平州刺史，督摄部内；赦系囚	六月，世子慕容以平北将军的身份摄行平州刺史职务，督察、统领境内士众，赦免囚犯
以长史裴开为军谘祭酒，郎中令高诩为玄菟太守	任命长史裴开为军咨祭酒，郎中令高翊为玄菟太守
以带方太守王诞为左长史，诞以辽东太守阳骛为才而让之；从之，以诞为左长史	慕容让带方太守王诞任左长史，王诞认为辽东太守阳骛有才能因而推让给他，慕容同意了，任命王诞为右长史
慕容遣长史勃海王济等来告丧	慕容派遣长史、勃海人王济等前来晋报丧
慕容初嗣位，用法严峻，国人多不自安，主簿皇甫真切谏，不听	慕容刚刚继位，使用刑法过于严厉，国内人大多不知所措，主簿皇甫真恳切劝谏，慕容不听
十二月，郭权据上，遣使来降；京兆、新平、扶风、冯翊、北地皆应之	十二月，郭权占据上，派使者向晋请降，京兆、新平、扶风、冯翊、北地都响应他
春，正月，赵改元延熙	春季，正月，后赵改年号为延熙
诏以郭权为镇西将军、雍州刺史	晋朝廷下诏任命郭权为镇西将军、雍州刺史
仇池王杨难敌卒，子毅立，自称龙骧将军、左贤王、下辨公；以叔父坚头之子盘为冠军将军、右贤王、河池公，遣使来称藩	仇池王杨难敌故去，儿子杨毅继立，自称龙骧将军、左贤王、下辨公；任命叔父杨坚头之子杨盘为冠军将军、右贤王、河池公，派使者来晋称臣
二月，丁卯，诏遣耿访、王丰赍印绶授张骏大将军、都督陕西・雍・秦・凉州诸军事	二月，丁卯，朝廷下诏派耿访、王丰携带印绶拜授张骏为大将军，都督陕西、雍州、秦州、凉州诸军事
自是每岁使者不绝	从此以后每年来往使者不断
慕容仁以司马翟楷领东夷校尉，前平州别驾庞鉴领辽东相	慕容仁让司马翟楷兼领东夷校尉，让原先任平州别驾的庞鉴兼领辽东相
三月，成主雄分宁州置交州，以霍彪为宁州刺史，爨深为交州刺史	三月，成汉主李雄由宁州分置出交州，让霍彪任宁州刺史，爨深任交州刺史
慕容仁自称平州刺史、辽东公	慕容仁自称平州刺史，辽东公
辛未，加平西将军庾亮征西将军、假节、都督江・荆・豫・益・梁・雍六州诸军事、领江・豫・荆三州刺史，镇武昌	辛未，朝廷授予平西将军庾亮征西将军，假节，都督江、荆、豫、益、梁、雍六州诸军事，兼领江、豫、荆三州刺史，镇守武昌
亮辟殷浩为记室参军	庾亮召用殷浩为记室参军
浩，羡之子也，与豫章太守褚裒、丹阳丞杜，皆以识度清远，善谈《老》、《易》，擅名江东，而浩尤为风流所宗	殷浩即殷羡的儿子，和豫章太守褚裒、丹阳丞杜都因见识清晰、气度弘远，善于进谈《老子》、《周易》，在江东负有盛名，而殷浩尤其被风流雅士所推重
裒，之孙；，锡之子也	褚裒即褚的孙子，杜即杜锡的儿子
桓彝尝谓裒曰：季野有皮里《春秋》	桓彝曾经评论褚裒说：褚季野有皮里《春秋》
言其外无臧否，而内有褒贬也	是说他表面不作评论，但内心却有所褒贬
谢安曰：裒虽不言，而四时之气亦备矣	谢安说：褚裒虽然不说话，但气度弘远
秋，八月，王济还辽东，诏遣侍御史王齐祭辽东公，又遣谒者徐孟策拜慕容镇军大将军、平州刺史、大单于、辽东公，持节、承制封拜，一如故事	秋季，八月，王济返回辽东，成帝下诏派侍御史王齐祭奠辽东公慕容，又派谒者徐孟册封慕容为镇军大将军、平州刺史、大单于、辽东公，持朝廷符节、秉承皇帝旨意封官拜爵，与慕容旧例完全相同
船下马石津，皆为慕容仁所留	舟船行至马石津，都被慕容仁扣留
九月，戊寅，卫将军江陵穆公陆晔卒	九月，戊寅，卫将军、江陵穆公陆晔去世
慕容仁遣兵袭新昌，督护新兴王击走之，遂徙新昌入襄平	慕容仁派兵攻击新昌，督护、新兴人王将他击退，于是将新昌的士民迁徙到襄平
成、赵皆大赦，成改元玉恒，赵改元建武	成汉、后赵都在境内实行大赦，成汉改年号为玉恒，后赵改年号为建武
成主期立皇后阎氏，以卫将军尹奉为右丞相，骠骑将军、尚书令王为司徒	成汉国主李期册立皇后阎氏，任卫将军尹奉为右丞相，任命骠骑将军、尚书令王为司徒
赵王虎命太子邃省可尚书奏事，惟祀效庙、选牧守、征伐、刑杀乃亲之	后赵王石虎令太子石邃省视、决断尚书奏事，只有祭祀郊庙、选任地方官员、征伐、刑杀方面的奏事才亲自审议
虎好治宫室，鹳雀台崩，杀典匠少府任汪；复使修之，倍于其旧	石虎爱营建宫室，鹳雀台崩圮，便杀死典匠少府任汪，又让人重修，规模比原先扩大一倍
邃保母刘芝封宜城君，关预朝权，受纳贿赂，求仕进者多出其门	封石邃的保姆刘芝为宜城君，干预朝政，接受贿赂，谋求任官，晋升的人大多出入其门
慕容置左、右司马，以司马韩矫、军祭酒封奕为之	慕容设置左、右司马，分别让司马韩矫、军祭酒封奕出任
赵王虎南游，临江而还	后赵王石虎去南方游巡，到达长江才返回
有游骑十余至历阳，历阳太守袁耽表上之，不言骑多少	手下的游动骑兵十多人到达历阳，历阳太守袁耽上表奏上，没说骑兵的数量
朝廷震惧，司徒导请出讨之	朝廷震动恐惧，司徒王导请求出兵征讨
夏四月，加导大司马、假黄钺、都督征讨诸军事	夏季，四月，授予王导大司马、假黄钺、都督征讨诸军事
癸丑，帝观兵广莫门，分命诸将救历阳及戍慈湖、牛渚、芜湖；司空郗鉴使广陵相陈光将兵入卫京师	癸丑，成帝到广莫门检阅军队，分别命令众将领救援历阳，以及戍守慈湖、牛渚、芜湖
俄闻赵骑至少，又已去，戊午，解严，王导解大司马	司空郗鉴让广陵相陈光领兵进入京城护卫
袁耽坐轻妄免官	不久听说赵国骑兵数量极少，又已经离去，戊午，解除军队的戒备状态，王导卸除大司马职，袁耽坐罪轻妄不察被免官
赵征虏将军石遇攻桓宣于襄阳，不克	后赵征虏将军石遇进攻驻守襄阳的桓宣，不能取胜
大旱，会稽馀姚米斗五百	晋发生严重旱灾，会稽郡的余姚每斗米价格五百钱
秋，七月，慕容立子俊为世子	秋季，七月，慕容立儿子慕容为世子
九月，赵王虎迁都于邺，大赦	九月，赵王石虎迁都于邺，实行大赦
初，赵主勒以天竺僧佛图澄豫言成败，数有验，敬事之	当初，后赵国主石勒因为天竺僧人佛图澄预先陈言事情的成败，多次得到验证，恭敬地侍奉他
及虎即位，奉之尤谨，衣以绫锦，乘以雕辇	石虎即位后，侍奉他更为恭谨，让他穿绫锦，乘雕辇
朝会之日，太子、诸公扶翼上殿，主者唱大和尚，众坐皆起	到朝会的日子，太子、各位公卿扶持上殿，掌管朝仪的人唱名说：大和尚，满座都起身
使司空李农旦夕问起居，太子、诸公五日一朝	石虎让司空李农早晚问候佛图澄的起居，太子、公卿每五天朝见他一次
国人化之，率多事佛，澄之所在，无敢向其方面涕唾者	国内人受此影响，大多崇尚佛教，佛图澄所在之处，无人敢朝着那个方面吐口水
争造寺庙，削发出家	大家争着建造寺庙，削发出家
虎以其真伪杂糅，或避赋役为奸宄，乃下诏问中书曰：佛，国家所奉，里闾小人无爵秩者，应事佛不	石虎因为拜佛出家的人真伪杂混，有的借此躲避赋税和徭役，干不法的勾当，于是下诏书问中书说：佛教是国家所尊奉的，里闾平民百姓没有官爵的人，是否应当事佛
著作郎王度等议曰：王者祭祀，典礼具存	著作郎王度等人评议说：君王的祭祀，有典制礼仪可供遵循
佛，外国之神，非天子诸华所应祠奉	佛是外国的神灵，不是天子和各华夏民族所应祠奉的
汉氏初传其道，唯听西域人立寺都邑以奉之，汉人皆不得出家；魏世亦然	汉朝佛教开始传入，当时只是允许西域人在都邑建立寺庙来祠奉，汉人都不让出家，魏朝也是这样
今宜禁公卿以下毋得诣寺烧香、礼拜；其赵人为沙门者，皆返初服	现在应当禁止公卿以下的人等，不让他们到寺庙烧香、拜佛；凡赵国人当和尚的，都恢复原先的服饰
虎诏曰：朕生自边鄙，忝君诸夏，至于飨祀，应从本俗	石虎下诏说：朕出生在边鄙之地，愧为华夏民族的君上，至于祭祀，应当遵从本来的习俗
其夷、赵百姓乐事佛者，特听之	凡夷族、赵国百姓乐意尊崇佛教的，特别听任其便
赵章武王斌帅精骑二万并秦、雍二州兵以讨薄句大，平之	后赵章武王石斌率精锐骑兵二万人，连同秦州、雍州的士兵讨伐薄句大，平定了他们
成太子班之舅罗演，与汉王相天水上官澹，谋杀成主期，立班子	成汉太子李班的舅父罗演和汉王相、天水人上官澹图谋杀死成汉国主李期，立李班的儿子为王
事觉，期杀演、澹及班母罗氏	事情败露，李期杀死罗演、上官澹及李班生母罗氏
冬，十月，乙未朔，日有食之	冬季，十月，乙未朔，出现日食
慕容仁遣王齐等南还	慕容仁遣送王齐等人归返南方
齐等自海道趣棘城，齐遇风不至	王齐等人从海路开赴棘城，王齐乘坐的船遇上海风，未能到达
十二月，徐孟等至棘城，慕容始受朝命	十二月，徐孟等人到达棘城，慕容开始接受朝廷的任命
是岁，明帝母建安君荀氏卒	这年，明帝母亲建安君荀氏死
荀氏在禁中，尊重同于太后；诏赠豫章郡君	荀氏在宫禁中，受到的尊重如同太后；成帝下诏赐赠名号为豫章郡君
初，张轨及二子、茂，虽保据河右，而军旅之事无岁无之	当初，张轨及两个儿子张、张茂虽然据守河右，但每年都有战事
及张骏嗣位，境内渐平	至张骏继位，境内渐渐平定
骏勤修庶政，总御文武，咸得其用，民富兵强，远近称之以为贤君	张骏辛勤治理各种政事，总领文武官员，让他们各得其用，民富兵强，远近之人都称他为贤君
骏遣将杨宣伐龟兹、鄯善，于是西域诸国焉耆、于阗之属，皆诣臧朝贡	张骏派部将杨宣攻伐龟兹、鄯善，于是西域各国如焉耆，于之类，都赴姑臧朝贡
骏于姑臧南作五殿，官属皆称臣	张骏在姑臧城南建造五座宫殿，官属都自称为臣
春，正月，辛巳，彗星见于奎、娄	春季，正月，辛巳，奎宿、娄宿一带出现慧星
慕容将讨慕容仁，司马高诩曰：仁叛弃君亲，民神共怒；前此海未尝冻，自仁反以来，连年冻者三矣	慕容准备讨伐慕容仁，司马高诩说：慕容仁背叛和抛弃君主亲人，神灵和士民共同恨怒，此前海水从未冻冰，自从慕容仁反叛以来，连续结冻已经三年了
且仁专备陆道，天其或者欲使吾乘海冰以袭之也	况且慕容仁专门防备陆路，上天大概是想让我们乘海结冰时去袭击他吧
从之	慕容听从了他的意见
群僚皆言涉冰危事，不若从陆道	众僚佐都说由冰上过海是危险的事，不如改走陆路
曰：吾计已决，敢沮者斩	慕容说：我计议已定，敢阻拦的人斩首
二月，尚书仆射王彬卒	二月，尚书仆射王彬去世
辛亥，帝临轩，遣使备六礼逆故当阳侯杜女陵阳为皇后，大赦；群臣毕贺	辛亥，成帝驾临殿前，派使者按六礼的仪式迎接原当阳侯杜之女杜陵阳为皇后，大赦天下，群臣都来致贺
夏，六月，段辽遣中军将军李咏袭慕容	夏季，六月，段辽派将军李咏攻袭慕容
咏趣武兴，都尉张萌击擒之	李咏赴武兴，被都尉张萌击败擒获
辽别遣段兰将步骑数万屯柳城西回水，宇文逸豆归攻安晋以为兰声援	段辽另外派遣段兰率步、骑兵数万人驻屯在柳城以西的回水，宇文逸豆归进攻安晋，以此与段兰互为援助
帅步骑五万向柳城，兰不战而遁	慕容率步、骑兵五万人向柳城进发，段兰不战而逃
引兵北趣安晋，逸豆归弃辎重走；遣司马封奕帅轻骑追击，大破之	慕容领兵向北赶赴安晋，宇文逸豆归丢弃辎重逃跑
谓诸将曰：二虏耻无功，必将复至，宜于柳城左右设伏以待之	慕容派司马封奕率轻骑追袭，重创宇文逸豆归所部
乃遣封奕帅骑数千伏于马兜山	慕容对众将领说：这两个敌虏耻于战而无功，必定还会再来，应当在柳城附近设下埋伏等待他们
三月，段辽果将数千骑来寇抄	于是派封奕率骑兵千人埋伏在马兜山
奕纵击，大破之，斩其将荣伯保	三月，段辽果然带领几千骑兵前来侵扰劫掠，封奕出动骑兵攻击，大败敌军，段辽部将荣伯保被杀
前廷尉孔坦卒	前廷尉孔坦死
坦疾笃，庾冰省之，流涕	孔坦病重时，庾冰前往探视，为之流泪
坦慨然曰：大丈夫将终，不问以济国安民之术，乃为儿女子相泣邪	孔坦慷慨地说：大丈夫将死，不向他询问治国安民的办法，却像小儿女一样哭泣吗
冰深谢之	庾冰向他深深致歉
九月，慕容遣长史刘斌、兼郎中令辽东阳景送徐孟等还建康	九月，慕容派长史刘斌、兼郎中令辽东人阳景护送徐孟等人返回建康
冬，十月，广州刺史邓岳遣督护王随等击夜郎、兴古，皆克之	冬季，十月，广州刺史邓岳派督护王随等人进攻夜郎、兴古，都获胜
加岳督宁州	授予邓岳督察宁州
成主期以从子尚书仆射武陵公载有隽才，忌之，诬以谋反，杀之	成汉国主李期因侄子尚书仆射武陵公李载才能俊逸出众，心中妒忌，便诬陷他谋反，将他杀害
索头郁鞠帅众三万降于赵，赵拜郁鞠等十三人为亲赵王，散其部众于冀、青等六州	索头部郁鞠率士众三万人归降后赵，后赵拜授郁鞠等十三人为亲赵王，遣散其部众到冀州、青州等六州之中
赵左校令成公段作庭燎于杠末，高十余丈，上盘置燎，下盘置人，赵王虎试而悦之	后赵左校令成公段在杠竿末稍安装庭燎照明，高十多丈，上盘放置烛燎，下盘安置人，后赵王石虎试用后很喜欢
国子祭酒袁、太常冯怀，以江左安，请兴学校，帝从之	国子祭酒袁、太常冯怀因为江东逐渐安宁，请求兴建学校，成帝听从
辛卯，立太学，征集生徒	辛卯，建立太学，征招学生门徒
而士大夫习尚老、庄，儒术终不振	但士大夫习惯于崇尚老子、庄子，儒学始终不景气
，涣之曾孙也	袁即袁涣曾孙
三月，慕容于乙连城东筑好城以逼乙连，留折冲将军兰勃守之	三月，慕容在乙连成以东修筑好城，威逼乙连城，留下折冲将军兰勃驻守
夏，四月，段辽以车数千两输乙连粟，兰勃击而取之	夏季，四月，段辽使用数千辆车向乙连城运粮，遭兰勃袭击，粮食被夺
六月，辽又遣其从弟扬威将军屈云将精骑夜袭子遵于兴国城，遵击破之	六月，段辽又派遣堂弟、扬威将军段屈云率领精锐骑兵乘夜间偷袭在兴国城的慕容之子慕容遵，被慕容遵击败
安定侯子光，自称佛太子，云从大秦国来，当王小秦国，聚众数千人于杜南山，自称大黄帝，改元龙兴	安定人侯子光自称佛太子，说是从大秦国来，应当在小秦国称王，在杜南山中聚集了数千名士众，自称大黄帝，改年号龙兴
石广讨斩之	石广征讨并斩杀了他
段辽数侵赵边，燕王遣扬烈将军宋回称藩于赵，乞师以讨辽，自请尽帅国中之众以会之，并以其弟宁远将军汗为质	段辽多次侵扰后赵边境，前燕王慕容派扬烈将军宋回向后赵称臣，乞请军队来讨伐段辽，自言将率领国内所有士众会同讨伐，并让自己的兄弟、宁远将军慕容汗到后赵当人质
赵王虎大悦，厚加慰答，辞其质，遣还；密期以明年	后赵王石虎大为喜悦，盛情抚尉、酬答，谢绝慕容汗为人质，遣送他返回，与前燕王秘密约定明年会合
是岁，赵将李穆纳拓跋翳槐于大甯，其故部落多归之	这年，后赵将领李穆安置拓跋翳槐回到大宁，拓跋翳槐原先领有的部落大多归从了他
代王纥那奔燕，国人复奉翳槐，城盛乐而居之	代王拓跋纥那逃奔前燕国，国内人又尊奉拓跋翳槐为代王，在盛乐筑城居住
仇池氐王杨毅族兄初，袭杀毅，并有其众，自立为仇池公，称臣于赵	仇池氐王杨毅的同族之兄杨初，击杀杨毅，兼并杨毅部众，自立为仇池公，向后赵称臣
春，正月，燕王遣都尉赵如赵，听师期	春季，正月，前燕王慕容派都尉赵前往后赵国，打听军队出征的日期
赵王虎将击段辽，募骁勇者三万人，悉拜龙腾中郎	后赵王石虎准备攻击段辽，招募骁勇善战的士兵三万人，全部拜授为龙腾中郎
会辽遣段屈云袭赵幽州，幽州刺史李孟退保易京	适逢段辽派段屈云进攻赵的幽州，幽州刺史李孟后退保守易京
虎乃以桃豹为横海将军，王华为渡辽将军，帅舟师十万出漂渝津；支雄为龙骧大将军，姚弋仲为冠军将军，帅步骑七万为前锋以伐辽	石虎便任命桃豹为横海将军，王华为渡辽将军，率领十万水军由漂渝津出发；又任支雄为龙骧大将军，姚弋仲为冠军将军，率领步兵、骑兵七万人为前锋，前往讨伐段辽
成主期骄虐日甚，多所诛杀，而籍没其资财、妇女，由是大臣多不自安	成汉国主李期日益骄纵暴虐，多所诛杀，收被杀者的资财和妻女入宫，因此大臣们大多惶恐不安
汉王寿素贵重，有威名，期及建宁王越等皆忌之	汉王李寿素来职高位重，享有盛名，李期和建宁王李越等都忌惮他
寿惧不免，每当入朝，常诈为边书，辞以警急	李寿害怕自己不能免祸，每逢入宫朝见，常伪作边境告急文书，以警讯紧急为由推辞不来
赵王虎以燕王不会赵兵攻段辽而自专其利，欲伐之	后赵王石虎因为前燕王慕容没有会合后赵的军队攻击段辽，却独自占有掳获的民众和畜产，因而打算讨伐他
太史令赵揽谏曰：岁星守燕分，师必无功	太史令赵揽劝谏说：岁星正当燕国的分野，出师必然无功
虎怒，鞭之	石虎发怒，鞭击他
赵太子宣帅步骑二万击朔方鲜卑斛摩头，破之，斩首四万余级	后赵太子石宣率领步、骑兵二万人攻击朔方的鲜卑部斛摩头，打败了他，斩首四万多级
冀州八郡大蝗，赵司隶请坐守宰	冀州八郡发生严重蝗灾，后赵司隶请求将州郡长官治罪
赵王虎曰：此朕失政所致，而欲委咎守宰，岂罪己之意邪	后赵王石虎说：这是朕朝政有过失所致，却想归罪地方长官，这哪里符合自己知罪的心意呢
司隶不进谠言，佐朕不逮，而欲妄陷无辜，可白衣领职	司隶不进陈正直的言论，以便辅助我纠正过失，却想随意陷害无辜之人，应当革除爵位品秩，让他以庶民的身份执行司隶的职务
乙未，以司徒导为太傅，都督中外诸军事，郗鉴为太尉，庾亮为司空	乙未，东晋朝廷任命司徒王导为太傅、都督中外诸军事，任郗鉴为太尉，庚亮为司空
六月，以导为丞相，罢司徒官以并丞相府	六月，任王导为丞相，取消司徒的官职，并入丞相府
汉李奕从兄广汉太守乾告大臣谋废立	成汉国李奕的堂兄、广汉太守李乾告发大臣图谋废黜旧君，更立新主
秋，七月，汉主寿使其子广与大臣盟于前殿，徙乾为汉嘉太守；以李闳为荆州刺史，镇巴郡	秋季，七月，成汉国主李寿让儿子李广和大臣们在前殿盟誓，改任李乾为汉嘉太守，让李闳出任荆州刺史，镇守巴郡
闳，恭之子也	李闳即李恭的儿子
九月，汉仆射任颜谋反，诛	九月，成汉仆射任颜谋反，被杀
颜，任太后之弟也	任颜即任太后的兄弟
汉主寿因尽诛成主雄诸子	成汉国主李寿因此全数诛杀成汉旧主李雄的所有子嗣
十二月，段辽自密云山遣使求迎于赵；既而中悔，复遣使求迎于燕	十二月，段辽从密云山派使者向赵请求允许自己归降；不久又后悔，重新派使者到前燕请求允许自己投降
春，正月，辛丑，大赦	春季，正月，辛丑，大赦天下
燕前军师慕容评、广威将军慕容军、折冲将军慕舆根、荡寇将军慕舆袭赵辽西，俘获千余家而去	前燕国前军师慕容评、广威将军慕容军、折冲将军慕舆根、荡寇将军慕舆攻袭赵的辽西，俘获民众一千多家后离去
赵镇远将军石成、积弩将军呼延晃、建威将军张支等追之，评等与战，斩晃、支首	后赵镇远将军石成、积弩将军呼延晃、建威将军张支等人追击，慕容评等同他们交战，斩杀呼延晃和张支
段辽谋反于燕，燕人杀辽及其党与数十人，送辽首于赵	段辽图谋反叛前燕国，前燕人杀死段辽及其门党几十人，把段辽首级送给后赵
五月，代王什翼犍会诸大人于参合陂，议都源川	五月，代王拓跋什翼犍在参合陂会见诸部大人，商议定都于源川
其母王氏曰：吾自先世以来，以迁徙为业；今国家多难，若城郭而居，一旦寇来，无所避之	母亲王氏说：我们从祖先开始，就以迁徙为业，现今国家多难，如果修筑城郭定居，一旦敌寇进犯，就没有躲避之处了
乃止	定都之事便告中止
秋，七月，赵王虎以太子宣为大单于，建天子旌旗	秋季，七月，后赵王石虎任太子石宣为大单于，树立天子旌旗
庚申，始兴文献公王导薨，丧葬之礼视汉博陆侯及安平献王故事，参用天子之礼	庚申，始兴文献公王导去世，丧葬的礼仪比照汉代博陆侯霍光和安平献王刘孚的旧例，参用天子的礼节
八月，壬午，复改丞相为司徒	八月，壬午，晋又改丞相官职为司徒
初，陶侃在武昌，议者以江北有邾城，宜分兵戍之；侃每不答，而言者不已	当初，陶侃镇守武昌，有人论议，认为长江北岸有邾城，应当分兵戍守
侃乃渡水猎，引将佐语之曰：我所以设险而御寇者，正以长江耳	陶侃常常不作答复，但总有人提及此事
邾城隔在江北，内无所倚，外接群夷	陶侃于是渡江围猎，召来将佐们告诉他们说：我之所以设置险阻防御敌寇，正因为有长江而已
夷中利深；晋人贪利，夷不堪命，必引虏入寇	邾城隔在长江北岸，自身没有可以依仗的天险，外部与各夷族接壤，对夷人来说利害关系更大
此乃致祸之由，非以御寇也	如果我们贪图小利，夷人不能忍受，必定领兵前来侵犯，这正是导致祸乱的根由，不是用以抵御敌寇的好方法
且吴时戍此城用三万兵，今纵有兵守，亦无益于江南；若羯虏有可乘之会，此又非所资也	况且吴国当初戍守此城，动用了三万兵众，现在纵然派兵戍守，对江南来说也没什么太大的好处；如果羯族敌虏有可乘之机，占据邾城又没有什么太大的帮助
赵王虎患贵戚豪恣，乃擢殿中御史李巨为御史中丞，特加亲任，中外肃然	后赵王石虎忧虑贵戚们狂放恣肆，于是提升殿中御史李巨为御史中丞，特别加以宠爱和信任，朝廷内外为此肃然
虎曰：联闻良臣如猛虎，高步旷野而豺狼避路，信哉	石虎说：我听说良臣如同猛虎，信步行走于旷野，豺狼因此避开行路，的确如此
汉主寿疾病，罗恒、解思明复议奉晋；寿不从	成汉国主李寿病重，罗恒、解思明又论议推奉李晋为储君，李寿不同意
李演复上书言之；寿怒，杀演	李演又上书谈及这件事，李寿发怒，杀死李演
张骏立辟雍、明堂以行礼	张骏设立辟雍、明堂以进行宣教礼仪活动
十一月，以世子重华行凉州事	十一月，让世子张重华兼管凉州事务
十二月，丁丑，赵太保桃豹卒	十二月，丁丑，后赵太保桃豹故去
丙戌，以骠骑将军琅邪王岳为侍中、司徒	丙戌，东晋朝廷任命骠骑将军、琅邪王司马岳为侍中、司徒
汉李奕寇巴东，守将劳杨败死	成汉国李奕侵犯巴东，守将劳杨战败身死
春，正月，庚子朔，都亭文康侯庾亮薨	春季，正月，庚子朔，都亭文康侯庾亮去世
以护军将军、录尚书何充为中书令	成帝任用护军将军、录尚书何充为中书令
庚戌，以南郡太守庾翼为都督江・荆・司・雍・梁・益六州诸军事、安西将军、荆州刺史、假节，代亮镇武昌	庾戌，任命南郡太守庾翼为都督江州、荆州、司州、雍州、梁州、益州诸军事及安西将军荆州刺史、假节，代替庾亮镇守武昌
时人疑翼年少，不能继其兄	当时人怀疑庾翼年轻，不能继承他兄长庾亮的业绩
翼悉心为治，戎政严明，数年之间，公私充实，人皆称其才	庾翼尽心治理，军务和政务都很严明，数年之间，官府和私人资用充实，众人都称赞他的才能
辛亥，以左光禄大夫陆玩为侍中、司空	辛亥，东晋朝廷任用左光禄大夫陆玩为侍中、司空
宇文逸豆归忌慕容翰才名；翰乃阳狂酣饮，或卧自便利，或被发歌呼，拜跪乞食	宇文逸豆归妒忌慕容翰的才能、名望，慕容翰便佯装癫狂，终日酣饮，有时躺着就大、小便，有时又披散头发，大声歌呼，跪拜乞食
宇文举国贱之，不复省录，以故得行来自遂，山川形便，皆默记之	宇文部全国都看不起他，对他不再检视省察
燕王以翰初非叛乱，以猜嫌出奔，虽在他国，常潜为燕计；乃遣商人王车通市于宇文部以窥翰	慕容翰因此可以来往自由，把宇文部的山川形势，都默记在心
翰见车，无言，抚膺颔之而已	前燕王慕容因为慕容翰当初并非叛乱，是因为心有猜忌才出逃，虽然居住别国，但经常悄悄地为前燕国打算，于是派商人王车到宇文部经商，借此观测慕容翰的心意
曰：翰欲来也	慕容翰见到王车，不说话，只是捶击胸部颔首而已
复使车迎之	慕容说：慕容翰想回来了
翰弯弓三石余，矢尤长大，为之造可手弓矢，使车埋于道旁而密告之	又让王车去迎接他归来
二月，翰窃逸豆归名马，携其二子过取弓矢，逃归	慕容翰拉弓的力量达三石多，箭身尤为长大，慕容为他制造了可手的弓箭，让王车埋在道路旁边，悄悄告诉慕容翰
逸豆归使骁骑百余追之	二月，慕容翰偷出宇文逸豆归的名马，携同两个儿子到路边取出弓箭，上马逃归
翰曰：吾久客思归，既得上马，无复还理	宇文逸豆归派骁勇骑兵一百多人追赶，慕容翰说：我长久客居他国，现在想回乡，既然已经上马，就再没有回去的道理
吾向日阳愚以诳汝，吾之故艺犹在，无为相逼，自取死也	我过去每天佯装痴呆欺蒙你们，其实我以往的技艺并未丢失，你们不要逼迫我，那是自寻死路
追骑轻之，直突而前	追来的骑兵小看慕容翰，径直奔驰而来
翰曰：吾居汝国久，不欲杀汝；汝去我百步立汝刀，吾射之，一发中者汝可还，不中者可来前	慕容翰说：我长久居住在你们国家，心存依恋之情，不想杀死你们，你们离开我一百步把刀树立起来，让我用箭射击，如果一发便射中，你们便可以返回；如果射不中，你们便可以前来抓我
追骑解刀立之，一发，正中其环；追骑散走	追来的骑兵解下佩刀插在地上，慕容翰射出一枝箭，正中刀环，追来的骑兵四散逃走
闻翰至，大喜，恩愚甚厚	慕容听说慕容翰到来，大为喜悦，对他的礼遇很优厚
庚辰，有星孛于太微	庚辰，有异星出现在太微星旁
三月，丁卯，大赦	三月，丁卯，东晋大赦天下
汉人攻拔丹川，守将孟彦、刘齐、李秋皆死	成汉人攻占丹川，丹川守将孟彦、刘齐、李秋全都战死
代王什翼犍始都云中之盛乐宫	代王拓跋什翼犍开始建都于云中的盛乐宫
赵尚书令夔安卒	后赵尚书令夔安去世
赵王虎命司、冀、青、徐、幽、并、雍七州之民五丁取三，四丁取二，合邺城旧兵，满五十万，具船万艘，自河通海，运谷千一百万斛于乐安城	后赵王石虎下令让司、冀、青、徐、幽、并、雍七州的民众五个男丁中选取三个，四个中选取两个，连同邺城旧有军队，足足五十万人，准备舟船一万艘，由黄河通往大海，运送谷物一千一百万斛到乐安城
徙辽西、北平、渔阳万余户于兖、豫、雍、洛四州之地	把辽西、北平、渔阳的一万多户民众迁徙到兖州、豫州、雍州、洛州
自幽州以东至白狼，大兴屯田	从幽州以东到白狼，大举屯田
悉括取民马，有敢私匿者腰斩，凡得四万余匹	把百姓的马匹全部收缴上来，敢于私自藏匿马匹不交出的人处以腰斩之刑，共得马匹四万多匹
大阅于宛阳，欲以击燕	在宛阳举行盛大阅兵式，准备用来进攻前燕国
春，正月燕王使唐国内史阳裕等筑城于柳城之北，龙山之西，立宗庙、宫阙，命曰龙城	春季，正月，前燕王慕容让唐国内史阳裕等人在柳城以北、龙山的西面修建城郭，设立宗庙和宫阙，命名为龙城
二月，甲子朔，日有食之	二月，甲子朔，出现日食
刘翔至建康，帝引见，问慕容镇军平安	刘翔到达建康，成帝召见，询问慕容平安与否
对曰：臣受遣之日，朝服拜章	刘翔回答说：我接受派遣时，他身穿朝服，向南方拜授章表
三月，戊戌，皇后杜氏崩	三月，戊戌，皇后杜氏驾崩
夏，四月，丁卯，葬恭皇后于兴平陵	夏季，四月，丁卯，恭皇后入葬兴平陵
诏实王公以下至庶人皆正土断、白籍	成帝下诏，王公以下至于平民，都确定现居的籍贯，著录于户口版籍
秋，七月，郭、刘翔等至燕，燕王以翔为东夷护军、领大将军长史，以唐国内史阳裕为左司马，典书令李洪为右司马，中尉郑林为军谘祭酒	秋季，七月，郭、刘翔等人到达前燕国，前燕王慕容任命刘翔为东夷护军、兼领大将军长史，任唐国内史阳裕为左司马，典书令李洪为右司马，中尉郑林为军咨祭酒
八月，辛酉，东海哀王冲薨	八月，辛酉，东海哀王司马冲去世
九月，代王什翼犍筑盛乐城于故城南八里	九月，代王拓跋什翼犍在旧城南面八里外修筑盛乐城
代王妃慕容氏卒	代王妃慕容氏去世
冬，十月，匈奴刘虎寇代西部，代王什翼犍遣军逆击，大破之	冬季，十月，匈奴族刘虎侵犯代国西部，代王拓跋什翼犍发军迎击，大破敌军
虎卒，子务桓立，遣使求和于代，什翼犍以女妻之	刘虎去世，儿子刘务桓继立，派使者向代王求和，拓跋什翼犍把女儿许配给他为妻
务桓又朝贡于赵，赵以务桓为平北将军、左贤王	刘务桓又向后赵国朝贡，后赵国任命他为平北将军、左贤王
赵横海将军王华帅舟师自海道袭燕安平，破之	后赵国横海将军王华帅水军由海路进攻前燕国安平，获胜
燕王以慕容恪为渡辽将军，镇平郭	前燕王慕容任用慕容恪为渡辽将军，镇守平郭
自慕容翰、慕容仁之后，诸将无能继者	自从慕容翰、慕容仁之后，众将领中没有人能够接替他们，等慕容恪到达平郭，抚慰旧属，怀柔新附民，多次击败高句丽的军队
及恪至平郭，抚旧怀新，屡破高句丽兵，高句丽畏之，不敢入境	高句丽畏惧幕容恪，不敢再来犯境
十二月，兴平康伯陆玩薨	十二月，兴平康伯陆玩去世
汉主寿以其太子势领大将军、录尚书事	成汉国主李寿让太子李势兼领大将军职、录尚书事
初，成主雄以俭约宽惠得蜀人心	当初，成汉国主李雄因俭约宽厚仁惠得蜀民之心，等到李闳、王嘏从邺城归来，盛赞邺中富庶，宫殿壮观华丽，并且说后赵王石虎靠刑罚杀戮驾驭臣下，所以能控制境内
及李闳、王嘏还自邺，盛称邺中繁庶，宫殿壮丽；且言赵王虎以刑杀御下，故能控制境内	李寿为此倾慕，便将邻近州郡的百姓中，凡每家超出三个以上的壮年男丁，都迁徙来充实成都，大修宫室，制造器玩
寿慕之，徙旁郡民三丁以上者以实成都，大修宫室，治器玩；人有小过，辄杀以立威	人有小过失，就处决以建立威仪
左仆射蔡兴、右仆射李嶷皆坐直谏死	左仆射蔡兴、右仆射李嶷都因直言规谏被杀
民疲于赋役，吁嗟满道，思乱者众矣	百姓因赋税和劳役疲惫不堪，吁嗟叹息声充溢于道路，许多人图谋作乱
春，正月，己未朔，日有食之	春季，正月，己未朔，出现日食
乙丑，大赦	乙丑，东晋大赦天下
三月，初以武悼后配食武帝庙	三月，开始把武悼后的牌位供奉在武帝庙
甲午，琅邪王即皇帝位，大赦	甲午，琅邪王司马岳即帝位，大赦天下
己亥，封成帝子丕为琅邪王，奕为东海王	己亥，封成帝儿子司马丕为琅邪王，司马奕为东海王
冬，十月，燕王迁都龙城，赦其境内	冬季，十月，前燕王慕容迁都至龙城，赦其境内罪囚
十二月，壬子，立妃褚氏为皇后	十二月，壬子，康帝立妃子褚氏为皇后
征豫章太守褚裒为侍中、尚书	征召豫章太守褚裒为侍中、尚书
裒自以后父，不愿居中任事，苦求外出，乃除建威将军、江州刺史，镇半洲	褚裒因为自己是褚皇后的父亲，不愿意在内廷任职，苦苦乞求外出，于是被任为建威将军、江州刺史，镇守半洲
春，二月，高句丽王钊遣其弟称臣入朝于燕，贡珍异以千数	春季，二月，高句丽王钊派兄弟去前燕国入朝称臣，进贡珍宝异物数以千计
燕王乃还其父尸，犹留其母为质	前燕王慕容这才交还其父尸体，但仍然扣留他们的母亲作人质
赵太子宣击鲜卑斛提，大破之，斩首三万级	后赵太子石宣进攻鲜卑部斛提，重创其军，斩首三万级
宇文逸豆归执段辽弟兰，送于赵，并献骏马万匹	宇文逸豆归执获段辽的兄弟段兰，送到后赵国，并且献上骏马一万匹
赵王虎命兰帅所众鲜卑五千人屯令支	后赵王石虎命令段兰率领追从他的鲜卑部五千人屯军令支
庾翼欲移镇襄阳，恐朝廷不许，乃奏云移镇安陆	庾翼想转移镇守地到襄阳，怕朝廷不同意，于是上奏说移镇安陆
帝及朝士皆遣使譬止翼，翼遂违诏北行；至夏口，复上表请镇襄阳	康帝和朝廷大臣都派使者晓谕制止，庾翼便违背诏令向北行进，到达夏口后，又上表请求镇守襄阳
翼时有众四万，诏加翼都督征讨诸军事	庾翼当时拥有兵众四万人，康帝下诏加授他都督征讨诸军事
先是车骑将军、扬州刺史庾冰屡求出外，辛巳，以冰都督荆・江・宁・益・梁・交・广七州・豫州之四郡诸军事、领江州刺史、假节，镇武昌，以为翼继援	此前，车骑将军、扬州刺吏庾冰多次请求外出任职，辛巳，任命庾冰都督荆州、江州、宁州、益州、梁州、交州、广州及豫州等四郡诸军事，兼领江州刺史、假节，镇守武昌，作为庾翼的后援
征徐州刺史何充为都督扬・豫・徐州之琅邪诸军事，领扬州刺史，录尚书事，辅政	征召徐州刺史何充为都督扬州、豫州、徐州的琅邪诸军事，兼领扬州刺史，录尚书事，辅佐朝政
以琅邪内史桓温为都督青・徐・兖三州诸军事、徐州刺史，褚裒为卫将军，领中书令	任命琅邪内史桓温为都督青州、徐州、兖州诸军事及徐州刺史，褚裒任卫将军，兼领中书令
冬十一月，己巳，大赦	冬季，十一月，己巳，东晋大赦天下
春，正月，赵王虎享群臣于太武殿，有白雁百余集马道之南，虎命射之，皆不获	春季，正月，后赵王石虎在太武殿宴享群臣，有一百多只白雁停栖在马道的南面，石虎让人射雁，都没射中
时诸州兵集者百余万，太史令赵揽密言于虎曰：白雁集庭，宫室将空之象，不宜南行	当时各州军队会集起来已有一百多万人，太史令赵揽秘密地对石虎说：白雁停栖庭院，是宫室将要空寂无人的征兆，不适宜向南进发
虎信之，乃临宣武观大阅而罢	石虎相信他，于是驾临宣武观，举行盛大的阅兵式，然后作罢
汉主势改元太和；尊母阎氏为皇太后，立妻李氏为皇后	成汉国主李势改年号为太和，尊奉母亲阎氏为皇太后，册立妻子李氏为皇后
代王什翼犍遣其大人长孙秩迎妇于燕	代王拓跋什翼犍派其大人长孙秩到前燕国迎娶妻子
夏，四月，凉州将张败赵将王擢于三交城	夏季，四月，凉州将领张在三交城击败后赵将领王擢
赵平北将军尹农攻燕凡城，不克而还	后赵北平将军尹农进攻前燕国凡城，不胜而退
汉太史令韩皓上言：荧惑守心，乃宗庙不修之谴	成汉国太史令韩皓上书说：火星在心宿，是对不修缮宗庙的谴责
汉主势命群臣议之	成汉国主李势令群臣论议此事
相国董皎、侍中王嘏以为：景、武创业，献、文承基，至亲不远，无宜疏绝	相国董皎、侍中王嘏认为：景皇帝李特、武皇帝李雄创定国家大业，献皇帝李骧、文皇帝李寿禀承国家政权，至亲的关系并不疏远，不应当疏远绝祀
乃更命祀成始祖、太宗，皆谓之汉	于是重新下令祭祀成始祖李特和太宗李雄，都用汉的称谓
中书令褚裒固辞枢要；闰月，丁巳，以裒为左将军、都督兖州・徐州之琅邪诸军事、兖州刺史，镇金城	晋中书令褚裒坚持辞绝枢要的重任，闰月，丁巳，任褚裒为左将军、都督兖州和徐州的琅邪诸军事、兖州刺史，镇守金城
帝疾笃，庾冰、庾翼欲立会稽王昱为嗣；中书监何充建议立皇子聃，帝从之	康帝病重，庾冰、庾翼想扶立会稽王司马昱为嗣君，中书监何充建议册立皇子司马聃，康帝听从何充的建议
九月，丙申，立聃为皇太子	九月，丙申，立司马聃为皇太子
戊戌，帝崩于式乾殿	戊戌，康帝在式乾殿驾崩
己亥，何充以遗旨奉太子即位，大赦	己亥，何充按康帝遗诏推奉太子即皇帝位，大赦天下
由是冰、翼深恨充	由此庾冰、庾翼深深痛恨何充
尊皇后褚氏为皇太后	穆帝尊奉康帝皇后褚氏为皇太后
时穆帝方二岁，太后临朝称制	当时穆帝刚两岁，太后临朝亲政
何充加中书监，录尚书事	何充被加授中书监，录尚书事
充自陈既录尚书，不宜复监中书；许之，复加侍中	何充自己陈述，既任录尚书事，不应再领导中书，获得允许，又加授他为侍中
冬，十月，乙丑，葬康帝于崇平陵	冬季，十月，乙丑，康帝入葬崇平陵
春，正月，甲戌朔，皇太后设白纱帷于太极殿，抱帝临轩	春季，正月，甲戌朔，皇太后在太极殿设置白纱帷怅，抱着穆帝驾临殿前
诏征卫将军褚裒，欲以为扬州刺史、录尚书事	朝廷下诏征召卫将军褚裒，想让他任扬州刺史，录尚书事
吏部尚书刘遐、长史王胡之说裒曰：会稽王令德雅望，国之周公也，足下宜以大政授之	吏部尚书刘遐、长史王胡之劝说褚裒道：会稽王司马昱德行昭著、素负雅望，是国家的周公，足下应把国家大政交给他
裒乃固辞，归藩	褚裒于是坚决辞谢不受封职，回归藩镇
壬戌，以会稽王昱为抚军大将军，录尚书六条事	壬戌，朝廷任命会稽王司马昱为抚军大将军，录尚书六条事
燕有黑龙、白龙见于龙山，交首游戏，解角而去	前燕国在龙山出现黑龙和白龙，交首戏游，丢下龙角离开
燕王亲祀以太牢，赦其境内，命所居新宫曰和龙	前燕王慕容亲自用太牢的礼节祭祀，赦免境内罪犯，把自己居住的新宫殿命名为和龙
八月，豫州刺史路永叛奔赵，赵王虎使永屯寿春	八月，豫州刺史路永背叛晋投奔后赵，后赵王石虎让他屯军寿春
冬，十月，燕王使慕容恪攻高句丽，拔南苏，置戍而还	冬季，十月，前燕王慕容派慕容恪进攻高句丽，攻克南苏，设置戍守后返回
春，正月，丙寅，大赦	春季，正月，丙寅，晋大赦天下
己卯，都乡文穆公何充卒	己卯，都乡文穆公何充死
充有器局，临朝正色，以社稷为己任，所选用皆以功效，不私亲旧	何充兼具才识和度量，上朝时面容端肃，以治国为己任，所选用的人都有所成就，不为亲朋故友徇私情
二月，癸丑，以左光禄大夫蔡谟领司徒，与会稽王昱同辅政	二月，癸丑，晋任左光禄大夫蔡谟兼领司徒职务，与会稽王司马昱共同辅佐朝政
褚裒荐前光禄大夫顾和、前司徒左长史殷浩；三月，丙子，以和为尚书令，浩为建武将军、扬州刺史	褚裒向朝廷荐举前光禄大夫顾和、前司徒左长史殷浩，三月，丙子，朝廷任命顾和为尚书令，殷浩为建武将军、扬州刺史
和有母丧	顾和为亡母服丧，坚持辞绝不肯出仕，对自己亲近的人说：古人中有脱下丧服从事君王事务的，是因为他们的才能足以济世治事
固辞不起，谓所亲曰：古人有释衰从王事者，以其才足干时故也；如和者，正足以亏孝道，伤风俗耳	像我这样的人如果这么做，就只有使孝道有损，伤风败俗而已
识者美之	有见地的人都称赞他
浩亦固辞	殷浩也坚持辞谢不受职
会稽王昱与浩书曰：属当厄运，危弊理极，足下沈识淹长，足以经济	会稽王司马昱给殷浩写信说：国家正当困厄的命运，危殆的弊病理当终尽，足下的见识深远、广博、出众，足以经世救国
若复深存挹退，苟遂本怀，吾恐天下之事于此去矣	如果再深存谦抑之心，随随便便满足个人的心愿，我怕天下之事就此无可挽回了
足下去就，即时之废兴，则家国不异，足下宜深思之	足下的去就，就是时世的废兴，家庭与国家命运紧密相连不可分割，足下还是好好想想
浩乃就职	殷浩这才就职
夏，四月，己酉朔，日有食之	夏季，四月，己酉朔，出现日食
赵将军王擢击张重华，袭武街，执护军曹权、胡宣，徙七千余户于雍州	后赵将军王擢攻打张重华，袭击武街，抓获了护军曹权、胡宣，将七千多户百姓迁徙到雍州
凉州刺史麻秋、将军孙伏都攻金城，太守张冲请降，凉州震恐	凉州刺史麻秋、将军孙伏都攻打金城，太守张冲请求投降，凉州人十分震惊恐惧
冬，汉太保李奕自晋寿举兵反，蜀人多从之，众至数万	冬季，成汉太保李奕在晋寿起兵反叛，蜀人大多都跟从他，兵众多达数万
汉主势登城拒战，奕单骑突门，门者射而杀之，其众皆溃	成汉国主李势登上城墙抵御，李奕单身匹马冲击城门，守卫城门的人向他射击，射死了他，其兵众全都溃逃
势大赦境内，改元嘉宁	李势在境内实行大赦，改年号为嘉宁
春，二月，桓温军至青衣	春季，二月，桓温的部队抵达青衣
汉主势大发兵，遣叔父右卫将军福、从兄镇南将军权、前将军昝坚等将之，自山阳趣合水	成汉国主李势大举出兵，派叔父右卫将军李福、堂兄镇南将军李权、前将军昝坚等人率领兵众，从山阳开赴合水
诸将欲设伏于江南以待晋兵，昝坚不从，引兵自江北鸳鸯渡向犍为	众将领想要在长江以南设下埋伏以等待东晋的军队，昝坚没有听从，带领军队从长江以北的鸳鸯渡过长江，奔赴犍为
汉故尚书仆射王誓、镇东将军邓定、平南将军王润、将军隗文等皆举兵反，众各万余	成汉过去的尚书仆射王誓、镇东将军邓定、平南将军王润、将军隗文等人全都起兵反叛，各自拥有兵众数万
桓温自击定，使袁乔击文，皆破之	桓温亲自攻打邓定，让袁乔攻打隗文，全都大败了他们
温命益州刺史周抚镇彭模，斩王誓、王润	桓温命令益州刺史周抚镇守彭模，斩杀了王誓、王润
温留成都三十日，振旅还江陵	桓温在成都逗留了三十天，整顿部队后返回了江陵
李势至建康，封归义侯	李势抵达建康，被封为归义侯
夏，四月，丁巳，邓定、隗文等入据成都，征虏将军杨谦弃涪城，退保德阳	夏季，四月，丁巳，邓定、隗文等人进占成都，征虏将军杨谦放弃了涪城，退守德阳
六月，辛酉，大赦	六月，辛酉，晋实行大赦
秋，七月，林邑复陷日南，杀督护刘雄	秋季，七月，林邑的军队又攻陷日南，杀掉了督护刘雄
隗文、邓定等立故国师范长生之子贲为帝而奉之，以妖异惑众，蜀人多归之	隗文、邓定等人立前国师范长生的儿子范贲为帝，并尊奉他，他们靠妖异之辞迷惑民众，蜀人大多归附
赵王虎复遣征西将军孙伏都、将军刘浑帅步骑二万会麻秋军，长驱济河，击张重华，遂城长最	后赵王石虎又派征西将军孙伏都、将军刘浑率领步、骑兵二万人与麻秋的军队会合，长驱直入，渡过黄河，攻打张重华，屯军长最
谢艾建牙誓众，有风吹旌旗东南指，索遐曰：风为号令，今旌旗指敌，天所赞也	谢艾在军前竖起大旗与兵众誓师，恰好风吹旌旗指向东南，索遐说：风向就是号令，现在旌旗指向敌人，这是上天的助
艾军于神鸟，王擢与艾前锋战，败，走还河南	谢艾屯军于神鸟，王擢与谢艾的前锋部队交战，被打败，逃回黄河以南
八月，戊午，艾进击秋，大破之，秋遁归金城	八月，戊午，谢艾进军攻打麻秋，大败麻秋，麻秋逃回金城
虎闻之，叹曰：吾以偏师定九州，今以九州之力困于罕，彼有人焉，未可图也	石虎听说以后，叹息道：我靠部分军队平定了九州，如今拥有九州的兵力却受困于罕，他们有人才在这里，不可图谋
艾还，讨叛虏斯骨真等万余落，皆破平之	谢艾班师返回，讨伐反叛敌虏的斯骨真等一万多个部落，全都打败平定了他们
赵王虎据十州之地，聚敛金帛，及外国所献珍异，府库财物，不可胜纪；犹自以为不足，悉发前代陵墓，取其金宝	后赵王石虎占据了十州的地域，聚集收敛金帛，以及外国所进献的珍异宝物，府库里的财物，不可胜数，但自己还是觉得不够，把前代的陵墓全都挖掘开，夺走了其中的金宝
赵麻秋又袭张重华将张瑁，败之，斩首三千余级	后赵的麻秋又攻袭张重华的部将张瑁，打败了他，斩首三千多级
罕护军李逵帅众七千降于赵，自河以南，氐、羌皆附于赵	罕护军李逵率领七千兵众投降了后赵，自黄河以南，氐族、羌族全都归附了后赵
冬，十月，乙丑，遣侍御史俞归至凉州，授张重华侍中、大都督、督陇右・关中诸军事、大将军、凉州刺史、西平公	冬季，十月，乙丑，晋派侍御史俞归到凉州，授予张重华侍中、大都督、督陇右、关中诸军事、大将军、凉州刺史、西平公
归至姑臧，重华欲称凉王，未肯受诏，使所亲沈猛私谓归曰：主公奕世为晋忠臣，今曾不如鲜卑，何也	俞归抵达姑臧，张重华想称凉王，不肯接受诏命，让亲信沈猛私下里对俞归说：主公世代都是晋王室的忠臣，如今却竟然不如鲜卑，为什么
朝廷慕容为燕王，而主公才为大将军，何以褒劝忠贤乎	朝廷封慕容为燕王，而主公仅仅才是大将军，靠什么褒奖勉励忠臣贤良呢
明台宜移河右，共劝州主为凉王	您应该向黄河以西的民众发布文告，共同劝州主作凉王
人臣出使，苟利社稷，专之可也	臣下出使于外，如果是对国家有利的事情，擅自决定也是可以的
归曰：吾子失言	俞归说：阁下说错了
昔三代之王也，爵之贵者莫若上公；及周之衰，吴、楚始僭号称王，而诸侯不之非，盖以蛮夷畜之也；借使齐、鲁称王，诸侯岂不四面攻之乎	过去三代称王的时候，尊贵的爵位没有什么能比得上上公；等到周室衰微，吴国、楚国开始僭越封号称为王，而其他诸侯国不加非难，是因为把他们作为蛮夷来对待，假使齐国、鲁国称王，其他诸侯国岂不四面攻击他们吗
汉高祖封韩、彭为王，寻皆诛灭，盖权时之宜，非厚之也	汉高祖封韩信、彭越为王，不久把他们全都诛灭，这是一时的权宜之计，不是厚待他们
圣上以贵公忠贤，故爵以上公，任以方伯，宠荣极矣，岂鲜卑夷狄所可比哉	圣主因为主公忠诚贤明，所以赐爵上公，授以一方重任，恩宠荣耀登峰造极，难道是鲜卑夷狄所能比拟的吗
且吾闻之，功有大小，赏有重轻	况且我听说，功有大小，赏有重轻
今贵公始继世而为王，若帅河石之众，东平胡、羯，修复陵庙，迎天子返洛阳，将何以加之乎	如今主公刚刚继位就称王，如果率领黄河以西的民众，东进平定胡人、羯人，修复陵庙，迎接天子返回洛阳，将会被加授什么职位呢
重华乃止	张重华于是放弃了称凉王的打算
武都氐王杨初遣使来称藩，诏以初为使持节、征南将军、雍州刺史、仇池公	武都氐王杨初派使者前来向晋称藩，朝廷下诏，任命杨初为使持节、征南将军、雍州刺史、仇池公
夏，四月，林邑寇九真，杀士民什八九	夏季，四月，林邑国的军队进犯九真郡，当地的士兵百姓十之八九被杀
朝廷论平蜀之功，欲以豫章郡封桓温	东晋朝廷讨论平定蜀汉的功劳，想把豫章郡赐封给桓温
尚书左丞荀蕤曰：温若复平河、洛，将何以赏之	尚书左丞荀蕤说：桓温如果再平定了黄河、洛水一带，那将用什么赏赐他呢
乃加温征西大将军、开府仪同三司，封临贺郡公；加谯王无忌前将军；袁乔龙骧将军，封湘西伯	于是朝廷让桓温担任征西大将军、开府仪同三司，封为临贺郡公，让谯王司马无忌担任前将军，让袁乔出任龙骧将军，并封为湘西伯
蕤，菘之子也	荀蕤是荀菘的儿子
燕王有疾，召世子俊属之曰：今中原未平，方资贤杰以经世务	前燕王慕容身患疾病，他召来太子慕容俊嘱咐说：如今中原尚未平定，正是需要依靠贤良杰出人士掌管朝政的时候
恪智勇兼济，才堪任重，汝其委之，以成吾志	慕容恪智勇双全，才能出众，你应当委他以重任，以实现我入主中原的远大志向
又曰：阳士秋士行高洁，忠干贞固，可托大事，汝善待之	又说：阳鹜具有高尚的士大夫品行，忠诚不二，坚贞不屈，可以委托他掌管大事，一定要很好地对待他
九月，丙申，薨	九月，丙申，前燕王慕容去世
赵王虎即皇帝位，大赦，改元太宁；诸子皆进爵为王	后赵王石虎即皇帝位，实行大赦，改年号为太宁，并将儿子们的爵位全都晋升为王
夏，四月，益州刺史周抚、龙骧将军朱焘击范贲，斩之，益州平	夏季，四月，益州刺史周抚、龙骧将军朱焘率兵攻打范贲，将其斩杀，益州得以平定
诏遣谒者陈沈如燕，拜慕容俊为使持节、侍中、大都督、督河北诸军事、幽・平二州牧、大将军、大单于、燕王	东晋穆帝下诏书派遣使者陈沈前往前燕，授予慕容俊使持节、侍中、大都督、督河北诸军事以及，幽、平二州牧、大将军、大单于、燕王等官职
桓温遣督护滕帅交、广之兵击林邑王文于卢容，为文所败，退屯九真	桓温派督护滕率领交、广二州的士兵在卢容攻击林邑王范文，反被范文打败，只好撤退驻扎在九真郡
六月，葬赵王虎于显原陵，庙号太祖	六月，后赵国主石虎被安葬在显原陵，上庙号为太祖
赵乐平王苞谋帅关右之众攻邺，左长史石光、司马曹曜等固谏，苞怒，杀光等百余人	后赵乐平王石苞谋划率领关右的兵众攻打邺城，左长史石光、司马曹曜等人竭力劝谏，石苞大怒，杀掉了石光等一百多人
苞性贪而无谋，雍州豪杰知其无成，并遣使告晋，梁州刺史司马勋帅众赴之	石苞生性贪婪但无谋略，雍州的豪杰之士都知道他一事无成，于是就一起派人把他想攻打邺城的事情报告了东晋朝廷，梁州刺史司马勋便率领兵众开赴雍州
杨初袭赵西城；破之	杨初袭击并攻破了后赵国的西城
九月，凉州官属共上张重华为丞相、凉王、雍・秦・凉州三牧	九月，凉州的官吏们共同拥戴张重华为丞相、凉王及雍、秦、凉三州的州牧
重华屡以钱帛赐左右宠臣；又喜博弈，颇废政事	张重华经常用钱帛赏赐周围所宠信的大臣们，又喜欢玩六博和围棋，很耽误政事
征事索振谏曰：先王夙夜勤俭以实府库，正以雠耻未雪，志平海内故也	征事索振劝他说：先王昼夜勤于政务，生活简朴，以使国家府库充实，正是由于仇恨未报，耻辱未雪，立志要平定海内的缘故
殿下嗣位之初，强寇侵逼，赖重饵之故，得战士死力，仅保社稷	殿下刚刚即位的时候，强敌前来进犯，依赖重赏，才得到战士们的拼死效力，勉强保住江山
今蓄积已虚而寇雠尚在，岂可轻有耗散，以与无功之人乎	如今积蓄已经空虚，而敌人与仇恨依然存在，怎么能轻易地耗费，把它送给无功之辈呢
昔汉光武躬亲万机，章奏诣阙，报不终日，故能隆中兴之业	过去汉光武帝日理万机，奏章文书送到朝廷后，复诏不出当天就发下，所以他才能使中兴大业兴隆昌盛
今章奏停滞，动经时月，下情不得上通，沈冤困于囹圄，殆非明主之事也	如今奏章文书滞留积压，往返传递动辄数月，下情不能上达，沉冤困在牢狱，这大概不是英明的君主所干的事情
重华谢之	张重华对索振表示谢罪
赵主鉴使乐平王苞、中书令李松、殿中将军张才夜攻石闵、李农于琨华殿，不克，禁中扰乱	后赵国主石鉴派乐平王石苞、中书令李松、殿中将军张才夜里去琨华殿攻打石闵、李农，没有成功，引起了宫中的混乱
鉴惧，伪若不知者，夜斩松、才于西中华门，并杀苞	石鉴很害怕，装作不知其事的样子，当夜就在西中华门杀掉了李松、张才，并杀了石苞
燕王俊遣使至凉州，约张重华共击赵	前燕王慕容俊派遣使者到凉州，与张重华相约共同攻打后赵
高句丽王钊送前东夷护军宋晃于燕、燕王俊赦之，更名曰活，拜为中尉	高句丽王钊遣送以前的东夷护军宋晃到达前燕国，前燕王慕容俊赦免了他，将其名改为宋活，授官中尉
二月，燕王俊使慕容霸将兵二万自东道出徒河，慕舆于自西道出塞，俊自中道出卢龙塞以伐赵	二月，前燕王慕容俊派慕容霸统率兵卒二万人由东路出徒河，慕舆于由西路出塞，慕容俊自己则由中路出卢龙塞，前去讨伐赵
以慕容恪、鲜于亮为前驱，命慕舆槎山通道	他以慕容恪、鲜于亮为前锋，命令慕舆开通山路
留世子晔守龙城，以内史刘斌为大司农，与典书令皇甫真留统后事	留下世子慕容晔镇守龙城，任命内史刘斌为大司农，和典书令皇甫真一起留下统管后方事务
魏主闵复姓冉氏，尊母王氏为皇太后，立妻董氏为皇后，子智为皇太子，胤、明、裕皆为王	魏国主石闵恢复冉姓，尊奉母亲王氏为皇太后，立妻子董氏为皇后，立儿子冉智为皇太子，冉胤、冉明、冉裕三个儿子全都被封为王
以李农为太宰、领太尉、录尚书事，封齐王，其子皆封县公	任命李农为太宰、兼太尉、录尚书事，并封为齐王，李农的儿子们全都被封为县公
遣使者持节赦诸军屯；皆不从	冉闵派遣使者带着作为凭证的符节向驻扎在各地的将领通报任命，他们都不服从
夏，四月，赵主祗遣汝阴王琨将兵十万伐魏	夏季，四月，后赵国主石祗派汝阴王石琨统领，十万士兵讨伐魏国
五月，庐江太守袁真攻魏合肥，克之，虏其居民而还	五月，庐江太守袁真攻克魏国的合肥，掳劫那里的民众返回
六月，赵汝阴王琨进据邯郸，镇南将军刘国自繁阳会之	六月，后赵国汝阴王石琨进攻占据邯郸，镇南将军刘国从繁阳来与他会师
魏卫将军王泰击琨，大破之，死者万余人	魏国卫将军王泰攻击石琨，把石琨打得大败，死亡的将士达一万多人
刘国还繁阳	刘国只好返回了繁阳
初，段兰卒于令支，段龛代领其众，因石氏之乱，拥部落南徙	当初，段兰死于令支，段龛代替他率领兵众，乘着石氏大乱的机会，率领着部落南迁
秋，七月，龛引兵东据广固，自称齐王	秋季，七月，段龛带领士兵东进，占据了广固，自称齐王
八月，代郡人赵帅三百余家叛燕归赵并州刺史张平	八月，代郡人赵率领三百多家的兵众背叛前燕国而归附后赵国的并州刺史张平
燕王俊徙广宁、上谷二郡民于徐无，代郡民于凡城	前燕王慕容俊将广宁、上谷二郡的百姓迁徙到徐无，将代郡的百姓迁徙到凡城
春，正月，丁酉，日有食之	春季，正月，丁酉，出现日食
段龛请以青州内附；二月，戊寅，以龛为镇北将军	段龛请求以所据的青州归附东晋
封齐公	二月，戊寅，东晋朝廷任命段龛为镇北将军，封为齐公
赵并州刺史张平遣使降秦，秦王以平为大将军、冀州牧	后赵国并州刺史张平派使者去向前秦投降，前秦王任命张平为大将军、冀州牧
燕王俊还蓟	前燕王慕容俊回到蓟城
三月，姚襄及赵汝阴王琨各引兵救襄国	三月，姚襄及后赵汝阴王石琨分别率兵救援襄国
冉闵遣车骑将军胡睦拒襄于长芦，将军孙威拒琨于黄丘，皆败还，士卒略尽	冉闵派车骑将军胡睦在长芦阻击姚襄，派将军孙威在黄丘阻击石琨，但全都失败而返，士兵死亡殆尽
秦王健分遣使者问民疾苦，搜罗隽异，宽重敛之税，弛离宫之禁，罢无用之器，去侈靡之服，凡赵之苛政不便于民者，皆除之	前秦王苻健分别派遣使者访问百姓的疾苦，搜罗杰出人才，放宽了横征暴敛的赋税，开放了为修建离宫划定的禁区，撤掉了没有用处的事务和器具，更换了华丽奢侈的服装，凡是后赵国制定的不利于百姓的繁琐苛刻的政令，全都予以废除
刘显弑赵王祗及其丞相乐安王炳、太宰赵庶等十余人，传首于邺	刘显杀掉了后赵王石祗及其丞相乐安王石炳、太宰赵庶等十多人，并将首级传送到邺城
骠骑将军石宁奔柏人	骠骑将军石宁逃奔到柏人县
魏主闵焚祗首于通衢，拜显上大将军、大单于、冀州牧	魏国主冉闵在邺城的通衢大道上焚烧了石祗的首级，授予刘显上大将军、大单于、冀州牧的官职
五月，赵兖州刺史刘启自鄄城来奔	五月，后赵国兖州刺史刘启从鄄城来投奔东晋
秋，七月，刘显复引兵攻邺，魏主闵击败之	秋季，七月，刘显再次率兵攻打邺城，被魏国主冉闵击败
显还，称帝于襄国	刘显返回，在襄国称帝
厍官伟帅部众自上党降燕	库官伟率领他的部众从上党来投降前燕
逄钓亡归渤海，招集旧众以叛燕	逄钓逃亡回渤海，召集起过去的旧部兵众背叛了前燕
乐陵太守贾坚使人告谕乡人，示以成败，钓部众稍散，遂来奔	乐陵太守贾坚派人劝谕百姓，给他们分析成败大势，逄钓的旧部逐渐离散，于是逄钓来投奔东晋
吐谷浑叶延卒，子碎奚立	吐谷浑的首领叶延去世，儿子碎奚继位
燕王俊如龙城	前燕王慕容俊到了龙城
丁零翟鼠帅所部降燕，封为归义王	丁零人翟鼠率领兵众投降了前燕，被封为归义王
春，正月，辛卯，日有食之	春季，正月，辛卯，出现日食
司马勋既还汉中，杜洪、张琚屯宜秋	司马勋已经回到汉中，杜洪、张琚驻扎在宜秋
洪自以右族轻琚，琚遂杀洪，自立为秦王，改元建昌	杜洪自以为出身名门望族而轻视张琚，张琚于是就杀掉了杜洪，自立为秦王，改年号为建昌
刘显攻常山，魏主闵留大将军蒋使辅太子智守邺，自将八千骑救之	刘显进攻常山，魏国主冉闵留下大将军蒋辅佐太子冉智守卫邺城，自己统率八千骑兵前去救援
显大司马清河王宁以枣强降魏	刘显的大司马清河人王宁投降了魏国，将枣强县拱手交出
闵击显，败之，追奔至襄国	冉闵攻击刘显，打败了他，追击到襄国
显大将军曹伏驹开门纳闵，闵杀显及其公卿已下百余人，焚襄国宫室，迁其民于邺	刘显的大将军曹伏驹打开城门让石闵进入，石闵杀掉了刘显及其公卿以下的官吏一百多人，焚烧了襄国的宫室，将襄国的百姓迁徙到邺城
赵汝阴王琨以其妻妾来奔，斩于建康市，石氏遂绝	后赵汝阴王石琨带着他的妻妾前来东晋投降，被斩杀在建康街头，于是石氏被彻底根绝了
尚书左丞孔严言于殷浩曰：比来众情，良可寒心，不知使君当何以镇之	尚书左丞孔严向殷浩进言说：近来人们的情绪，真令人心寒，不知您将用什么办法使其安定
愚谓宜明受任之方，韩、彭专征伐，萧、曹守管，内外之任，各有攸司；深思廉、蔺屈身之义，平、勃交欢之谋，令穆然无间，然后可以保大定功也	我认为应该明确官吏的职责，韩信、彭越专事征伐，萧何、曹参留守理财，对内对外的职责，各有所司；还应该深思廉颇、蔺相如为国家利益而捐弃前嫌的道理，陈平、周勃为制止吕氏专权而结为至交的谋略，让人们和睦无间，然后就可以保有天下，成就功业了
观近日降附之徒，皆人面兽心，贪而无亲，恐难以义感也	看看近来投降归附的那些人，全都是人面兽心，贪婪之极而且六亲不认，恐怕难以用道义感化他们
浩不从	殷浩没有听从孔严的意见
严，愉之从子也	孔严是孔愉的侄子
乙巳，燕王俊还蓟，稍徙军中文武兵民家属于蓟	乙巳，前燕王慕容俊回到蓟城，并将少量的军队文武官员、士兵的家属迁徙到蓟城
魏主闵既克襄国，因游食常山、中山诸郡	魏国主冉闵既已攻克襄国，因此就在常山、中山等地周游吃喝
赵立义将军段勤聚胡、羯万余人保据绎幕，自称赵帝	后赵国立义将军段勤聚集了胡族、羯族一万多人保卫据守绎幕，自称为赵帝
夏，四月，甲子，燕王俊遣慕容恪等击魏，慕容霸等击勤	夏季，四月，甲子，前燕王慕容俊派慕容恪等人率兵攻击魏国，派慕容霸等人率兵攻击段勤
秦以张遇为征东大将军、豫州牧	前秦任命张遇为征东大将军、豫州牧
五月，秦主健攻张琚于宜秋，斩之	五月，前秦国主苻健在宜秋攻打张琚，将其斩杀
邺中大饥，人相食，故赵时宫人被食略尽	邺中地区发生严重饥荒，人们互相残食，过去后赵的宫人被残食殆尽
蒋使侍中缪嵩、詹事刘猗奉表请降，且求救于谢尚	蒋派侍中缪嵩、詹事刘猗向东晋朝廷进奉降表，请求投降，并且向谢尚求救
庚寅，燕王俊遣广威将军慕容军、殿中将军慕舆根、右司马皇甫真等帅步骑二万助慕容评攻邺	庚寅，前燕王慕容俊派广威将军慕容军、殿中将军慕舆根、右司马皇甫真等人率领步、骑兵二万人协助慕容评攻打邺城
辛卯，燕人斩冉闵于龙城	辛卯，前燕人在龙城斩杀了冉闵
会大旱、蝗，燕王俊谓闵为祟，遣使祀之，谥曰悼武大王	恰好这时发生了严重的旱灾、蝗灾，前燕王慕容俊说这是冉闵在作祟，便派使臣去祭祀他，给他追封谥号为悼武天王
甲申，秦主健还长安	甲申，前秦国主苻健返回长安
赵故西中郎将王擢遣使请降，拜擢秦州刺史	后赵国过去的西中郎将王擢派遣使者向东晋请求投降，朝廷授予王擢秦州刺史职务
丁酉，以武陵王为太宰	丁酉，东晋朝廷任命武陵王司马为太宰
丙辰，燕王俊如中山	丙辰，前燕王慕容俊到中山
王午闻魏败，时邓恒已死，午自称安国王	王午听说了魏国失败的消息，当时邓恒已经死去，王午自称安国王
八月，戊辰，燕王俊遣慕容恪、封奕、阳骛攻之，午闭城自守，送冉操诣燕军，燕人掠其禾稼而还	八月，戊辰，前燕王慕容俊派慕容恪、封奕、阳鹜攻打他，王午紧闭城门自守，把冉操送给燕军，燕人把他们的庄稼砍掠一空后返回去了
桓温使司马勋助周抚讨萧敬文于涪城，斩之	桓温派司马勋帮助周抚在涪城讨伐萧敬文，杀掉了他
谢尚自枋头迎传国玺至建康，百僚毕贺	谢尚从枋头迎接传国印玺抵达建康，朝廷百官，一同庆贺
秦以雷弱儿为大司马，毛贵为太尉，张遇为司空	前秦任命雷弱儿为大司马，毛贵为太尉，张遇为司空
丁卯，燕王俊还蓟	丁卯，前燕王慕容俊回到蓟城
故赵将拥兵据州郡者，各遣使降燕；燕王俊以王擢为益州刺史，夔逸为秦州刺史，张平为并州刺史，李历为兖州刺史，高昌为安西将军，刘宁为车骑将军	过去后赵国的将领中带领士兵占据州郡的人，各自都派使者向前燕投降，前燕王慕容俊任命王擢为益州刺史，夔逸为秦州刺史，张平为并州刺史，李历为兖州刺史，高昌为安西将军，刘宁为车骑将军
慕容恪屯安平，积粮，治攻具，将讨王午	慕容恪驻扎在安平，储备粮食，准备进攻的武器装备，将要讨伐王午
丙戌，中山苏林起兵于无极，自称天子；恪自鲁口还讨林	丙戌，中山人苏林在无极起兵，自称天子
闰月，戊子，燕王俊遣广威将军慕舆根助恪攻林，斩之	慕容恪从鲁口返回讨伐苏林
王午为其将秦兴所杀	闰十月，戊子，前燕王慕容俊派广威将军慕舆根帮助慕容恪攻打苏林，把他杀掉了
吕护杀兴，复自称安国王	王午被他的将领秦兴杀掉，吕护杀了秦兴，又自称安国王
秦丞相雄攻王擢于陇西，擢奔凉州，雄还屯陇东	前秦丞相苻雄在陇西攻打王擢，王擢逃奔到凉州，苻雄返回，驻扎在陇东
张重华以擢为征虏将军、秦州刺史，特宠待之	张重华任命王擢为征虏将军、秦州刺史，特别宠待他
春，正月，乙卯朔，大赦	春季，正月，乙卯朔，东晋实行大赦
二月，庚子，燕主俊立其妃可足浑氏为皇后，世子晔为皇太子，皆自龙城迁于蓟宫	二月，庚子，前燕国主慕容俊立他的后妃可足浑氏为皇后，立长子慕容晔为皇太子，他们全都从龙城迁至蓟城王宫
三月，交州刺史阮敷讨林邑，破五十余垒	三月，东晋交州刺史阮敷讨伐林邑国，攻破了五十多座营垒
赵故卫尉常山李犊聚众数千人叛燕	后赵国原来的卫尉常山人李犊聚集兵众数千人背叛了前燕
以安西将军谢尚为尚书仆射	东晋朝廷任命安西将军谢尚为尚书仆射
六月，秦苻飞攻氐王杨初于仇池，为初所败	六月，前秦苻飞在仇池攻打氐王杨初，但被杨初打败
丞相雄、平昌王菁帅步骑四万屯于陇东	丞相苻雄、平昌王苻菁率领四万步、骑兵驻扎在陇东
秦以左仆射鱼遵为司空	前秦任命左仆射鱼遵为司空
九月，秦丞相雄帅众二万还长安，遣平昌王菁略定上洛，置荆州于丰阳川，以步兵校尉金城郭敬为刺史	九月，前秦丞相苻雄率领兵众二万人回到长安，派平昌王苻菁平定治理上洛，在丰阳川设置荆州，任命步兵校尉金城人郭敬为刺史
雄与清河王法、苻飞分讨孔持等	苻雄与清河王苻法、苻飞分别讨伐孔持等人
西平敬烈公张重华有疾，子曜灵才十岁，立为世子，赦其境内	西平敬烈公张重华患病，儿子张曜灵才十岁，被立为太子，在境内实行大赦
重华庶兄长宁侯祚，有勇力、吏干，而倾巧善事内外，与重华嬖臣赵长、尉缉等结异姓兄弟	张重华的庶兄长宁侯张祚，力气很大，具有果敢勇猛的禀性和当官的才干，然而为人狡诈，善于看风行事，左右逢源，和张重华的宠臣赵长、尉缉等人结拜为异姓兄弟
都尉常据请出之，重华曰：吾方以祚为周公，使辅幼子，君是何言也	都尉常据请求把他调离，张重华说：我正要把张祚当作周公，让他辅佐幼子，你这是说的什么话呢
殷浩使部将刘启、王彬之攻姚益于山桑，姚襄自淮南击之，启、彬之皆败死	殷浩派部将刘启、王彬之在山桑攻打姚益，姚襄从淮南出兵反击，刘启、王彬之全都战败死亡
襄进据芍陂	姚襄继续前进，占据了芍陂
秦丞相雄克池阳，斩孔持	前秦苻雄攻克池阳，斩杀了孔持
十二月，清河王法、苻飞克，斩刘珍、夏侯显	十二月，清河王苻法、苻飞攻克县，斩杀了刘珍、夏侯显
燕卫将军恪、抚军将军军、左将军彪等屡荐给事黄门侍郎霸有命世之才，宜总大任	前燕卫将军慕容恪、抚军将军慕容军、左将军慕容彪等人曾经屡次荐举给事黄门侍郎慕容霸，说他有显赫于世的才能，应该总揽重任
是岁，燕主俊以霸为使持节、安东将军、北冀州刺史，镇常山	这一年，前燕国主慕容俊任命慕容霸为使持节、安东将军、北冀州刺史、镇守常山
故魏降将周成反，自宛袭洛阳	过去魏国投降过来的将领周成造反，从宛县出发袭击洛阳
辛酉，河南太守戴施奔鲔渚	辛酉，河南太守戴施逃奔到鲔渚
姚襄遣使降燕	姚襄派遣使者向前燕投降
桓温别将攻上洛，获秦荆州刺史郭敬；进击青泥，破之	桓温的另一位将领攻打上洛，俘获了前秦荆州刺史郭敬，继续前进，又攻破了青泥
司马勋掠秦西鄙，凉秦州刺史王擢攻陈仓以应温	司马勋夺取了前秦的西部边陲地带，前凉秦州刺史王擢攻打陈仓以接应桓温
秦主健遣太子苌、丞相雄、淮南王生、平昌王菁、北平王硕帅众五万军于柳以拒温	前秦国主苻健派太子苻苌、丞相苻雄、淮南王苻生、平昌王苻菁、北平王苻硕率领五万兵众驻扎在柳，以阻击桓温
夏，四月，己亥，温与秦兵战于蓝田	夏季，四月，己亥，桓温与前秦军队在蓝田交战
秦淮南王生单骑突陈，出入以十数，杀伤晋将士甚众	前秦淮南王苻生单枪匹马冲入敌阵，往返十多次，杀死杀伤了众多的东晋将士
温督众力战，秦兵大败；将军桓冲又败秦丞相雄于白鹿原	桓温督促兵众奋力拼搏，前秦军队终于被打得大败
冲，温之弟也	将军桓冲又在白鹿原打败了前秦丞相苻雄
温转战而前，壬寅，进至灞上	桓冲是桓温的弟弟
秦太子苌等退屯城南，秦主健与老弱六千固守长安小城，悉发精兵三万，遣大司马雷弱儿等与苌合兵以拒温	桓温转战前进，壬寅，到达灞上
三辅郡县皆来降	前秦太子苻苌等退守驻扎在城南，前秦国主苻健与六千老弱民众固守长安小城，把三万精锐兵士全部派出，让大司马雷弱儿等人与苻苌会合兵力，以抵抗桓温
温抚谕居民，使安堵复业	三辅地区的郡县全都投降
民争持牛酒迎劳，男女夹路观之，耆老有垂泣者，曰：不图今日复睹官军	桓温安抚告谕当地居民，让他们安居复业，当地的百姓争先恐后地带着酒肉迎接慰劳桓温的部队，男男女女夹道围观，有些老年人还激动地流下了眼泪，说：没想到今天又见到了朝廷的军队
五月，江西流民郭敞等执陈留内史刘仕，降于姚襄	五月，江西的流民郭敞等一千多人挟持着陈留内史刘仕投降了姚襄
建康震骇，以吏部尚书周闵为中军将军，屯中堂，豫州刺史谢尚自历阳还卫京师，固江备守	东晋朝廷十分震惊，任命吏部尚书周闵为中军将军，驻扎宫中，豫州刺史谢尚从历阳返回，戍卫京师，加固长江防线，严密守备
王擢拔陈仓，杀秦扶风内史毛难	王擢攻克陈仓，杀掉了前秦的扶风内史毛难
北海王猛，少好学，倜傥有大志，不屑细务，人皆轻之	北海人王猛，从小好学，才能卓越，胸怀大志，不屑于琐碎事务，人们都轻视他
猛悠然自得，隐居华阴	王猛却悠然自得，隐居于华阴
闻桓温入关，披褐诣之，扪虱而谈当世之务，旁若无人	当他听说桓温入关后，便披着粗布衣服去拜访他，边摸着虱子边谈论当时的大事，旁若无人
温异之，问曰：吾奉天子之命，将锐兵十万为百姓除残贼，而三秦豪杰未有至者，何也	桓温觉得他与众不同，便问道：我奉天子之命，统帅十万精兵为百姓消灭残存的寇贼，然而三秦的豪杰之士至今没有人前来归附，这是为什么呢
猛曰：公不远数千里，深入敌境，今长安咫尺而不渡灞水，百姓未知公心，所以不至	王猛说：您不远数千里，深入敌土，如今长安近在咫尺而您却不横渡灞水，百姓们不知道您的意图，所以不来
温嘿然无以应，徐曰：江东无卿比也	桓温沉默不语，无以应答，过了一会儿说：长江以南没有人能和你相比
乃署猛军谋祭酒	于是就安排王猛暂任军谋祭酒
秦丞相雄击司马勋、王擢于陈仓，勋奔汉中，擢奔略阳	前秦丞相苻雄在陈仓攻击司马勋、王擢，司马勋逃奔汉中，王擢逃奔略阳
秦以光禄大夫赵俱为洛阳刺史，镇宜阳	前秦任命光禄大夫赵俱为洛州刺史，镇守宜阳
燕大调兵众，因发诏之日，号曰丙戌举	前燕大规模地征调兵众，根据发布诏令的日期，这次征调称为丙戌举
九月，桓温还自伐秦，帝遣侍中、黄门劳温于襄阳	九月，桓温从伐秦前线返回，东晋穆帝派侍中、黄门侍郎在襄阳慰劳桓温
秦太子苌之拒桓温也，为流矢所中，冬，十月，卒，谥曰献哀	前秦太子苻苌抵御桓温进攻的时候，被流箭射中，冬季，十月，去世，追封谥号为献哀
燕王俊如龙城	前燕国主慕容俊到龙城
桓温之入关也，王擢遣使告凉王祚，言温善用兵，其志难测	桓温入关的时候，王擢派遣使者向前凉王张祚报告，说桓温善于用兵，他的志向难以猜测
祚惧，且畏擢之叛己，遣人刺之	张祚十分害怕，而且担心王擢背叛自己，于是就派人去刺杀王擢
事泄，祚益惧，大发兵，声言东伐，实欲西保敦煌，会温还而止	事情败露，张祚更加害怕，于是大举出兵，声称要去东伐，实则想西退保全敦煌，恰好这时桓温撤兵返回，他才停止了行动
既而遣秦州刺史牛霸等帅兵三千击擢，破之	接着又派秦州刺史牛霸等人率领三千士兵攻打王擢，王擢被打败
十一月，擢帅众降秦，秦以擢为尚书，以上将军啖铁为秦州刺史	十一月，王擢率领兵众投降了前秦，前秦任命他为尚书，任命上将军啖铁为秦州刺史
秦王健叔父武都王安自晋还，为姚襄所虏，以为洛州刺史	前秦国主苻健的叔父武都王苻安从东晋返回时，被姚襄俘虏，任命他为洛州刺史
十二月，安亡归秦，健以安为大司马、骠骑大将军、并州刺史，镇蒲阪	十二月，苻安逃回到了前秦，苻健任命他为大司马、骠骑大将军、并州刺史，镇守蒲阪
是岁，秦大饥，米一升直布一匹	这一年，前秦发生严重饥荒，一升米价值一匹布
二月，秦大蝗，百草无遗，牛马相啖毛	二月，前秦发生严重蝗灾，百草无遗，牛马互相啃食身上的毛
兰陵太守孙黑、济北太守高柱、建兴太守高及秦河内太守王会、黎阳太守韩高皆以郡降燕	兰陵太守孙黑、济北太守高柱、建兴太守高，以及前秦河内太守王会、黎阳太守韩高全都投降了前燕，将所据之郡拱手相让
秦淮南王生幼无一目，性粗暴	前秦淮南王苻生小时丧失了一只眼睛，性情暴烈
其祖父洪尝戏之曰：吾闻瞎儿一泪，信乎	他的祖父苻洪曾经和他开玩笑说：我听说瞎儿只有一只眼流泪，真的吗
生怒，引佩刀自刺出血，曰：此亦一泪也	苻生听后发怒了，拔出佩刀就刺向自己的瞎眼，鲜血直流，说：这也是一只眼的眼泪
洪大惊，鞭之	苻洪见状十分震惊，用鞭子打他
生曰：性耐刀槊，不堪鞭棰	苻生说：我生性能够忍耐刀矛，但不堪忍受鞭打
洪谓其父健曰：此儿狂悖，宜早除之；不然，必破人家	苻洪对苻生父亲苻健说：这个儿子狂暴悖逆，应该尽早除掉他，不然，一定会导致家破人亡
健将杀之，健弟雄止之曰：儿长自应改，何可遽尔	苻健正准备杀掉苻生，苻健的弟弟苻雄劝阻说：儿子长大以后自然就会改变，怎么能这样急不可耐呢
及长，力举千钧，手格猛兽，走及奔马，击刺骑射，冠绝一时	等到苻生长大以后，能够力举千钧，徒手与猛兽搏斗，跑起来赶得上奔驰的骏马，击刺骑射各种武艺，全都冠绝一时
献哀太子卒，强后欲立少子晋王柳；秦主健以谶文有三羊五眼，乃立生为太子	太子苻苌死后，强太后想立小儿子晋王苻柳，前秦国主苻健认为谶文中有三羊五眼的字样，于是就立苻生为太子
以司空、平昌王菁为太尉，尚书令王堕为司空，司隶校尉梁楞为尚书令	任命司空、平昌王苻菁为太尉，尚书令王堕为司空，司隶校尉梁楞为尚书令
六月，丙子，秦主健寝疾	六月，丙子，前秦国主苻健患病，卧床不起
庚辰，平昌公菁勒兵入东宫，将杀太子生而自立	庚辰，平昌王苻菁率兵进入东宫，准备杀掉太子苻生而自立
时生侍疾西宫，菁以为健已卒，攻东掖门	这时苻生正在西宫服侍患病的苻健，苻菁以为苻健已经死了，便攻打东掖门
健闻变，登端门，陈兵自卫	苻健听到变故的消息后，登上端门，布署兵力自卫
众见健惶惧，皆舍仗逃散	苻菁的兵众看见苻健后十分惶恐害怕，全都丢下武器四处逃散
健执菁，数而杀之，余无所问	苻健抓到了苻菁，数说了他的罪行后把他杀死，其余的人不加以追究
秋，七月，以吏部尚书周闵为左仆射	秋季，七月，东晋朝廷任命吏部尚书周闵为左仆射
或告会稽王昱曰：武陵王第中大修器仗，将谋非常	有人向会稽王司马昱报告说：武陵王司马的宫中大量准备武器，看来将要图谋政变
昱以告太常王彪之，彪之曰：武陵王之志，尽于驰骋畋猎而已耳，深愿静之，以安异同之论，勿复以为言	司马昱把这一消息告诉了太常王彪之，王彪之说：武陵王的志向，全都在驰骋狩猎方面而已，愿您安静下来，以平息各种议论，不要再提这事了
昱善之	司马昱觉得此话有理
秦主生尊母强氏曰皇太后，立妃梁氏为皇后	前秦国主苻生尊奉母亲强氏为皇太后，立妃子梁氏为皇后
梁氏，安之女也	梁氏是梁安的女儿
以其嬖臣太子门大夫南安赵韶为右仆射，太子舍人赵诲为中护军，著作郎董荣为尚书	任命他的宠臣太子门大夫、南安人赵韶为右仆射，太子舍人赵诲为中护军，著作郎董荣为尚书
秦主生封卫大将军黄眉为广平王，前将军飞为新兴王，皆素所善也	前秦国主苻生封卫大将军苻黄眉为广平王，封前将军苻飞为新兴王，这两人都是他平常所喜欢的
征大司马武都王安领太尉	征召大司马武都王苻安兼太尉
以晋王柳为征东大将军、并州牧，镇蒲阪；魏王为镇东大将军、豫州牧，镇陕城	任命晋王苻柳为征东大将军、并州牧，镇守蒲阪，任命魏王苻为镇东大将军、豫州牧，镇守陕城
凉宋混军于武始大泽，为曜灵发哀	前凉宋混的部队驻扎在武始的大湖边，哀悼张曜录
闰月，混军至姑臧，凉王祚收张弟琚及子嵩，将杀之	闰六月，宋混的部队抵达姑臧，前凉王张祚拘捕了张的弟弟张琚及儿子张嵩，准备要杀掉他们
琚、嵩闻之，募市人数百，扬言：张祚无道，我兄大军已至城东，敢举手者诛三族	张琚、张嵩听说后，招募了城里的数百人，公开宣称：张祚无道，我哥哥的大军已抵达城东，敢动手杀我们的人诛灭三族
遂开西门纳混兵	于是打开西城门让宋混的军队进城
领军将军赵长等惧罪，入阁呼张重华母马氏出殿，立凉武侯玄靓为主	领军将军赵长等人因有请立张祚的罪行，十分害怕，他们入宫请张重华的母亲马氏登堂升殿，立凉武侯张玄靓为国主
易揣等引兵入殿，收长等，杀之	易揣等人率兵进入殿堂，拘捕了赵长等人，杀掉了他们
祚按剑殿上，大呼，叱左右力战	张祚在殿堂上扶剑大喊，命令左右的人奋力战斗
祚素失众心，莫肯为之斗者，遂为兵人所杀	张祚平时失掉了民心，这时没有人肯为他去战斗，于是被士兵杀掉
混等枭其首，宣示中外，暴尸道左，城内咸称万岁	宋混等人砍下了他的首级示众，公告宫廷内外，张祚暴尸于路旁，城里的人们都高呼万岁
以庶人礼葬之，并杀其二子	宋混等人把张祚以普通百姓的规格埋葬，并且杀了他的两个儿子
混、琚上玄靓为大将军、凉州牧、西平公，赦境内，复称建兴四十三年	宋混、张琚上书东晋朝廷请立张玄靓为大将军、凉州牧、西平公，在境内实行大赦，纪年恢复为建兴四十三年
时玄靓始七岁	这时张玄靓刚七岁
冬，十月，以豫州刺史谢尚督并、冀、幽三州，镇寿春	冬季，十月，东晋朝廷任命豫州刺史谢尚总督并、冀、幽三州，镇守寿春
秦以辛牢守尚书令，赵韶为左仆射，尚书董荣为右仆射，中护军赵诲为司隶校尉	前秦任命辛牢代理尚书令，任命赵韶为左仆射，尚书董荣为右仆射，中护军赵诲为司隶校尉
上党人冯鸯逐燕太守段刚，据安民城，自称太守，遣使来降	上党人冯鸯赶走了前燕太守段刚，占据了安民城，自称太守，派遣使者来向东晋投降
春，正月，燕太原王恪引兵济河，未至广固百余里，段龛帅众三万逆战	春季，正月，前燕太原王慕容恪率兵渡过了黄河，离广固只有一百多里，段龛率领兵众三万人迎战
丙申，恪大破龛于淄水，执其弟钦，斩右长史袁范等	丙申，慕容恪在淄水大破段龛的部队，抓获段龛的弟弟段钦，杀死右长史袁范等人
齐王友辟闾蔚被创，恪闻其贤，遣人求之，蔚已死，士卒降者数千人	齐国的王友辟闾蔚负伤，慕容恪听说过他的贤明，便派人去寻找他，但辟闾蔚已经死了，段龛士卒中投降的有数千人
龛脱走，还城固守，恪进军围之	段龛逃脱，返回广固城中固守，慕容恪进军将他包围
秦司空王堕性刚峻，右仆射董荣、侍中强国皆以佞幸进，随疾之如雠，每朝，见荣未尝与之言	前秦司空王堕性格刚峻，右仆射董荣、侍中强国都是靠着谄媚得宠而得到提升重用，王堕恨之如仇，每次上朝，见到董荣都不和他搭话
或谓堕曰：董君贵幸无比，公宜小降意接之	有人对王堕说：董君显贵宠幸，无与伦比，您应该稍微抑制一点心意，和他接触
堕曰：董龙是何鸡狗，而令国士与之言乎	王堕说：董荣是什么样的鸡狗之徒，而让国中的贤杰人士和他搭话呢
会有天变，荣与强国言于秦主生曰：今天谴甚重，宜以贵臣应之	恰巧这时天象有变故，董荣与强国便向前秦国主苻生进言说：如今上天的谴责非常严重，应该以显贵的大臣去应接谴责
生曰：贵臣惟有大司马及司空耳	苻生说：显贵的大臣只有大司马和司空而已
荣曰：大司马国之懿亲，不可杀也	董荣说：大司马苻安是王室的至亲，不能杀
乃杀王堕	于是就杀了王堕
将刑，荣谓之曰：今日复敢比董龙于鸡狗乎	在将要行刑的时候，董荣对王堕说：今天还敢把董荣我比作鸡狗吗
堕目叱之	王堕怒目痛斥董荣
洛州刺史杜郁，堕之甥也，左仆射赵韶恶之，谮于生，以为贰于晋而杀之	洛州刺史杜郁，是王堕的外甥，左仆射赵韶厌恶他，就向苻生进谗言，说他和东晋来往，有二心，把他杀死
匈奴大人刘务桓卒，弟阏头立，将贰于代	匈奴首领刘务桓去世，他的弟弟刘阏头即位，准备要背叛代国
二月，代王什翼犍引兵西巡临河，阏头惧，请降	二月，代王拓跋什翼犍率兵西巡到达黄河岸边，刘阏头害怕，便请求投降
燕太原王恪招抚段龛诸城	前燕太原王慕容恪招纳安抚段龛辖境内的各座城邑
己丑，龛所署徐州刺史阳都公王腾举众降，恪命腾以故职还屯阳都	己丑，段龛所设置的徐州刺史、阳都公王腾率领民众投降，慕容恪让王腾以旧有官职的身份回去屯守阳都
桓温请移都洛阳，修复园陵，章十余上；不许	桓温请求东晋朝廷将国都迁移到洛阳，修复帝王的陵墓，奏章递上去十多次，都未获许可
拜温征讨大都督，督司、冀二州诸军事，以讨姚襄	只授予桓温征讨大都督的官职，督察司、冀二州各种军务，用以讨伐姚襄
三月，秦主生发三辅民治渭桥，金紫光禄大夫程肱谏，以为妨农；生杀之	三月，前秦国主苻生调集三辅的百姓去修建渭水桥，金紫光禄大夫程肱对此加以劝谏，认为这样做妨碍农耕，苻生把他杀死
姚襄自许昌攻周成于洛阳	姚襄自许昌进发到洛阳，攻打周成
丙子，燕献怀太子晔卒	丙子，前燕国献怀太子慕容晔去世
姚襄攻洛阳，逾月不克	姚襄攻打洛阳，一个多月也没有攻克
长史王亮谏曰：明公英名盖世，兵强民附	长史王亮劝谏姚襄说：您英名盖世，兵力强盛，民众都来归附
今顿兵坚城之下，力屈威挫，或为他寇所乘，此危亡之道也	如今屯兵于坚固的城池之下，力量受阻，威势受挫，其他敌人或许会利用这个机会，这是走向危险灭亡的道路
襄不从	姚襄没有听从
段龛遣其属段来求救，诏徐州刺史荀羡将兵随救之	段龛派他的属下段来东晋求救，朝廷诏令徐州刺史荀羡统领军队跟随段前去救援
羡至琅邪，惮燕兵之强不敢进	荀羡到达琅邪后，由于害怕前燕兵力的强大而不敢继续前进
王腾寇鄄城，羡进攻阳都，会霖雨，城坏，获腾，斩之	王腾进犯鄄城，荀羡便进攻阳都，这时恰巧碰上连绵大雨，城墙被淋坏，荀羡擒获了王腾，把他杀掉了
冬，十月，癸巳朔，日有食之	冬季，十月，癸巳朔，出现日食
诏遣兼司空、散骑常侍车灌等持节如洛阳，修五陵	东晋穆帝下诏，派兼司空、散骑常侍车灌等人带着符节前往洛阳，修整先帝的五座陵墓
十二月，庚戌，帝及群臣皆服缌，临于太极殿三日	十二月，庚戍，穆帝和群臣全都身穿细麻布衣服，到太极殿哭泣谒拜三天
司州都督谢尚以疾不行，以丹阳尹王胡之代之	司州都督谢尚因为有病无法料理政事，东晋朝廷以丹阳尹王胡之代替他
胡之，之子也	王胡之是王的儿子
春，正月，壬戌朔，帝加元服；太后诏归政，大赦，改元，太后徙居崇德宫	春季，正月，壬戌朔，东晋穆帝行加冠礼，太后下诏，让他开始主持朝政，实行大赦，改年号，太后迁居崇德宫
燕主俊征幽州刺史乙逸为左光禄大夫	前燕国主慕容俊征召幽州刺史乙逸为左光禄大夫
逸夫妇共载鹿车；子璋从数十骑，服饰甚丽，奉迎于道	乙逸夫妇共坐一辆小车前往就任，而他的儿子乙璋却带着随从数十骑，衣着华丽，在路上迎候
逸大怒，闭车不与言，到城，深责之	乙逸十分愤怒，紧闭车门，不和他说话，到了蓟城后，乙逸深深地责备他，乙璋还不认错
璋犹不悛	乙逸常常忧虑他要衰败下去，而乙璋却屡被提升，历任中书令、御史中丞
逸常忧其败，而璋更被擢任，历中书令、御史中丞	乙逸于是便叹息道：我从小修身养性，克己守礼，到头来也只能是得以免罪
逸乃叹曰：吾少自修立，克己守道，仅能免罪	乙璋不检点品行，专干放纵奢侈的事情，反而屡任政事清简地位显赫的官职，这难道仅仅是乙璋有愧于宠幸吗
璋不治节检，专为奢纵，而更居清显，此岂惟璋之忝幸，实时世之陵夷也	实在是世道的衰落
二月，癸丑，燕主俊立其子中山王为太子，大赦，改元光寿	二月，癸丑，前燕国主慕容俊立他的儿子中山王慕容为太子，实行大赦，改年号为光寿
戊寅，燕主俊遣抚军将军垂、中军将军虔、护军将军平熙帅步骑八万攻敕勒于塞北，大破之，俘斩十余万，获马十三万匹，牛羊亿万头	戊寅，前燕国主慕容俊派抚军将军慕容垂、中军将军慕容虔、护军将军慕容平熙率领八万步、骑兵在边境以北攻打敕勒部族，彻底攻破了他们，俘获斩首十多万人，缴获马十三万匹，牛羊亿万头
匈奴单于贺赖头帅部落三万五千口降燕，燕人处之代郡平舒城	匈奴单于贺赖头率领本部落的三万五千人投降了前燕，前燕人把他们安置在代郡的平舒城
燕主俊杀段龛，坑其徒三千余人	前燕国主慕容俊杀掉了段龛，把他的兵众三千多人活埋
秋，七月，秦大将军冀州牧张平遣使请降，拜并州刺史	秋季，七月，前秦大将军冀州牧张平派遣使者到东晋请求投降，朝廷授予他并州刺史官职
八月，丁未，立皇后何氏	八月，丁未，东晋穆帝立何氏为皇后
后，故散骑侍郎庐江何准之女也	何氏皇后，是过去散骑常侍郎庐江人何准的女儿
礼如咸康而不贺	立后礼仪像威康二年那次一样，不加以庆贺
秦王坚以权翼为给事黄门侍郎，薛赞为中书侍郎，与王猛并掌机密	前秦王苻坚任命权翼为给事黄门侍郎，薛为中书侍郎，和王猛一起掌管机要事务
九月，追复太师鱼遵等官，以礼改葬，子孙存者皆随才擢叙	九月，追认恢复了太师鱼遵等人的官位，按照礼仪对他们重新加以安葬，对他们在世的子孙，全都根据才能加以提拔任用
张平据新兴、雁门、西河、太原、上党、上郡之地，壁垒三百余，夷、夏十余万户，拜置征镇，欲与燕、秦为敌国	张平占据了新兴、雁门、西河、太原、上党、上郡等地，修筑了三百多座坚营垒，有夷、汉的十万多户人家，设置了征镇官吏，要与前燕、前秦相对抗
冬，十月，平寇略秦境，秦王坚以晋公柳都督并、冀州诸军事，加并州牧，镇蒲阪以御之	冬季，十月，张平进犯秦地，前秦王苻坚让晋公苻柳总领并、冀二州各种军务，授予并州牧，镇守蒲阪，以抵御张平
十一月，癸酉，燕主俊自蓟徙都邺	十一月，癸酉，前燕国主慕容俊将都城由蓟城迁往邺城
十二月，乙巳，燕主俊入邺宫，大赦	十二月，乙巳，前燕国主慕容俊进入邺城宫殿，实行大赦
复作铜雀台	修复了铜雀台
以太常王彪之为左仆射	东晋任命太常王彪立为左仆射
秦王坚行至尚书，以文案不治，免左丞程卓官，以王猛代之	前秦王苻坚巡视到了尚书省，看见文牍案卷凌乱，便罢免了尚书左丞程卓的官职，任命王猛取代他
坚举异材，修废职，课农桑，恤困穷，礼百神，立学校，旌节义，继绝世；秦民大悦	苻坚任用贤才，整治废弛的政事，劝勉农桑，抚恤贫困，礼敬百神，设立学校，表彰节义，恢复已经断绝的世祀，前秦的百姓十分高兴
春，正月，司徒昱稽首归政；帝不许	春季，正月，司徒司马昱叩头请求归还朝政，晋穆帝不同意
初，冯鸯既以上党来降，又附于张平，又自归于燕，既而复叛燕	当初，冯鸯已将上党献给东晋，但又归附张平，不久又归附前燕，紧接着又背叛了前燕
二月，燕司徒上庸王评讨之，不克	二月，前燕司徒上庸王慕容评前往讨伐冯鸯，但没有攻克
秋，八月，豫州刺史谢奕卒	秋季，八月，东晋豫州刺史谢奕去世
奕，安之兄也	谢奕是谢安的哥哥
司徒昱以建武将军桓云代之	司徒司马昱任命建武将军桓云替代他的职位
云，温之弟也	桓云是桓温的弟弟
访于仆射王彪之，彪之曰：云非不才，然温居上流，已割天下之半，其弟复处西藩；兵权萃于一门，非深根固蒂之宜	司马昱就此去向王彪之询问意见，王彪之说：桓云不是无能的人，然而桓温已经居守长江上游，管辖着天下的一半，他的弟弟再要掌握朝廷西部藩屏的重要军职，兵权集于一家之手，这不宜于使国家根基牢固
人才非可豫量，但当令不与殿下作异者耳	人才不是可以预料的，只应当让他不与殿下怀有二心而已
昱颔之曰：君言是也	司马昱点头说道：你说得对
壬申，以吴兴太守谢万为西中郎将，监司・豫・冀・并四州诸军事、豫州刺史	壬申，任命吴兴太守谢万为西中郎将，监司、豫、冀、并四州诸军事及豫州刺史
赵之亡也，其将张平、李历、高昌皆遣使降燕，已而降晋，又降秦，各受爵位，欲中立以自固	后赵灭亡的时候，其将领张平、李历、高昌都派遣使者投降了前燕，后来又投降了东晋，不久又投降了前秦，从各国分别接受了爵位，想以中立的方式自我保全
燕主俊使司徒评讨张平于并州，司空阳鹜讨高昌于东燕，乐安王臧讨李历于濮	前燕国主慕容俊派司徒慕容评在并州讨伐张平，派司空阳鹜在东燕讨伐高昌，派乐安王慕容臧在濮城讨伐李历
阳骛攻昌别将于黎阳，不拔	阳鹜在黎阳攻打高昌另一部将的军队，没有攻破
历奔荥阳，其众皆降	李历逃奔荥阳，其兵众全部投降
并州壁垒百余降于燕，俊以右仆射悦绾为并州刺史以抚之	并州一百多座营垒都投降了前燕，慕容俊任命右仆射悦绾为并州刺史安抚他们
平所署征西将军诸葛骧等帅壁垒百三十八降于燕，俊皆复其官爵	张平统辖的征西将军诸葛骧等人率领一百三十八座营垒投降了前燕，慕容俊都恢复了他们的官职爵位
平帅众三千奔平阳，复请降于燕	张平率领三千兵众逃奔到平阳，又一次向前燕请求投降
春，二月，燕主俊立子泓为济北王，冲为中山王	春季，二月，前燕国主慕容俊立儿子慕容泓为济北王，慕容冲为中山王
燕人杀段勤，勤弟思来奔	前燕人杀了段勤，段勤的弟弟段思来投奔东晋
燕主俊宴群臣于蒲池，语及周太子晋，潸然流涕曰：才子难得	前燕国主慕容俊在蒲池宴请群臣，谈到周朝太子姬晋的时候，他潸然泪下，说：有才华的儿子难得
自景先之亡，吾鬓发中白	自从慕容晔死去以后，我鬓发已经半白
卿等谓景先何如	你们说慕容晔怎样
司徒左长史李绩对曰：献怀太子之在东宫，臣为中庶子，太子志业，敢不知之	司徒左长史李绩回答说：献怀太子慕容晔在东宫的时候，我为中庶子，太子的志向业绩，我怎敢说不清楚呢
太子大德有八：至孝，一也；聪敏，二也；沈毅，三也；疾谀喜直，四也；好学，五也；多艺，六也；谦恭，七也；好施，八也	太子的大德表现在八个方面：其一，至孝；其二，聪明敏锐；其三，沉着坚毅；其四，痛恨阿谀喜欢刚直；其五，好学；其六，多才多艺；其七，谦恭；其八，喜欢施惠于人
俊曰：卿誉之虽过，然此儿在，吾死无忧矣	慕容俊说：你的赞誉虽说有点过分，但如果此儿健在，我便死而无忧了
景茂何如	慕容怎么样
时太子侍侧，绩曰：皇太子天资岐嶷，虽八德已闻，而二阙未补，好游畋而乐丝竹，此其所以损也	当时慕容正陪从在旁边，李绩说：皇太子天资聪慧，虽然已有具备八德的声誉，但尚有两方面的缺憾未能弥补，喜欢游玩打猎和丝竹器乐，这就是导致他有所不如的原因
俊顾谓曰：伯阳之言，药石之惠也，汝宜诫之	慕容俊看着慕容说：李绩的话，是苦口良药，你应该引以为诫
甚不平	慕容却忿忿不平
秦平羌护军高离据略阳叛，永安威公侯讨之，未克而卒	前秦平羌护军高离据守略阳反叛，永安威公苻侯前往讨伐，没有攻克苻侯就死了
夏，四月，骁骑将军邓羌、秦州刺史啖铁讨平之	夏季，四月，骁骑将军邓羌、秦州刺史啖铁讨伐并平定了反叛
匈奴刘悉勿祈卒，弟卫辰杀其子而代之	匈奴刘悉勿祈去世，弟弟刘卫辰杀掉了他的儿子，取而代之
高昌不能拒燕，秋，七月，自白马奔荥阳	高昌抵抗不住前燕的攻击，秋季，七月，从白马逃奔到荥阳
泰山太守诸葛攸将水陆二万击燕，入自石门，屯于河渚	东晋泰山太守诸葛攸统率二万水兵、步兵攻击前燕，从石门进入，驻扎在黄河的小岛上
燕上庸王评、长乐太守傅颜帅步骑五万与攸战于东阿，攸兵大败	前燕上庸王慕容评、长乐太守傅颜率领五万步兵、骑兵和诸葛攸在东阿交战，诸葛攸的军队大败
秦王坚以王猛为吏部尚书，寻迁太子詹事，十一月，为左仆射，余官如故	前秦王苻坚任命王猛为吏部尚书，不久又升迁为太子詹事，十一月，任左仆射，其他官职依旧如前
十二月，封武陵王子为梁王	十二月，东晋穆帝封武陵王司马的儿子司马为梁王
大旱	发生严重旱灾
辛酉，燕主俊寝疾，谓大司马太原王恪曰：吾病必不济	辛酉，前燕国主慕容俊患病，卧床不起，他对大司马、太原王慕容恪说：我的病肯定难以好转了
今二方未平，景茂冲幼，国家多难，吾欲效宋宣公，以社稷属汝，何如	如今晋、秦二国尚未平定，慕容年幼，国家多有磨难，我想效仿宋宣公，把天下嘱托给你，如何
恪曰：太子虽幼，胜残致治之主也	慕容恪说：太子虽然年幼，但却是能遏制顽凶实现大治的君主
臣实何人，敢干正统	我其实是什么人，怎么敢当正统的君主呢
俊怒曰：兄弟之间，岂虚饰邪	慕容俊愤怒地说：兄弟之间，岂能虚伪掩饰
恪曰：陛下若以臣能荷天下之任者，岂不能辅少主乎	慕容恪说：陛下如果认为我是能够承担天下重任的人，我怎么就不能辅佐少主呢
俊喜曰：汝能为周公，吾复何忧	慕容俊高兴地说：你能做周公，我还有什么可忧虑的
李绩清方忠亮，汝善遇之	李绩行为清廉，忠诚闻名，你要很好地对待他
召吴王垂还邺	慕容俊召吴王慕容垂返回邺城
秦王坚以王猛为辅国将军、司隶校尉，居中宿卫，仆射、詹事、侍中、中书令、领选如故	前秦国王苻坚任命王猛为辅国将军、司录校尉，在宫中值宿警卫，仆射、詹事、侍中、中书令以及兼任的其他职务一如从前
猛上疏辞让，因荐散骑常侍阳平公融、光禄・散骑西河任群、处士京兆朱彤自代	王猛上疏请求辞让，并荐举散骑常侍阳平公苻融，光禄、散骑西河人任群，处士京兆人朱彤来分别替代自己的这些兼职，苻坚没有同意，而是任命苻融为侍中、中书监、左仆射，任命任群为光禄大夫，兼领太子家令，任命朱彤为尚书侍郎，兼领太子庶子
坚不许，而以融为侍中、中书监、左仆射，任群为光禄大夫、领太子家令，朱彤为尚书侍郎、领太子庶子	王猛时年三十六岁，一年中五次升迁，权势显赫压倒朝廷内外
猛时年三十六，岁中五迁，权倾内外；人有毁之者，坚辄罪之，于是群臣莫敢复言	有诋毁他的人，苻坚就以罪处置，于是群臣没有谁再敢说三道四
以左仆射李威领护军；右仆射梁平老为使持节、都督北垂诸军事、镇北大将军，戍朔方之西；丞相司马贾雍为云中护军，戍云中之南	苻坚任命左仆射李威兼任护军，右仆射梁平老为使持节、都督北垂诸军事、镇北大将军，戍守朔方以西地区，丞相司马贾雍为云中护军，戍守云中以南地区
秦王坚分司、隶置雍州，以河南公双为都督雍・河・凉三州诸军事、征西大将军、雍州剌史，改封赵公，镇安定	前秦王苻坚分司隶之地设置雍州，任命河南公苻双为都督雍、河、凉三州诸军事，征西大将军，雍州刺史，并将他改封为赵公，镇守安定
封弟忠为河南公	封弟弟苻忠为河南公
仇池公杨俊卒，子世立	仇池公杨俊去世，儿子杨世继位
匈奴刘卫辰遣使降秦，请田内地，春来秋返；秦王坚许之	匈奴刘卫辰派使者向前秦投降，请求在内地划给他们农田耕种，春天来秋天走，前秦王苻坚同意了
夏，四月，云中护军贾雍遣司马徐帅骑袭之，大获而还	夏季，四月，云中护军贾雍派司马徐率领骑兵袭击刘卫辰，满载而返
坚怒曰：朕方以恩信怀戎狄，而汝贪小利以败之，何也	苻坚愤怒地说：朕正在以恩信安抚戎狄，而你却贪图小利而败坏了事情，为什么呢
黜雍以白衣领职，遣使还其所获，慰抚之	于是废黜贾雍，让他以布衣百姓的身分兼领职务，派使者将他所掠获的财物送还了刘卫辰，并对他加以抚慰
卫辰于是入居塞内，贡献相寻	刘卫辰从此进入关内定居，经常向前秦进献贡奉
八月，辛丑朔，日有食之，既	八月，辛丑朔，出现日全食
冬，十月，乌桓独孤部、鲜卑没奕干各帅众数万降秦，秦王坚处之塞南	冬季，十月，乌桓的独孤部、鲜卑的没奕干各自率领数万部众投降了前秦，前秦王苻坚把他们安置在塞南地区
阳平公融谏曰：戎狄人面兽心，不知仁义	阳平公苻融劝苻坚说：戎狄人面兽心，不懂仁义
其稽颡内附，实贪地利，非怀德也；不敢犯边，实惮兵威，非感恩也	他们叩首归附，实际上是贪图地利，并不是向往仁德；他们不敢侵犯边境，实际上是害怕军队的威势，并不是感激恩情
今处之塞内，与民杂居，彼窥郡县虚实，必为边患，不如徙之塞外以防未然	如今把他们安排在塞内地区与我们的百姓混住杂居，等窥探清郡县的虚实后，一定会成为边境之地的祸患，不如把他们迁徙到塞外，以防患于未然
坚从之	苻坚听从了这一劝告
十一月，封桓温为南郡公，温弟冲为丰城县公，子济为临贺县公	十一月，东晋封桓温为南郡公，封桓温的弟弟桓冲为丰城县公，桓温的儿子桓济为临贺县公
燕太宰恪欲以李绩为右仆射，燕主不许	前燕太宰慕容恪想任命李绩为右仆射，前燕国主慕容不同意
恪屡以为请，曰：万机之事，皆委之叔父；伯阳一人，请独载	慕容恪多次请求，慕容说：国家各种事务，全都交给叔父处理，只有李绩一人的事情，我请求独自裁断
出为章武太守，以忧卒	于是把李绩调出朝廷，任章武太守，李绩忧郁而死
春，正月，戊戌，大赦	春季，正月，戊戌，东晋实行大赦
刘卫辰掠秦边民五十余口为奴婢以献于秦；秦王坚责之，使归所掠	刘卫辰掳掠了前秦的边境居民五十多人作为奴婢，进献给了前秦，前秦王苻坚责备他，让他把掳掠的百姓放回去
卫辰由是叛秦，专附于代	刘卫辰因此而背叛了前秦，一心依附于代国
东安简伯郗昙卒	东安简伯郗昙去世
二月，以东阳太守范汪都督徐、兖、冀、青、幽五州诸军事，兼徐、兖二州刺史	二月，东晋任命东阳太守范汪都督徐、兖、冀、青、幽五州诸军事，兼任徐、兖二州刺史
夏，四月，桓温以其弟黄门郎豁都督沔中七郡诸军事，兼新野、义城二郡太守，将兵取许昌，破燕将慕容尘	夏季，四月，桓温任命他的弟弟黄门郎桓豁为都督沔中七郡诸军事，兼任新野、义城二郡太守，统率军队攻取了许昌，打败了前燕将领慕容尘
凉骠骑大将军宋混疾甚，张玄靓及其祖母马氏往省之，曰：将军万一不幸，寡妇孤儿将何所托	前凉骠骑大将军宋混病重，张玄靓及其祖母马氏前去看望，说：将军万一有不幸，我们孤儿寡妇将依靠谁呢
欲以林宗继将军，可乎	想以宋林宗继承将军，可以吗
混曰：臣子林宗幼弱，不堪大任	宋混说：臣下的儿子宋林宗年幼无力，难以承担重任
殿下傥未弃臣门，臣弟澄政事愈于臣，但恐其儒缓，机事不称耳	殿下倘若还未抛弃臣下一家，我的弟弟宋澄施政办事的能力胜于我，只是恐怕他迂缓迟钝，难以适应随机应变的事务
殿下策励而使之，可也	殿下如果能对他鞭策鼓励而加以使用，就可以
混戒澄及诸子曰：吾家受国大恩，当以死报，无恃势位以骄人	宋混告诫宋澄以及儿子们说：我们家承受了国家的大恩大泽，应当以死相报，不要倚仗权势地位而对人傲慢
又见朝臣，皆戒之以忠贞	他又会见了朝廷的大臣，全都告诫他们要忠贞不二
及卒，行路为之挥涕	等到宋混死后，路人都为他流泪
玄靓以澄为领军将军，辅政	张玄靓任命宋澄为领军将军，辅佐朝政
五月，丁巳，帝崩，无嗣	五月，丁巳，东晋穆帝驾崩，没有继承人
皇太后令曰：琅邪王丕，中兴正统，义望情地，莫与为比，其以王奉大统	皇太后下令说：琅邪王司马丕，是朝廷中兴以来的正传统嫡传，不论是道德名声，还是族亲地位，没有人能和他相比，让琅邪王奉接帝位
于是百官备法驾迎于琅邪第	于是朝廷百官备好皇帝的车驾去琅邪王的宅第迎接他
庚申，即皇帝位，大赦	庚申，司马丕即皇帝位，实行大赦
壬戌，改封东海王奕为琅邪王	壬戌，改封东海王司马奕为琅邪王
秋，七月，戊午，葬穆帝于永平陵，庙号孝宗	秋季，七月，戊午，东晋穆帝被安葬在永平陵，定庙号为孝宗
九月，戊申，立妃王氏为皇后	九月，戊申，东晋立妃王氏为皇后
后，之女也	王皇后是王的女儿
穆帝何皇后称穆皇后，居永安宫	穆帝何皇后称为穆皇后，居住在永安宫
凉右司马邕恶宋澄专政，起兵攻澄，杀之，并灭其族	前凉右司马张邕憎恨宋澄独专朝政，起兵攻打宋澄，把他杀了，他的家族也一并灭掉
张玄靓以邕为中护军，叔父天锡为中领军，同辅政	张玄靓任命张邕为中护军，任命叔父张天锡为中领军，一同辅佐朝政
乙亥，秦大赦	乙亥，前秦实行大赦
吕护复叛，奔燕，燕人赦之，以为广州刺史	吕护又背叛了东晋，逃奔到前燕，前燕人宽赦了他，任命他为广州刺史
燕大赦	前燕实行大赦
是岁，归义侯李势卒	这一年，归义侯李势去世
春，正月，壬子，大赦，改元	春季，正月，壬子，东晋实行大赦，改年号为隆和
甲寅，减田租，亩收二升	甲寅，东晋减免田租，每亩收租二升
燕豫州刺史孙兴请攻洛阳，曰：晋将陈弊卒千余，介守孤城，不足取也	前燕豫州刺史孙兴请求攻打洛阳，他说：东晋将领陈只有一千多疲惫体弱的兵卒，独守孤城，不堪一击
燕人从其言，遣宁南将军吕护屯河阴	前燕人听了他的话，派宁南将军吕护驻军河阴
二月，辛未，以吴国内史庾希为北中郎将、徐・兖二州刺史，镇下邳，龙骧将军袁真为西中郎将、监护豫・司・并・冀四州诸军事、豫州刺史，镇汝南；并假节	二月，辛未，东晋任命吴国内史庾希为北中郎将、徐、兖二州刺史，镇守下邳，任命龙骧将军袁真为西中郎将、监豫、司、并、冀四州诸军事、豫州剌史，镇守汝南，全都持有符节
希，冰之子也	庾希是庾冰的儿子
丙子，拜帝母周贵人为皇太妃，仪服拟于太后	丙子，东晋授予皇帝的母亲周贵人为皇太妃，礼仪服饰仿照太后的规格
秦王坚亲临太学，考第诸生经义，与博士讲论，自是每月一至焉	前秦王苻坚亲临太学，考查学生们的儒学经书义理，与博士一起谈论讲习，从此每月来这里一次
六月，甲戌，燕征东参军刘拔刺杀征东将军、冀州刺史、范阳王友于信都	六月，甲戌，前燕征东参军刘拔在信都刺杀了征东将军、冀州刺史、范阳王慕容友
冬，十一月，代王什翼犍纳女于燕，燕人亦以女妻之	冬季，十一月，代王拓跋什翼使向前燕进贡女子，前燕人也把女子送给他作妻
十二月，戊午朔，日有食之	十二月，戊午朔，出现日食
庾希从下邳后退，驻扎在山阳，袁真从汝南后退，驻扎在寿阳	春，二月，己亥，大赦，改元
东晋任命西中郎将袁真为都督司、冀、并三州诸军事，任命北中郎将庾希为都督青州诸军事	癸卯，燕人拔密城，刘远奔江陵
癸卯，前燕人攻下了密城，刘远逃奔到江陵	秋，八月，有星孛于角、亢
癸亥，东晋实行大赦	冬，十月，燕镇南将军慕容尘攻陈留太守袁披于长平；汝南太守朱斌乘虚袭许昌，克之
代王拓跋什冀犍攻击高车，把他们打得大败	以征虏将军桓冲为江州刺史
俘获一万多人，马、牛、羊一百多万头	十一月，姚襄故将张骏杀江州督护赵毗，帅其徒北叛；冲讨斩之
春季，正月，丙辰，前燕实行大赦	二月，燕太傅评、龙骧将军李洪略地河南
二月，前燕太傅慕容评、龙骧将军李洪率军巡视黄河以南	三月，庚戌朔，大阅户口，令所在土断，严其法制，谓之《庚戌制》
前燕侍中慕舆龙去到了龙城，将祭祀祖先的宗庙以及所留下来的百官全都迁徙到邺城	燕太宰恪将取洛阳，先遣人招纳士民，远近诸坞皆归之；乃使司马悦希军于盟津，豫州刺史孙兴军于成皋
春季，正月，庚申，东晋皇后王氏去世	刘卫辰复叛代，代王什翼犍东渡河，击走之
十二月，戊戌，东晋任命尚书王彪之为仆射	春，三月，荆州刺史桓豁使督护桓罴攻南郑，讨司马勋
春季，三月，荆州刺史桓豁派督护桓罴攻打南郑，讨伐司马勋	燕太宰、大司马恪，太傅、司徒评，稽首归政，上章绶，请归第；燕主不许
夏季，五月，戊寅，东晋皇后庾氏去世	朱序、周楚击司马勋，破之，擒勋及其党，送大司马温；温皆斩之，传首建康
代王拓跋什翼犍派左长史燕凤向前秦进献贡奉	秋，七月，癸酉，葬孝皇后于敬平陵
九月，甲午，司马勋因平定了梁、益二州，在境内实行赦免	冬，十月，加司徒昱丞相、录尚书事，入朝不趋，赞拜不名，剑履上殿
冬季，十月，东晋任命司徒司马昱担任丞相、录尚书事，并给予他入朝晋见皇帝不必小步趋行、唱拜不直呼姓名、可以佩剑穿鞋上殿的礼遇	张天锡遣使至秦境上，告绝于秦
张天锡派使者到前秦边境，告知与前秦绝交	燕抚军将军下邳王厉寇兖州，拔鲁、高平数郡，置守宰而还
徐、兖二州刺史庾希，因为是皇后家放族的缘故，兄弟们显贵一时，大司马桓温对比非常忌恨	春，正月，庾希坐不能救鲁、高平，免官
春季，正月，庾希因不能救援鲁郡、高平郡的罪过，被免官	二月，燕抚军将军下邳王厉、镇北将军宜都王桓袭敕勒
秋季，七月，前燕下邳王慕容厉等攻破了敕勒，夺取牛马数万头	九月，以会稽内史郗为都督徐・兖・青・幽・扬州之晋陵诸军事、徐・兖二州刺史，镇京口
十二月，甲子，前燕太尉建宁敬公阳鹜去世	春，正月，秦王坚遣后将军杨成世、左将军毛嵩分讨上、安定，辅国将军王猛、建节将军邓羌攻蒲阪，前将军杨安、广武将军张蚝攻陕城
任命司空皇甫真为侍中、太尉，光禄大夫李洪为司空	坚命蒲、陕之军皆距城三十里，坚壁勿战，俟秦、雍已平，然后并力取之
三月，丁巳朔，出现日食	癸亥，大赦
前秦杨安攻打晋阳，晋阳兵多粮足，久攻不下	秦兵长驱而东，丁卯，围邺
王猛留下屯骑校尉苟长戍守壶关，自己带兵帮助杨安攻打晋阳	猛上疏称：臣以甲子之日，大歼丑类
他们挖了地道，让虎牙将军张蚝率领勇士数百人潜入城中，大声呼喊着冲破了关卡，接秦兵入城	顺陛下仁爱之志，使六州士庶，不觉易主，自非守迷违命，一无所害
辛巳，王猛、杨安进入晋阳城，抓获了前燕并州刺史东海王慕容庄	秦王坚报之曰：将军役不逾时，而元恶克举，勋高前古
太傅慕容评惧怕王猛，不敢继续前进，驻扎在潞川	朕今亲帅六军，星言电赴
冬季，十月，辛亥，王猛留下将军武都人毛当戍守晋阳，自己进军潞川，与慕容评相对峙	将军其休养将士，以待朕至，然后取之
三月，壬辰，益州刺史建成定公周楚去世	秦后将军金城俱难攻兰陵太守张闵子于桃山，大司马温遣兵击却之
前秦后将军金城人俱难在桃山攻打兰陵太守张闵的儿子，大司马桓温派兵击退了他	秦西县侯雅、杨安、王统、徐成及羽林左监朱肜、扬武将军姚苌帅步骑七万伐仇池公杨纂
前秦西县侯苻雅、杨安、王统、徐成以及羽林左监朱肜、扬武将军姚苌率领步、骑兵七万人讨伐仇池公杨纂	代将长孙斤谋弑代王什翼犍，世子格之，伤胁，遂执斤，杀之
代国将领长孙斤图谋杀掉代王拓跋什翼犍，世子拓跋攻打他，伤了两肋，但终于擒获了长孙斤，把他杀掉了	夏，四月，戊午，大赦
代国的世子拓跋因伤势恶化而死亡	秋，七月，秦王坚如洛阳
秋季，七月，前秦王苻坚到洛阳	代世子娶东部大人贺野干之女，有遗腹子，甲戌，生男，代王什翼犍为之赦境内，名曰涉圭
前秦任命河州刺史李辩兼任兴晋太守，回去镇守罕	是岁，秦益州刺史王统攻陇西鲜卑乞伏司繁于度坚山，司繁帅骑三万拒统于苑川
将凉州的治所迁移到金城	统潜袭度坚山，司繁部落五万余皆降于统；其众闻妻子已降秦，不战而溃
张天锡听说前秦有兼并他的想法，十分害怕，便在姑臧城西设立祭坛，杀了牛、羊、猪三牲，率领他的官属们遥望东晋，与东晋的三公致意起誓结盟	司繁无所归，亦诣统降
派从事中郎韩博去奉献表章，送达盟约，同时还带信给大司马桓温，约定明年夏天在上盟会	秦王坚以司繁为南单于，留之长安；以司繁从叔吐雷为勇士护军，抚其部众
前秦王苻坚下达诏令说：关东的百姓有学问能够精通一经，才能具有一技之长的人，所在州县应按礼仪把他们送到官府	夏，四月，徙海西公于吴县西柴里，敕吴国内史刁彝防卫，又遣御史顾允监察之
享受百石以上俸禄的官吏，学问不能精通一经，才能没有一技之长的，罢官遣送，恢复普通百姓的身份	彝，协之子也
九月，东晋追尊过去的会稽王妃王氏为顺皇后，尊孝武帝的生母李氏为淑妃	冬，十月，丁卯，葬简文帝于高平陵
三吴地区发生大旱，许多人都饿死了	春，正月，己卯朔，大赦改元
夏季，代王拓跋什翼犍让燕凤去向前秦进献贡奉	秋，七月，己亥，南郡宣武公桓温薨
东晋任命王坦之为中书令，兼任丹杨尹	是岁，鲜卑勃寒掠陇右，秦王坚使乞伏司繁讨之，勃寒请降；遂使司繁镇勇士川
这一年，代王拓跋什翼犍攻打刘卫辰，向南逃走	春，正月，辛亥，大赦
春季，正月，辛亥，东晋实行大赦	夏，五月，丙午，蓝田献侯王坦之卒；临终与谢安、桓冲书，惟以国家为忧，言不及私
夏季，五月，丙午，蓝田献侯王坦之去世	桓冲以谢安素有重望，欲以扬州让之，自求外出
临终前给谢安、桓冲写信	桓氏族党皆以为非计，莫不扼腕固谏，郗超亦深止之，冲皆不听，处之澹然
只是对国家的事情表示忧虑，没有谈及个人的事情	甲寅，诏以冲都督徐・豫・兖・青・扬五州诸军事、徐州刺史，镇京口；以安领扬州刺史，并加侍中
春，正月，壬寅朔，帝加元服；皇太后下诏归政，复称崇德太后	春季，正月，壬寅朔，东晋孝武帝加冠，皇太后下达诏令，将朝政归还给他，自己恢复崇德太后的称号
甲辰，大赦，改元	甲辰，实行大赦，改年号为太元
丙午，帝始临朝	丙午，孝武帝开始临朝主持国政
以会稽内史郗为镇军大将军、都督浙江东五郡诸军事；徐州刺史桓冲为车骑将军、都督豫、江二州之六郡诸军事，自京口徙镇姑孰	任命会稽内史郗为镇军大将军、都督浙江东五郡诸军事；任命徐州刺史桓冲为车骑将军、都督豫江二州之六郡诸军事，从京口调到姑孰镇守
谢安欲以王蕴为方伯，故先解冲徐州	谢安想让王蕴做地方长官，所以先解除桓冲在徐州的职务
乙卯，加谢安中书监，录尚书事	乙卯，让谢安担任中书监，录尚书事
三月，秦兵寇南乡，拔之，山蛮三万户降秦	三月，前秦的军队进犯南乡，攻下该地，山蛮民众三万户投降前秦
夏，五月，甲寅，大赦	夏季，五月，甲寅，东晋实行大赦
初，张天锡之杀张邕也，刘肃及安定梁景皆有功，二人由是有宠，赐姓张氏，以为己子，使预政事	初，哀帝减田租，亩收二升
天锡荒于酒色，不亲庶务，黜世子大怀而立嬖妾之子大豫，以焦氏为左夫人，人情愤怨；从弟从事中郎宪舆榇切谏，不听	乙巳，除度田收租之制，王公以下，口税米三斛，蠲在役之身
这一年，乞伏司繁去世，儿子乞伏国仁继位	春，高句丽、新罗、西南夷皆遣使入贡于秦
桓豁上表请求任命兖州刺史朱序为梁州刺史，镇守襄阳	秋，七月，丁未，以尚书仆射谢安为司徒，安让不拜；复加侍中、都督扬・豫・徐・兖・青五州诸军事
九月，前秦王苻坚与群臣饮酒，让秘书监朱肜当酒正官，让人们都喝到烂醉如泥的程度	秦凉州刺史梁熙遣使入西域，扬秦威德
秘书侍郎赵整编了一首《酒德之歌》说：地上有酒泉，天上垂着酒池，杜康酒的美妙，帝女仪狄先知	冬，十月，大宛献汗血马
纣丧失殷商之邦，桀倾毁夏朝之国，由此言之，前人的危亡，后人的法则	秦王坚曰：吾尝慕汉文帝之为人，用千里马何为
苻坚听后十分高兴，命令赵整写出来以作为对饮酒的禁戒，从此再宴请群臣时，只是礼节性地喝一点酒而已	命群臣作《止马之诗》而反之
这一年，前秦发生严重饥荒	春，正月，秦王坚复以北海公重为镇北大将军，镇蓟
春季，正月，前秦王苻坚又任命北海公苻重为镇北大将军，镇守蓟城	秦征北将军、幽州刺史行唐公洛，勇而多力，能坐制奔牛，射洞犁耳；自以有灭代之功，求开府仪同三司不得，由是怨愤
	三月，秦王坚
东晋朝廷认为前秦军队的溃退是谢安、桓冲的功劳，给谢安授官卫将军，与桓冲都开府仪同三司	六月，甲子，大赦
六月，甲子，东晋实行大赦	丁卯，以会稽王道子为司徒；固让不拜
九月，癸未，东晋皇后王氏去世	冬，十月，九真太守李逊据交州反
冬季，十月，九真太守李逊占据交州反叛	秦王坚以左禁将军杨壁为秦州刺史，尚书赵迁为洛州刺史，南巴校尉姜宇为宁州刺史
前秦王苻坚任命左禁将军杨壁为秦州刺史，尚书赵迁为洛州刺史，南巴校尉姜宇为宁州刺史	十一月，乙酉，葬定皇后于隆平陵
十一月，乙酉，东晋在隆平陵安葬了定皇后王氏	十二月，秦以左将军都贵为荆州刺史，镇彭城
十二月，前秦任命左将军都贵为荆州刺史，镇守彭城	置东豫州，以毛当为刺史，镇许昌
前秦设置东豫州，任命毛当为刺史，镇守许昌	是岁，秦王坚遣高密太守毛之等二百余人来归
丁酉，东晋任命尚书谢石为仆射	二月，东夷、西域六十二国入贡于秦
二月，东夷、西域六十二国向前秦进贡	夏，六月，庚子朔，日有食之
夏季，六月，庚子朔，出现日食	秋，七月，甲午，交趾太守杜瑗斩李逊，交州平
秋季，七月，甲午，交趾太守杜缓斩杀李逊，交州得以平定	冬，十月，故武陵王卒于新安，追封新宁郡王，命其子遵为嗣
冬季，十月，原武陵王司马在新安去世，东晋追封他为新宁郡王，让他的儿子司马遵继嗣王位	十一月，己亥，以前会稽内史郗为司空；固辞不起
秋季，八月，癸卯，东晋实行大赦	秦王坚以谏议大夫裴元略为巴西、梓潼二郡太守，使密具舟师
春季，正月，前秦吕光发兵长安，以鄯善王休密驮、车师前部王弥作为向导	三月，丁巳，大赦
庚午，东晋实行大赦	谢安婿王国宝，坦之之子也；安恶其为人，每抑而不用，以为尚书郎
任命谢石为尚书令	国宝自以望族，故事唯作吏部，不为余曹，固辞不拜，由是怨安
晋升谢玄的称号为前将军，谢玄固执地辞让，不接受	国宝从妹为会稽王道子妃，帝与道子皆嗜酒，狎昵邪谄，国宝乃谮安于道子，使离间之于帝
	安功名既盛，而险求进之徒，多毁短安，帝由是稍疏忌之
壬子，后燕王慕容垂攻打邺城，攻下了外城，长乐公苻丕退守中城	丰城宣穆公桓冲闻谢玄等有功，自以失言，惭恨成疾；二月，辛巳，卒
关东六州的郡县大都送来人质请求向后燕投降	朝议欲以谢玄为荆、江二州刺史
癸丑，慕容垂任命陈留王慕容绍代理冀州刺史，驻扎在广阿	谢安自以父子名位太盛，又惧桓氏失职怨望，乃以梁郡太守桓石民为荆州刺史，河东太守桓石虔为豫州刺史，豫州刺史桓伊为江州刺史
三月，东晋任命卫将军谢安为太保	秦北地长史慕容泓闻燕王垂攻邺，亡奔关东，收集鲜卑，众至数千，还屯华阴，败秦将军强永，其众遂盛；自称都督陕西诸军事、大将军、雍州牧、济北王，推垂为丞相、都督陕东诸军事、领大司马、冀州牧、吴王
竟陵太守赵统攻打襄阳，前秦荆州刺史都贵逃奔鲁阳	五月，秦洛州刺史张五虎据丰阳来降
后秦王姚苌进军驻扎在北地，前秦华阴、北地、新平、安定的羌人、胡人投降的有十多万	六月，癸丑朔，崇德太后褚氏崩
东晋将军刘春攻打鲁阳，都贵逃回长安	后秦王苌帅众七万击秦，秦王坚遣杨璧等拒之，为苌所败；获杨璧及右将军徐成、镇军将军毛盛等将吏数十人，苌皆礼而遣之
前秦王苻坚听说慕容冲逐渐逼近长安，就带领军队返回，派抚军大将军苻方戍守骊山，任命平原公苻晖为都督中外诸军事、车骑大将军、录尚书事，配备五万兵众以抵抗慕容冲	秦康回兵数败，退还成都
慕容冲与苻晖在郑西交战，大败苻晖	梓潼太守垒袭以涪城来降
苻坚又派前将军姜宇与小儿子河间公苻琳率领三万兵众在灞上抵抗慕容冲，苻琳、姜宇全都战败死亡，慕容冲于是就占据了阿房城	荆州刺史桓石民据鲁阳，遣河南太守高茂北戍洛阳
八月，翟真从邯郸北逃，后燕王慕容垂派太原王慕容楷、骠骑大将军慕容农率领骑兵追击他，到下邑时追了上去	邺中刍粮俱尽，削松木以饲马
慕容楷想与他交战，慕容农说：士兵饥饿疲倦，而且在敌人的军营中看不见身强力壮的成年人，恐怕在其他地方有埋伏	燕王垂谓诸将曰：苻丕穷寇，必无降理；不如退屯新城，开丕西归之路，以谢秦王畴昔之恩，且为讨翟真之计
慕容楷没有听从，进军交战，后燕的军队大败	丙寅夜，垂解围趋新城
翟真向北开赴中山，驻扎在承营	遣慕容农徇清河、平原，徵督租赋，农明立约束，均适有无，军令严整，无所侵暴，由是谷帛属路，军资丰给
东晋太保谢安进上奏章，请求乘苻氏失败之机，开拓中原地区，任命徐、兖二州刺史谢玄为前锋都督，率领豫州刺史桓石虔讨伐前秦	秦王坚闻吕光平西域，以光为都督玉门以西诸军事，西域校尉
谢玄抵达下邳，前秦徐州刺史赵迁放弃彭城逃走，谢玄进军占据了彭城	道绝，不通
冬季，十月，辛亥朔，出现日食	乙丑，大赦
癸未，前秦王苻坚与西燕国主慕容冲在长安城西交战，大败慕容冲，一直追击到阿城	乙酉，秦益州刺史王广以蜀人江阳太守李丕为益州刺史，守成都
众将领请求乘胜入城，苻坚担心被慕容冲包围，带领军队返回	已丑，广帅所部奔还陇西，蜀人随之者三万余人
荥阳人郑燮举郡向东晋投降	燕王垂攻邺，久不下，将北诣冀州，乃命抚军大将军麟屯信都，乐浪王温屯中山，召骠骑大将军农还邺；于是远近闻之，以燕为不振，颇怀去就
秋季，七月，东晋发生大旱、饥荒，水井全都枯竭	后秦王苌自故县如新平
乞伏国仁自称大都督、大将军、单于、兼秦、河二州牧，改年号为建义，任命乙旃童为左相，屋引出支为右相，独孤匹蹄为左辅，武群勇士为右辅，弟弟乞伏乾归为上将军，在所辖领地分别设置了武城等十二郡，建筑了勇士城作为都城	秦尚书令、魏昌公纂自关中奔晋阳；秦主丕拜纂太尉，封东海王
前秦尚书令、魏昌公苻纂从关中奔赴晋阳	冬，十月，西燕主冲遣尚书令高盖帅众五万伐后秦，战于新平南，盖大败，降于后秦
前秦国主苻丕授予苻纂太尉官职，封他为东海王	初，盖以杨定为子，及盖败，定亡奔陇右，复收集其旧众
绎幕人蔡匡据城背叛了后燕，后燕慕容麟、慕容隆共同攻打他	慕容农至龙城，休士马十余日
泰山太守任泰暗中出兵救援蔡匡	诸将皆曰：殿下之来，取道甚速，今至此久留不进，何也
到了蔡匡营垒以南八里的地方，后燕人才发现了他们	农曰：吾来速者，恐馀岩过山钞盗，侵扰良民耳
众将领因为还没有攻下蔡匡而外面的敌人又突然到来，深以为患	岩才不逾人，诳诱饥儿，乌集为群，非有纲纪；吾已扼其喉，久将离散，无能为也
慕容隆说：蔡匡靠着外边的救援，所以不会马上攻下	今此田善熟，未取而行，徒自耗损，当俟收毕，往则枭之，亦不出旬日耳
如今考虑任泰的兵力不超过数千人，趁着他们尚未汇合，展开攻击，任泰一失败，蔡匡自然就会投降	顷之，农将步骑三万至令支，岩众震骇，稍稍逾城归农
于是就丢开蔡匡去攻击任泰，大败任泰，斩首一千多人	岩计穷出降，农斩之；进击高句丽，复辽东、玄菟二郡
蔡匡于是也就投降了，后燕王慕容垂杀掉了他，并且在他的营垒内大肆屠杀	还至龙城，上疏请缮修陵庙
前秦苻定据守信都以抵抗后燕，后燕王慕容垂任命堂弟北地王慕容精为冀州刺史，带领军队攻打苻定	拓跋从曾祖纥罗与其弟建及诸部大人共请贺讷推为主
后燕王慕容垂即皇帝位	后秦王苌如安定
代王拓跋迁徙到定襄的盛乐居住，致力于农耕，让百姓休养生息，国内的人对此都很高兴	三月，大赦
西燕仆射慕容恒、尚书慕容永袭击段随，把他杀掉了	鲜卑既东，长安空虚
立宜都王慕容恒的儿子慕容为燕王，改年号为建明，率领鲜卑男女四十多万人离开长安东去	前荥阳高陵赵谷等招杏城卢水胡郝奴帅户四千入于长安，渭北皆应之，以谷为丞相
慕容恒的弟弟护军将军慕容韬诱骗慕容，在临晋杀掉了他，慕容恒很愤怒，丢下慕容韬离开了	扶风王有众数千，保据马嵬，怒遣弟多攻之
慕容永与武卫将军刁云率领兵众攻打慕容韬，慕容韬失败，逃奔到慕容恒的军营	夏，四月，后秦王苌自安定伐之，奔汉中
慕容恒立西燕国主慕容冲的儿子慕容瑶为帝，改年号为建平，给慕容冲定谥号为威皇帝	苌执多而进，奴惧，请降，拜镇北将军、六谷大都督
兵众全都离开慕容瑶投奔慕容永，慕容永	
癸巳，东晋任命尚书仆射陆纳为左仆射，谯王司马恬为右仆射	毛兴袭击王广，败之，广奔秦州；陇西鲜卑匹兰执广送于后秦
陆纳是陆玩的儿子	兴复欲攻王统于上，罕诸氐皆厌苦兵事，乃共杀兴，推卫平为河州刺史，遣使请命于秦
后燕国主慕容垂封他的儿子慕容农为辽西王，慕容麟为赵王，慕容隆为高阳王	代王初改称魏王
代王拓跋开始改称魏王	张大豫自杨坞进屯姑臧城西，王穆及秃发思复子奚于帅众三万屯于城南；吕光出击，大破之，斩奚于等二万余级
魏王拓跋到东面的陵石，护佛侯部的主帅侯辰、乙佛部的主帅代题全都背叛逃走	六月，庚寅，以前辅国将军杨亮为雍州刺史，镇卫山陵
众将领请求追击他们，拓跋说：侯辰等人世代为我们效劳，有罪过也应该暂且容忍他们	荆州刺史桓石民遣将军晏谦击弘农，下之
如今国家刚刚建立，人心尚未统一，愚昧的人本来就是进退无常，不值得追击	初置湖、陕二戍
前秦国主苻丕任命苻登为征西大将军、开府仪同三司、南安王，持节、州牧、都督，全都根据他的自称而加以正式任命	初，后秦主苌之弟硕德统所部羌居陇上，闻苌起兵，自称征西将军，聚众于冀城以应之；以兄孙详为安远将军，据陇城，从孙训为安西将军，据南安之赤亭，与秦秦州刺史王统相持
又任命徐义为右丞相	苌自安定引兵会硕德攻统，天水屠各、略阳羌胡应之者二万余户
留下王腾镇守晋阳，右仆射杨辅戍守壶关，率领四万兵众，进军到平阳驻扎	秦略阳太守王皮降之
九月，王统献秦州投降了后秦	吕光得秦王坚凶问，举军缟素，谥曰文昭皇帝
后秦国主姚苌任命姚硕德为使持节、都督陇右诸军事、秦州刺史，镇守上	冬，十月，大赦，改元大安
甲申，海西公司马奕在吴郡去世	燕寺人吴深据清河反，燕主垂攻之，不克
后燕宦官吴深占据清河反叛，后燕国主慕容垂攻打他，没有攻克	后秦主苌还安定
张大豫从西郡进入临洮，掳掠了五千多户百姓，据守俱城	十二月，吕光自称使持节、侍中、中外大都督、督陇右・河西诸军事、大将军、凉州牧、酒泉公
后燕国主慕容垂任命魏王拓跋为西单于，封为上谷王	春，正月，乙已，以朱序为青、兖二州剌史，代谢玄镇彭城；序求镇准阴，许之
拓跋不予接受	以玄为会稽内史
后燕上谷郡人王敏袭杀了太守封，代郡人许谦驱逐了太守贾闰，各自举郡城归顺匈奴部落的刘显	燕乐浪王温为尚书右仆射
后燕乐浪王慕容温被任为尚书右仆射	夏，四月，戊辰，尊帝母李氏为皇太妃，仪服如太后
后燕国主慕容垂从黎阳回到中山	吴深杀燕清河太守丁国，章武人王祖杀太守白钦，勃海人张申据高城以叛；燕主垂命乐浪王温讨之
西秦苑川王乞伏国仁统领骑兵三万人袭击鲜卑部落的首领密贵、裕苟、提伦等三部所据守的六泉	秦主登军于瓦亭，后秦主苌攻彭沛谷堡，拔之，谷奔杏城
秋天，七月，乞伏国仁与前秦安定都尉没弈干、金熙，在渴浑川展开大战，没弈干、金熙大败，鲜卑三个部落也都归降了西秦	苌还阴密，以太子兴镇长安
辛已，立皇子司马德宗为太子，宣布大赦	燕主垂立刘显弟可泥为乌桓王，以抚其众，徙八千余落于中山
前秦国主苻登进兵据守胡空堡，戎族人与汉人前来归附的有十多万人	冬，十月，翟辽复叛燕，遣兵与王祖、张申寇抄清河、平原
春季，正月，东晋会稽郡太守、康乐献武公谢玄去世	二月，秦主登军朝那，后秦主苌军武都
翟辽派遣司马眭琼，前往后燕认罪	燕青州刺史陈留王绍为平原太守辟闾浑所逼，退屯黄巾固
后燕国主慕容垂因为他几次反复，便斩了眭琼，拒绝他的请求	燕主垂更以绍为徐州刺史
翟辽于是自称为魏天王，改年号为建光，设立文武百官	浑，蔚之子也，因苻氏乱，据齐地来降
五月，前秦皇太弟苻弟苻懿去世，谥号为献哀	翟辽徙屯滑台
六月，苑川王乞伏国仁卒，谥曰宣烈，庙号烈祖	六月，西秦苑川王乞伏国仁去世，谥号宣烈，庙号为烈祖
其子公府尚幼，群下推国仁弟乾归为大都督、大将军、大单于、河南王，大赦，改元太初	他的儿子乞伏公府还很幼小，因此，属下百官拥推乞伏国仁的弟弟乞伏乾归为大都督、大将军、大单于、河南王，并下令大赦，改年号为太初
秦、后秦自春相持，屡战，互有胜负，至是各解归	前秦与后秦从春天开始相持不下，交战了好几次，互有胜败，这时各自罢兵返回
关西豪杰以后秦久无成功，多去而附秦	关西的一些英雄豪杰因为后秦兴起这么久而仍不能成功，有很多便离去而归附了前秦
河南王乾归立其妻边氏为王后；置百官，仿汉制，以南川侯出连乞都为丞相，梁州刺史悌眷为御史大夫，金城边芮为左长史，东秦州刺史秘宜为右长史，武始翟为左司马，略阳王松寿为主簿，从弟轲弹为梁州牧，弟益州为秦州牧，屈眷为河州牧	西秦河南王乞伏乾归册立他的妻子边氏为王后；设置文武百官，摹仿汉族的制度，任命南川侯出连乞都为丞相，梁州刺史悌眷为御史大夫，金城人边芮为左长史，东秦州刺史秘宜为右长史，武始人翟为左司马，略阳人王松寿为主簿，任命他的堂弟乞伏轲弹为梁州牧，他的弟弟乞伏益州为秦州牧，乞伏屈眷为河州牧
八月，秦主登立子崇为皇太子，弁为南安王，尚为北海王	八月，前秦国主苻登立自己的儿子苻崇为皇太子，苻弁为南安王，苻尚为北海王
燕护军将军平幼会章武王宙讨吴深，破之，深走保绎幕	后燕护军将军平幼会同章武王慕容宙一起讨伐并打败吴深，吴深逃到绎幕固守
九月，河南王乾归迁都金城	九月，西秦河南王乞伏乾归把都城迁到金城
十二月，庚子，尚书令南康襄公谢石卒	十二月，庚子，东晋尚书令、南康襄公谢石去世
秦以颍川王同成为太尉	前秦任命颍川王苻同成为太尉
春，正月，燕以阳平王柔镇襄国	春季，正月，后燕命令阳平王慕容柔镇守襄国
后秦主苌以秦战屡胜，谓得秦王坚之神助，亦于军中立坚像而祷之曰：臣兄襄敕臣复仇，新平之祸，臣行襄之命，非臣罪也	后秦国主姚苌因为前秦军队屡次获胜利，以为那是得到了前秦国主苻坚的神灵帮助的结果，因此也在军营中竖立苻坚的神像，并且向他祷告说：我的哥哥姚襄临死时嘱咐我为他报仇，那次在新平城缢死您的祸事，就是我在执行哥哥姚襄的遗命，不是我的罪过呀
苻登，陛下疏属，犹欲复仇，况臣敢忘其兄乎	苻登，不过是陛下您的比较疏远的亲属，还想着为您复仇，何况我是弟弟，怎么敢忘掉哥哥的大仇呢
且陛下命臣以龙骧建业，臣敢违之	况且陛下您又命令我以龙骧将军的身分建立大业，我又怎敢违背您的教诲
今为陛下立像，陛下勿追计臣过也	今天我为陛下您立这尊神像，希望陛下不要再追究计较臣下我的过错
秦主登升楼，遥谓苌曰：为臣弑君，而立像求福，庸有益乎	前秦国主苻登爬上军营中的指挥楼，从远处告诉姚苌说：作为臣子而杀害了自己的君主，却又立像求福，能有什么好处呢
因大呼曰：弑君贼姚苌何不自出	因此，他又大声呼喊说：杀害了自己君主的奸贼姚苌为什么不自己出来
吾与汝决之	我和你决一死战
苌不应	姚苌不答应
久之，以战未有利，军中每夜数惊，乃斩像首以送秦	可是，时间一长，因为在交战时并没有得到什么好处，而他自己在军营中每夜都要受几次惊吓，所以，姚苌才把神像的头斩了下来送给了前秦
秦主登以河南王乾归为大将军、大单于、金城王	前秦国主苻登任命河南王乞伏乾归为大将军、大单于，封为金城王
甲寅，魏王袭高车，破之	甲寅，魏王拓跋袭击位于北方的高车部落，大破高车军
癸巳，魏王击吐突邻部于女水，大破之，尽徙其部落而还	癸巳，魏王拓跋在女水攻击吐突邻部，把他们打得大败，又强行将这个部落全部迁走，才班师回朝
秦主登留辎重于大界，自将轻骑万余攻安定羌密造保，克之	秦国主苻登把部队的一些需要搬运的笨重物资留在大界，亲自率领一支一万多人的轻装骑兵部队进攻据守安定的羌族密造保，并攻克了他们的地域
夏，四月，翟辽寇荥阳，执太守张卓	夏季，四月，翟辽侵犯荥阳，抓住了荥阳太守张卓
燕以长乐公盛镇蓟城，修缮旧宫	后燕派遣长乐公慕容盛镇守蓟城，修理整顿旧有宫殿
金城王乾归击侯年部，大破之	西秦金城王乞伏乾归袭击侯年部落，并把侯年部落打得大败
于是秦、凉、鲜卑、羌、胡多附乾归，乾归悉授以官爵	从此秦州、凉州的百姓以及鲜卑人、羌人、胡人等大多数都归附了乞伏乾归，乞伏乾归对他们中的头目都加授官爵
秋，七月，以骠骑长史王忱为荆州刺史、都督荆・益・宁三州诸军	秋季，七月，东晋任命骠骑长史王忱为荆州刺史，都督荆、益、宁三州诸军事
忱，国宝之弟也	王忱是王国宝的弟弟
九月，庚午，以左仆射陆纳为尚书令	九月，庚午，东晋擢升左仆射陆纳为尚书令
冬，十月，秦主登以窦冲为大司马、都督陇东诸军事、雍州牧，杨定为左丞相、都督中外诸军事、秦・梁二州牧，约共攻后秦；又约监河西诸军事・并州刺史杨政、都督河东诸军事・冀州刺史杨楷各帅其众会长安	冬季，十月，前秦国主苻登任命窦冲为大司马、都督陇东诸军事，雍州牧；杨定为左丞相、都督中外诸军事及秦、梁二州牧，约定一起进攻后秦
政、楷皆河东人	苻登又分别通知监河西诸军事、并州刺史杨政，都督河东诸军事、冀州刺史杨楷，各自统率他们的军队在长安会师
秦主丕既败，政、楷收集流民数万户，政据河西，楷据湖、陕之间，遣使请命于秦，登因而授之	杨政、杨楷都是河东人，前秦国主苻丕当年失败的时候，杨政、杨楷招集收容逃亡的难民几万户，杨政占据河西，杨楷占据湖县、陕城一带地方，并派遣信使向前秦请求任命官职，苻登按照他们的功劳分别授给官职
秦以安成王广为司徒	前秦任命安成王苻广为司徒
春，正月，乙亥，谯敬王恬薨	春季，正月，乙亥，东晋青州、兖州刺史谯敬王司马恬去世
三月，戊辰，大赦	三月，戊辰，东晋宣布大赦
后秦主苌攻秦扶风太守齐益男于新罗堡，克之，益男走	后秦国主姚苌在新罗堡进攻前秦扶风太守齐益男，攻克之后，齐益男逃走
秦主登攻后秦天水太守张业生于陇东，苌救之，登引去	而前秦国主苻登又在陇东进攻后秦天水太守张业生，姚苌赶去解救他，苻登率兵退去
秋，七月，冯翊人郭质起兵于广乡以应秦，移檄三辅曰：姚苌凶虐，毒被神人	秋季，七月，冯翊人郭质在广乡聚众起兵，来响应投靠前秦，并向三辅的百姓发布檄文说：姚苌这个家伙凶恶残暴，他的祸害遍及天神和民众
吾属世蒙先帝尧、舜之仁，非常伯、纳言之子，即卿校、牧守之孙也	我们世世代代蒙受先帝苻坚像尧和舜那样的恩德仁政，即使不是侍中、尚书一类官的儿子，那么也应该是卿、校、牧、守之类的地方官员的孙子了
与其含耻而存，孰若蹈道而死	与其忍受屈辱活着，不如为追求正义而死
于是三辅壁垒皆应之；独郑县人苟曜聚众数千附于后秦	于是，三辅一带所有的民堡都起兵响应他的号召，惟独郑县人苟曜召集部众数千人去归附了后秦
秦以质为冯翊太守	前秦任命郭质为冯翊太守
后秦以曜为豫州刺史	后秦则任命苟曜为豫州刺史
以侍中王国宝为中书令，俄兼中领军	东晋任命侍中王国宝为中书令，不久，又兼任中领军
丁未，以吴郡太守王为尚书右仆射	丁未，东晋又调任吴郡太守王为尚书右仆射
吐谷浑视连卒，子视罴立	吐谷浑可汗、白兰王慕容视连去世，他的儿子慕容视罴继位
视罴以其父祖慈仁，为四邻所侵侮，乃督厉将士，欲建功业	慕容视罴认为他的父亲、祖父由于秉性仁慈和善，而受到四周邻国的侵略欺侮，于是，他常常督促激励将士，加强军事训练，打算以此建立功业
冬，十月，金城王乾归遣使拜视罴沙州牧、白兰王；视罴不受	冬季，十月，西秦金城王乞伏乾归派遣使者委任慕容视罴为沙州牧，并封白兰王，慕容视罴拒绝接受
越质诘归据平襄，叛金城王乾归	西秦国鲜卑部落首领越质诘归据守平襄，背叛了金城王乞伏乾归
春，正月，燕置行台于蓟，加长乐公盛录行台尚书事	春季，正月，后燕在蓟城设置行台，任命长乐公慕容盛录行台尚书事
贺染干谋杀其兄讷，讷知之，举兵相攻	贺兰部落的贺染干准备谋杀亲哥哥贺讷，贺讷得知后派兵攻打
魏王告于燕，请为乡导以讨之	魏王拓跋把这个消息告诉后燕，请求担任向导而带兵去讨伐他们
二月，甲戌，燕主垂遣赵王麟将兵击讷，镇北将军兰汗帅龙城之兵击染干	二月，甲戌，后燕国主慕容垂派遣赵王慕容麟带领部队去袭击贺讷，又派镇北将军兰汗统率龙城的守军去袭击贺染干
夏，四月，燕兰汗破贺染干于牛都	夏季，四月，后燕兰汗在牛都将贺染干的部队打败
西燕主永寇河南，太守杨期击破之	西燕国主慕容永进犯东晋的河南郡，太守杨期率守兵打败了慕容永
秋，七月，壬申，燕主垂如范阳	秋季，七月，壬申，后燕国主慕容垂来到范阳
秦主登攻新平，后秦主苌救之，登引去	前秦国主苻登进攻新平，后秦国主姚苌率兵赶去解救
	苻登带兵退走
九月，癸未，以尚书右仆射王为左仆射，太子詹事谢琰为右仆射	九月，癸未，东晋任命尚书右仆射，王为左仆射，太子詹事谢琰为右仆射
太学博士范弘之论殷浩宜加赠谥，因叙桓温不臣之迹	太学博士范弘之提议殷浩应该追加谥号，又顺便述说了桓温叛逆的事情
是时桓氏犹盛，王，温之故吏也，以为温废昏立明，有忠贞之节；黜弘之为馀杭令	这个时候，桓氏家族的气势仍然很大，王以前也是桓温的属官，认为桓温废黜昏君，拥立明君，是具有忠贞的节操的，因此，便把范弘之逐出京都，贬为余杭令
弘之，汪之孙也	范弘之是范汪的孙子
冬，十月，壬辰，燕主垂还中山	冬季，十月，壬辰，后燕国主慕容垂回到中山
翟辽卒，子钊代立，改元定鼎	翟辽去世，他的儿子翟钊继位，改年号为定鼎
攻燕邺城，燕辽西王农击却之	翟钊攻击后燕邺城，后燕辽西王慕容农把他击退
戊申，燕主垂如鲁口	戊申，后燕国主慕容垂来到鲁口
春，正月，己巳朔，大赦	春季，正月，己巳朔，东晋实行大赦
秦主登立昭仪陇西李氏为皇后	前秦国主苻登册立昭仪、陇西人李氏为皇后
二月，壬寅，燕主垂自鲁口如河间、渤海、平原	二月，壬寅，后燕国主慕容垂从鲁口前往河间、渤海、平原
翟钊遣其将翟都侵馆陶，屯苏康垒	翟钊派遣他的部将翟都侵犯馆陶，驻在苏康垒
三月，垂引兵南击钊	三月，慕容垂带领部队向南袭击翟钊
燕主垂进逼苏康垒	后燕国主慕容垂向前进军威逼苏康垒
夏，四月，翟都南走滑台	夏季，四月，翟都向南撤退到滑台
翟钊求救于西燕，西燕主永谋于群臣，尚书郎渤海鲍遵曰：使两寇相弊，吾承其后，此卞庄子之策也	翟钊向西燕请求救援，西燕国主慕容永与大臣们商议，尚书郎渤海人鲍遵说：让这两个寇匪互相进攻、消耗力量，我们紧跟在他们背后，坐收渔人之利，这是卞庄子当年所用过的策略
中书侍郎太原张腾曰：垂强钊弱，何弊之承	中书侍郎太原人张腾则说：慕容垂强大，而翟钊弱小，我们有什么好处可以得到呢
不如速救之，以成鼎足之势	不如赶快去解救翟钊，这样还可以形成鼎足而立的局势
今我引兵趋中山，昼多疑兵，夜多火炬，垂必惧而自救	现在我们带领部队奔袭后燕的都城中山，白天多设些疑兵，黑夜多点一些火把，慕容垂得知后一定会担心后方的安全而赶回来为自己解围
我冲其前，钊蹑其后，此天授之机，不可失也	那时候，我们再迎击他们的前面，翟钊又可以跟在他们的背后骚扰，这是上天所给我们提供的绝好时机，万万不可失去
永不从	慕容永没有听从他的话
燕大赦	后燕实行大赦
五月，丁卯朔，日有食之	五月，丁卯朔，出现日食
冬，十月，辛亥，荆州刺史王忱卒	冬季，十月，辛亥，东晋荆州刺史王忱去世
巴蜀人在关中者皆叛后秦，据弘农以附秦	流亡到关中一带的巴蜀人全部背叛了后秦，占据了弘农并归附前秦
秦主登以窦冲为左丞相，冲徙屯华阴	前秦国主苻登任命窦冲为左丞相，带兵转到华阴去驻扎
郗恢遣将军赵睦守金墉，河南太守杨期帅众军湖城，击冲，走之	郗恢派遣将军赵睦据守金墉，河南太守杨期统率部队到湖城，袭击窦冲，并把窦冲赶走
十一月，癸酉，以黄门郎殷仲堪为都督荆・益・宁三州诸军事、荆州刺史，镇江陵	十一月，癸酉，东晋任命黄门郎殷仲堪为都督荆、益、宁三州诸军事，荆州刺史，镇守江陵
仲堪虽有英誉，资望犹浅，议者不以为允	殷仲堪虽然有很好的名声，但是资历、威望还浅，因此议论的人认为并不公允合理
到官，好行小惠，纲目不举	果然，殷仲堪到达任上后，喜欢行使小恩小惠，对大政方针缺乏有力切实的措施
庚寅，立皇子德文为琅邪王，徙琅邪王道子为会稽王	庚寅，孝武帝立他的儿子司马德文为琅邪王，把原琅邪王司马道子改封为会稽王
十二月，燕主垂还中山，以辽西王农为都督兖、豫、荆、徐、雍五州诸军事，镇邺	十二月，后燕国主慕容垂回到都城中山，任命辽西王慕容农为都督兖、豫、荆、徐、雍五州诸军事，镇守邺城
休官权千成据显亲，自称秦州牧	休官部落的首领权千成据守显亲县，自称为秦州牧
春，正月，燕阳平孝王柔卒	春季，正月，后燕阴平孝王慕容柔去世
金成王乾归立其子炽磐为太子	西秦金城王乞伏乾归立他的儿子乞伏炽磐为太子
炽磐勇略明决，过于其父	乞伏炽磐的武勇谋略和明智决断，都超过他父亲
冬，十月，后秦主苌疾甚，还长安	冬季，十月，后秦国主姚苌病重，回到长安
己亥，后秦主苌召太尉姚、仆射尹纬、姚晃、将军姚大目、尚书狄伯支入禁中，受遗诏辅政	己亥，后秦国主姚苌把太尉姚、仆射尹纬、姚晃、将军姚大目、尚书狄伯支等人召进宫中，要他们接受遗诏辅佐太子姚兴治理朝政
苌谓太子兴曰：有毁此诸公者，慎勿受之	姚苌对太子姚兴说：如果有诋毁攻击这几位先生的人，你一定要慎重处理，不要听从他们的话
汝抚骨肉以恩，接大臣以礼，待物以信，遇民以仁，四者不失，吾无忧矣	你如能做到用恩德来抚慰骨肉，用礼仪来对待大臣，用信义来处理一切事情，用仁慈来对待百姓，这四个方面都能不偏废的话，我就没有什么可担忧的了
姚晃垂涕问取苻登之策，苌曰：今大业垂成，兴才智足办，奚所复问	姚晃此时流着泪询问征服苻登的计策，姚苌说：现在，我们的帝王大业马上就要完成了，姚兴的才智与谋略已经足可以胜任，还有什么必要再来问我呢
庚子，苌卒	庚子，姚苌去世
兴秘不发丧，以其叔父绪镇安定，硕德镇阴密，弟崇守长安	姚兴不对外宣布，只是马上任命他的叔叔姚绪去镇守安定，派遣姚硕德去镇守阴密，并命令他的弟弟姚崇留守长安
二月，秦主登攻屠各姚奴、帛蒲二堡，克之	二月，前秦国主苻登进攻了屠各部落所占领的姚奴堡、帛蒲堡
六月，壬子，追尊会稽王太妃郑氏曰简文宣太后	六月，壬子，孝武帝追尊自己的祖母，元帝司马睿的妃子郑氏为简文宣太后
群臣谓宣太后应配食元帝，太子前率徐邈曰：宣太后平素之时，不伉俪于先帝；至于子孙，岂可为祖考立配	很多大臣都说宣太后的牌位应该被尊放在元帝之侧，与元帝一起享受香火，太子前率徐邈却说：宣太后活着的时候，并没有被作为先帝的婚配正室，到了作为子孙的人，我们怎么可以为祖先们做主安排妻室呢
国学明教东莞臧焘曰：今尊号既正，则罔极之情申；别建寝庙，则严祢之义显；系子为称，兼明贵之所由	国学明教东莞人臧焘说：现在，宣太后的尊号已经扶正，作为后代的无穷的孝思已经得到表达；为宣太后另建一座祭庙，尊重先辈祭庙的心情就已可以显现；把儿子的谥号加在母亲的谥号前面，能使人明白母亲得以荣耀尊贵的原因
一举而允三义，不亦善乎	这一个举动可以符合三方面的意义，不也是一件应该做的好事吗
乃立庙于太庙路西	于是，在太庙路的西侧建立一座宣太后的祭庙
三河王光以子覆为都督玉门以西诸军事、西域大都护，镇高昌；命大臣子弟随之	后凉三河王吕光，任命他的儿子吕覆为都督玉门以西诸军事、西域大都护，镇守高昌，并命令大臣的子弟，随同前往
八月，己巳，尊皇太妃李氏为皇太后，居崇训宫	八月，己巳，孝武帝尊封皇太妃李氏为皇太后，居住在崇训宫
十一月，燕辽西王农败辟闾浑于龙水，遂入临淄	十一月，后燕辽西王慕容农在龙水地方击败了东晋的辟闾浑，随即进入临淄
十二月，燕主垂召农等还	十二月，后燕国主慕容垂把慕容农等随即征召回国
梁王乾归自称秦王，大赦	西秦梁王乞伏乾归自称秦王，实行大赦
西秦王乾归以太子炽磐领尚书令，左长史边芮为左仆射，右长史秘宜为右仆射，置官皆如魏武、晋文故事，然犹称大单于、大将军	西秦王乞伏乾归任命太子乞伏炽磐领尚书令，左长史边芮为左仆射，右长史秘宜为右仆射，设置的文武百官等都按照魏武帝和晋文帝时的旧例，但却还依然称大单于、大将军等
边芮等领府佐如故	边芮等人也都还像过去一样兼任大单于府、大将军府的官职
薛干太悉伏自长安亡归岭北	薛干部落的首领太悉伏，从后秦长安逃回到岭北
上郡以西鲜卑杂胡皆应之	上郡以西地区的鲜卑族人和其他胡人都纷纷起来响应他
二月，甲寅，尚书令陆纳卒	二月，甲寅，东晋尚书令陆纳去世
三月，庚辰朔，日有食之	三月，庚辰朔，出现日食
皇太子出就东宫，以丹杨尹王雅领少傅	东晋皇太子司马德宗从皇宫迁到太子东宫居住，孝武帝任命丹杨尹王雅兼任太子少傅
六月，癸丑，燕太原元王楷卒	六月，癸丑，后燕太原元王慕容楷去世
西秦王乾归迁于西城	西秦王乞伏乾归把自己的都城迁到苑川西城
魏张衮闻燕军将至，言于魏王曰：燕狃于滑台、长子之捷，竭国之资力以来，有轻我之心，宜羸形以骄之，乃可克也	北魏长史张衮听说后燕的大军即将到来，向魏王拓跋献计说：后燕国被滑台、长子两次战役的胜利冲昏了头脑，这次动员全国的人力物力来进攻我们，是有轻视我们的意思，我们应该表现我们的疲惫孱弱，以使他们更加骄纵，我们便可以攻克他们了
从之，悉徙部落畜产，西渡河千余里以避之	拓跋听从了他的计策，命令把所有的部落的牲畜资产全部迁到黄河以西一千多里以外的地方去躲避
燕军至五原，降魏别部三万余家，收田百余万斛，置黑城，进军临河，造船为济具	后燕军队来到五原，收降了北魏其他部落的居民三万多户，收割杂粮一百多万斛，在那里设置了黑城，然后把大军开进到黄河边，打造船只，准备渡河用具
遣右司马许谦乞师于秦	拓跋派遣右司马许谦去向后秦请求援助
是岁，秦主兴封其叔父绪为晋王，硕德为陇西王，弟崇为齐公，显为常山公	这一年，后秦国主姚兴封他的叔父姚绪为晋王，封另一位叔叔姚硕德为陇西王，封他的弟弟姚崇为齐公，弟弟姚显为常山公
春，正月，燕高阳王隆引龙城之甲入中山，军容精整，燕人之气稍振	春季，正月，后燕高阳王慕容隆带领驻防龙城的兵士来到中山，军容精壮整齐，使后燕人的精神稍稍得到振奋
休官权万世帅众降西秦	休官部落的首领权万世率领部众投降了西秦
乙卯，以散骑常侍彭城刘该为徐州刺史，镇鄄城	乙卯，东晋任命散骑常侍、彭城人刘该为徐州刺史，镇守鄄城
甲子，以望蔡公谢琰为尚书左仆射	甲子，东晋任命望蔡公谢琰为尚书左仆射
六月，癸酉，魏王遣将军王建等击燕广宁太守刘亢泥，斩之，徙其部落于平城	六月，癸酉，魏王拓跋派遣将军王建等人袭击后燕广宁太守刘亢泥，杀了他，并把他所属的部落迁到平城
燕上谷太守开封公详弃郡走	后燕上谷太守开封公慕容详放弃自己的郡城逃走
详，之曾孙也	慕容详是慕容的曾孙子
丁亥，魏贺太妃卒	丁亥，北魏贺太妃去世
纳故中书令王献之女为太子妃	东晋太子司马德宗，娶原中书令王献之的女儿为太子妃
献之，羲之之子也	王献之是王羲之的儿子
魏群臣劝魏王称尊号，始建天子旌旗，出警入跸，改元皇始	北魏的文武大臣一致劝说魏王拓跋自称尊号，拓跋才开始制作天子才用的旌旗，出入时戒备森严，清除道路，禁止行人通行，改年号为皇始
参军事上谷张恂劝进取中原，善之	参军事、上谷人张恂进劝拓跋发兵去夺取中原，拓跋以为他说得很对
魏王使冠军将军代人于栗、宁朔将军公孙兰帅步骑二万，潜自晋阳开韩信故道	魏王拓跋派遣冠军将军、代郡人于栗、宁朔将军公孙兰等二人率领步、骑兵共二万人，偷偷地从晋阳向东开辟修复韩信当年修筑使用过的栈道
己酉，自井陉趋中山	已酉，拓跋带兵从井陉直奔中山
李先降魏，以为征东左长史	李先投降了北魏，拓跋任命他为征东左长史
西秦凉州牧轲弹与秦州牧益州不平，轲弹奔凉	西秦凉州牧乞伏轲弹与秦州牧乞伏益州二人发生冲突，乞伏轲弹投奔后凉国
春，正月，己亥朔，帝加元服，改元	春季，正月，己亥朔，东晋安帝行加冕礼，改年号为隆安
以左仆射王为尚书令；领军将军王国宝为左仆射，领选；仍加后将军、丹杨尹	任命左仆射王为尚书令；领军将军王国宝为左仆射，兼管官员任免升降，仍兼任后将军、丹杨尹
会稽王道子悉以东宫兵配国宝，使领之	会稽王司马道子把东宫太子的兵马全部分配给王国宝，让他带领这些部队
秃发乌孤自称大都督、大将军、大单于、西平王，大赦，改元太初	秃发乌孤自称为大都督、大将军、大单于、西平王，实行大赦，改年号为太初
治兵广武，攻凉金城，克之	在广武集结整顿部队，进攻并攻克后凉金城
凉王光遣将军窦苟伐之，战于街亭，凉兵大败	后凉王吕光派将军窦苟去讨伐，在街亭展开激战，后凉军大败
三月，燕以仪同三司武乡张崇为司空	三月，后燕任命仪同三司、武乡人张崇为司空
甲寅，尊皇太后李氏为太皇太后	甲寅，安帝尊奉他的祖母皇太后李氏为太皇太后
戊午，立皇后王氏	戊午，册立王氏妃子为皇后
燕主宝出中山，与赵王麟遇于城	后燕国主慕容宝逃出都城中山，和赵王慕容麟在城相遇，慕容麟没有想到慕容宝来到这里，大惊失色，赶紧率领着他的部众向蒲阴逃去，然后又来到望都驻扎
麟不意宝至，惊骇，帅其众奔蒲阴，复出屯望都，土人颇供给之	当地的土人还为他提供粮草
慕容详遣兵掩击麟，获其妻子，麟脱走，入山中	慕容详派兵袭击慕容麟，抓获了他的妻子儿女，慕容麟自己则逃脱，进入山中
燕库官骥入中山，与开封公详相攻	后燕西河公库官骥进入中山，与留守在那里的开封公慕容详互相攻打，莫容详杀了库官骥，并把整个库官氏家族全部消灭
详杀骥，尽灭库官氏；又杀中山尹苻谟，夷其族	他又杀死了中山尹苻谟，屠杀了苻谟家一族
中山城无定主，民恐魏兵乘之，男女结盟，人自为战	中山城内没有一个主事人，居民们害怕北魏的军队乘虚攻进城来，男女老幼自愿结起盟约，各自单独作战
凉王光遣太原公纂将兵击沮渠蒙逊于谷，破之	后凉王吕光派遣太原公吕纂带兵在谷进攻沮渠蒙逊，并把他打败
蒙逊逃入山中	沮渠蒙逊逃进深山之中
六月，西秦王乾归征北河州刺史彭奚念为镇卫将军；以镇西将军屋弘破光为河州牧；定州刺史翟为兴晋太守，镇罕	六月，西秦王乞伏乾归征召北河州刺史鼓奚念为镇卫将军，任命镇西将军屋弘破光为河州牧，定州刺史翟为兴晋太守，镇守罕
燕以辽西王农为都督中外诸军事、大司马、录尚书事	后燕任命辽西王慕容农为都督中外诸军事、大司马、录尚书事
鲜卑薛勃叛秦，秦主兴自将讨之	后秦所属的鲜卑部落首领薛勃叛变，后秦国主姚兴亲自带兵去讨伐他，薛勃战败，去投奔没弈干，没弈干把他抓住送回后秦
勃败，奔没弈干，没弈干执送之	
秦泫氏男姚买得谋弑秦主兴，不克而死	后秦泫氏男、姚买得阴谋杀害后秦国主姚兴，没有成功而被杀死
中山饥甚，慕容麟帅二万余人出据新市	中山城里的饥荒越来越严重，慕容麟带领二万多人出城据守新市
甲子晦，魏王进军攻之	甲子晦，魏王拓跋指挥军队进攻慕容麟
太史令晁崇曰：不吉	太史令晁崇说：今天很不吉利
昔纣以甲子亡，谓之疾日，兵家忌之	过去纣王就是在甲子这天灭亡的，因此人们都把这天叫疾日，用兵的人忌讳这一天
曰：纣以甲子亡，周武不以甲子兴乎	拓跋说：纣王在甲子这天死，周武王不是在甲子这天兴起吗
崇无以对	晁崇没有什么话可以回答
冬，十月，丙寅，麟退阻水	冬季，十月，丙寅，慕容麟撤退到水去据守
甲戌，与麟战于义台，大破之，斩首九千余级，麟与数十骑驰取妻子入西山，遂奔邺	甲戌，拓跋与慕容麟在义台展开激战，把后燕军打得落花流水，有九千多人被杀，慕容麟与几十个骑兵跑过去救出自己的妻子儿女逃进西山，随后又逃奔邺城
秦长水校尉姚珍奔西秦，西秦王乾归以女妻之	后秦长水校尉姚珍投奔西秦，西秦国主乞伏乾归把女儿嫁给他
河南鲜卑吐秣等十二部大人，皆附于秃发乌孤	河南鲜卑族吐秣等十二个部落的首领，全部归附于秃发乌孤
庚子，魏王自中山南巡至高邑，得王永之子宪，喜曰：王景略之孙也	庚子，魏王拓跋从中山出发向南巡视，来到高邑，寻访到原来前秦左丞相王永的儿子王宪，非常高兴地说：你是王景略的孙子
以为本州中正，领选曹事，兼掌门下	于是，马上任命他做本州的中正，兼选曹事，主持门下事务
至邺，置行台，以龙骧将军日南公和跋为尚书，与左丞贾彝帅吏兵五千人镇邺	拓跋来到邺城，在那里设置了行台，任命龙骧将军日南公和跋为尚书，与左丞贾彝统率吏兵五千人镇守在邺城
燕启伦还至龙城，言中山已陷；燕主宝命罢兵	后燕启伦回到龙城，说中山已经被攻陷，后燕国主慕容宝命令部队停止行动
辽西王农言于宝曰：今迁都尚新，未可南征，宜因成师袭库莫奚，取其牛马以充军资，更审虚实，俟明年而议之	辽西王慕容农对慕容宝说：现在从中山迁回龙城，时间还太短，千万不可发动大军向南出征，应该利用已经准备好的部队进攻库莫奚部落，夺取他们的牛马来充实我们的军备物资，然后再了解情况，等到明年再来商议出兵南征的事
宝从之	慕容宝听从了他的劝告
己未，北行	己未，调动部队向北进发
庚申，渡浇洛水，会南燕王德遣侍郎李延诣宝，言涉圭西上，中国空虚	庚申，渡过浇洛水，正好南燕王慕容德派遣侍郎李延拜见慕容宝，追到这里说：拓跋取路向西，中部地区非常空虚
延追宝及之，宝大喜，即日引还	慕容宝闻听此言，大喜，当天就带着大军回来了
辛酉，魏王发中山，徙山东六州吏民杂夷十余万口以实代	辛酉，魏王拓跋从中山出发，迁移原在山东居住的六州居民、官吏以及一些杂居的夷人十多万，充实代郡的人口
博陵、勃海、章武群盗并起，略阳公遵等讨平之	博陵、勃海、章武等地的成群盗匪纷纷起事，略阳公拓跋遵等人将他们讨灭平定
西秦王乾归遣乞伏益州攻凉支阳、武、允吾三城，克之；虏万余人而去	西秦王乞伏乾归派遣乞伏益州进攻后凉的支阳、武、允吾三座城池，并且全部攻克，俘虏了一万多人而离去
燕主宝还龙城宫，诏诸军就顿，不听罢散，文武将士皆以家属随驾	后燕国主慕容宝回到龙城寝宫，诏令各路大军回到兵营集结，不许解散，文武官员和将士全部携带家属跟随御驾
辽西王农、长乐王盛切谏，以为兵疲力弱，魏新得志，未可与敌，宜且养兵观衅	辽西王慕容农、长乐王慕容盛再三恳切劝阻，觉得国家军队疲惫、力量薄弱，而北魏则是刚刚获得胜利，万万不可与它对敌；应该暂且将养修整军队静观时机
宝将从之，抚军将军慕舆腾曰：百姓可与乐成，难与图始	慕容宝刚要打算接受他们的劝谏，抚军将军慕舆腾说：老百姓是只可以与他们享乐成功后的快慰，很难和我们一起图谋大业的创始
今师众已集，宜独决圣心，乘机进取，不宜广采异同以沮大计	现在各路大军的兵众已经集结完毕，您应该独自下定决心，把握住机会，努力进取，不应该广泛听取相同或者不同的意见，影响甚至破坏国家大计的施行
宝乃曰：吾计决矣，敢谏者斩	慕容宝于是说：我的计划已经决定，再有人胆敢劝阻，格杀勿论
二月，乙亥，宝出就顿，留盛统后事	二月，乙亥，慕容宝离开皇宫，进驻兵营，留下慕容盛统管后事
己卯，燕军发龙城，慕舆腾为前军，司空农为中军，宝为后军，相去各一顿，连营百里	己卯，后燕军从龙城出发，慕舆腾为前锋，司空慕容农为中军，慕容宝亲自殿后，各军之间相距三十里，全军的兵营前后相连，绵延一百多里
魏王如繁宫，给新徙民田及牛	魏王拓跋回到繁自己的宫里，给那些新迁移来的百姓分发田地及耕牛
杨轨以其司马郭纬为西平相，帅步骑二万北赴郭	杨轨任命他的司马郭纬为西平相，并率领步、骑兵二万人向北开进增援郭
秃发乌孤遣其弟车骑将军檀帅骑一万助轨	秃发乌孤派他的弟弟车骑将军秃发檀带领骑兵一万人帮助杨轨
轨至姑臧，营于城北	杨轨的部队抵达姑臧，在城北扎下大营
凉太原公纂将兵击杨轨，郭救之，纂败还	后凉太原公吕纂带兵进攻杨轨，郭赶来相救，吕纂失败而归
段业使沮渠蒙逊攻西郡，执太守吕纯以归	北凉段业派沮渠蒙逊进攻西郡，俘获太守吕纯后回师
纯，光之弟子也	吕纯是吕光的侄儿
于是晋昌太守王德、敦煌太守赵郡孟敏皆以郡降业	从此，晋昌太守王德、敦煌太守赵郡人孟敏都献出本郡，投降了段业
业封蒙逊为临池侯，以德为酒泉太守，敏为沙州刺史	段业封沮渠蒙逊为临池侯，任命王德为酒泉太守，孟敏为沙州刺史
魏王迁都平城，始营宫室，建宗庙，立社稷	魏王拓跋把都城迁到平城，开始营建宫殿，筑造宗庙，以及土神、谷神的祭坛
宗庙岁五祭，用分、至及腊	皇家宗庙每年祭祀五次，时间为春分、夏至、秋分、冬至以及腊日
燕以河间公熙为侍中、车骑大将军、中领军、司隶校尉，城阳公元为卫将军	后燕任命河间公慕容熙为侍中、骠骑大将军、中领军、司录校尉，城阳公慕容元为卫将军
元，宝之子也	慕容元是慕容宝的儿子
又以刘忠为左将军，张豪为后将军，并赐姓慕容氏	又任命刘忠为左将军，张豪为后将军，并赐他们姓慕容
李旱为中常侍、辅国将军，卫双为前将军，张顺为镇西将军、昌黎尹，张真为右将军；皆封公	任命李旱为中常侍、辅国将军，卫双为前将军，张顺为镇西将军、昌黎尹，张真为古将军，并都封为公爵
宁朔将军邓启方、南阳太守闾丘羡将兵二万击南燕，与南燕中军将军法、抚军将军和战于管城，启方等兵败，单骑走免	东晋宁朔将军对启方、南阳太守闾丘羡，带领部队二万人进攻南燕，同南燕中军将军慕容法、抚军将军慕容和在管城交战，邓启方等人的部队失败，他单人匹马逃走，免于一死
魏王命有司正封畿，标道里，平权衡，审度量；遣使循行郡国，举奏守宰不法者，亲考察黜陟之	魏王拓跋命令有关部门确定京师的区划，标明道路的名称和里程，统一重量衡器的标准，审定长度的计量，派遣特使到各个郡国去巡回视察、监督，检举弹劾违法乱纪的地方官吏，以便拓跋亲自考察定罪处理
九月，辛卯，加会稽王道子黄钺，以世子元显为征讨都督；遣卫将军王、右将军谢琰将兵讨王恭，谯王尚之将兵讨庾楷	九月，辛卯，东晋朝廷授予会稽王司马道子黄钺，任命会稽王长子司马元显为征讨都督，又派遣卫将军王、右将军谢琰带兵讨伐王恭，派遣谯王司马尚之带兵讨伐庾楷
张骧子超收合三千余家据南皮，自号乌桓王，抄掠诸郡	原后燕国辅国将军张骧的儿子张超，收留集合了三千多户人家占据南皮，自己号称为乌桓王，抢劫掠夺附近各郡
魏王命庾岳讨之	魏王拓跋命令庾岳去讨伐他
西秦王乾归遣秦州牧益州、武卫将军慕兀、冠军将军翟帅骑二万伐吐谷浑	西秦王乞伏乾归派遣秦州牧乞伏益州、武卫将军慕兀、冠军将军翟率领骑兵二万人去讨伐吐谷浑
大赦	东晋实行大赦
凉建武将军李鸾以兴城降于秃发乌孤	后凉国建武将军李鸾，献出兴城，向秃发乌孤投降
十一月，以琅邪王德文为卫将军、开府仪同三司，征虏将军元显为中领军，领军将军王雅为尚书左仆射	十一月，东晋任命琅邪王司马德文为卫将军、开府仪同三司，征虏将军司马元显为中领军，领军将军王雅为尚书左仆射
杨轨、王乞基帅户数千自归于西平王乌孤	杨轨、王乞基率几千户居民，主动归附了西平王秃发乌孤
己亥，燕幽州刺史慕容豪、尚书左仆射张通、昌黎尹张顺坐谋反诛	己亥，后燕幽州刺史慕容豪、尚书左仆射张通、昌黎尹张顺，以谋反罪被处死
西平王秃发乌孤更称武威王	南凉西平王秃发乌孤改称武威王
春，正月，辛酉，大赦	春季，正月，辛酉，东晋实行大赦
庚午，魏主北巡，分命大将军常山王遵等三军从东道出长川，镇北将军高凉王乐真等七军从西道出牛川，自将大军从中道出髯水以袭高车	庚午，北魏国主拓跋去北方巡视，分别命令大将军常山王拓跋遵等三支军队从东路向长川进发，镇北将军高凉王拓跋乐真等七支军队从西路向牛川进发，拓跋则自己带领大军从中路在髯水出发，准备袭击高车部落
壬午，燕右将军张真、城门校尉和翰坐谋反，诛	壬午，后燕右将军张真、城门校尉和翰因谋反罪被杀
癸未，燕大赦，改元长乐	癸未，后燕大赦，改年号为长乐
燕主盛每十日一自决狱，不加拷掠，多得其情	后燕国主慕容盛每隔十天，亲自审理判决一次讼事，虽然并不加以严刑拷打，但也能获得很多真实情况
二月，丁亥朔，魏军大破高车三十余部，获七万余口，马三十余万匹，牛羊百四十余万头	二月，丁亥朔，北魏北征的军队将高车的三十多个部落打得大败，俘虏七万多人，缴获马三十多万匹，牛羊一百四十多万头
卫王仪别将三万骑绝漠千余里，破其七部，获二万余口，马五万余匹，牛羊二万余头	卫王拓跋仪另外带领三万骑兵，深入沙漠一千多里，攻破了高车的七个余部，俘虏二万多人，缴获马五万多匹，牛羊二万多头
高车诸部大震	高车的各个部落非常震惊、恐慌
庚戌，魏征虏将军庾岳破张超于勃海，斩之	庚戌，北魏征虏将军庾岳在勃海攻破了张超率领的变民部队，并把张超斩首
初，秦王登之弟广帅众三千依南燕王德，德以为冠军将军，处之乞活堡	当初，前秦王苻登的弟弟苻广率兵众三千人投顺了南燕王慕容德，慕容德任命他为冠军将军，安置在乞活堡
会荧惑守东井，或言秦当复兴，广乃自称秦王，击南燕北地王钟，破之	正赶上火星侵入井宿，有人说这种星象表示前秦应当复兴，苻广于是自称秦王，进攻南燕北地王慕容钟，并将他打败
是时，滑台孤弱，土无十城，众不过一万，钟既败，附德者多去德而附广	这时，南燕慕容德驻地的滑台势单力薄，所辖治的地方不到十个城池，军队也不过一万人，慕容钟失败之后，依附慕容德的人大都离开了慕容德而依附苻广
德乃留鲁阳王和守滑台，自帅众讨之，斩之	慕容德留下鲁阳王慕容和驻守滑台，亲自统帅兵众去讨伐苻广，并把他斩了
丙子，魏主遣建义将军庾真、越骑校尉奚斤击库狄、宥连、侯莫陈三部，皆破之，追奔至大峨谷，置戍而还	丙子，北魏国主拓跋派遣建义将军庾真、越骑校尉奚斤率兵袭击库狄、宥连、侯莫陈三个部落，并且把它们全部击破，追击奔袭到大峨谷，在那里安置了守卫部队之后才返回
己卯，追尊帝所生母陈夫人为德皇太后	己卯，安帝追尊他的亲生母亲陈夫人为德皇太后
夏，四月，鲜卑叠掘河内帅户五千降于西秦	夏季，四月，鲜卑族叠掘部落的首领河内率他所辖属的五千户居民，向西秦投降
西秦王乾归以河内为叠掘都统，以宗女妻之	西秦王乞伏乾归任命河内为叠掘都统，并把自己宗族的一个女儿嫁给他做妻子
甲午，燕大赦	甲午，后燕实行大赦
燕散骑常侍馀超、左将军高和等坐谋反，诛	后燕散骑常侍馀超、左将军高和等人，以谋反罪被杀
凉太子绍、太原公纂将兵伐北凉，北凉王业求救于武威王乌孤，乌孤遣骠骑大将军利鹿孤及杨轨救之	后凉太子吕绍、太原公吕纂率军讨伐北凉，北凉王段业向南凉武威王秃发乌孤求救，秃发乌孤派遣骠骑大将军秃发利鹿孤，与杨轨一起前去救援
业将战，沮渠蒙逊谏曰：杨轨恃鲜卑之强，有窥窬之志，绍、纂深入，置兵死地，不可敌也	段业准备迎战，沮渠蒙逊劝阻他说：杨轨这个人依仗着鲜卑人的强大，有对我趁机动手的野心，吕绍、吕纂此次敢于率军深入，已经把军队置之死地，我们抵挡不过
今不战则有泰山之安，战则有累卵之危	现在我们不出战，还有像泰山那样的安稳，出战，就会有累卵之危
业从之，按兵不战	段业听从了他的劝告，按兵不动
绍、纂引兵归	吕绍、吕纂只好带着大军回去
魏前河间太守卢溥帅其部曲数千家就食渔阳，遂据有数郡	北魏前河间太守范阳人卢溥统率他手下的人几千家到渔阳谋生，于是占据了几个郡的土地
秋，七月，己未，燕主盛遣使拜溥幽州刺史	秋季，七月，己未，后燕国主慕容盛派遣使节任命卢溥为幽州刺史
辛酉，燕主盛下诏曰：法例律，公侯有罪，得以金帛赎，此不足以惩恶而利于王府，甚无谓也	辛酉，后燕国主慕容盛下诏书说：法令判例规定，公、侯如果犯了罪，可以用金钱、布帛来赎罪，这不能达到惩罚罪恶的目的，却有利于王府，因此，毫无意义
自今皆令立功以自赎，勿复输金帛	从今往后，犯罪的人必须立功才能赎清自己的罪责，不得再收取金钱、布帛
西秦丞相南川宣公出连乞都卒	西秦丞相、南川宣公出连乞都去世
初，魏奋武将军张衮以才谋为魏主所信重，委以腹心	当初，北魏奋武将军张衮因为才干出众、谋略过人而得到北魏国主拓跋的信任与重用，把他当做心腹
问中州士人于衮，衮荐卢溥及崔逞，皆用之	拓跋向张衮询问中州的读书人谁比较有名，张衮荐举了卢溥和崔逞，拓跋都加以任用
燕李旱行至建安，燕主盛急召之，君臣莫测其故	后燕辅国将军李旱，讨伐李朗行进到建安，后燕国主慕容盛把他紧急召回，大臣们都不知道是什么缘故
九月，辛未，复遣之	九月，辛未，又派他出征
李朗闻其家被诛，拥二千余户以自固；及闻旱还，谓有内变，不复设备，留其子养守令支，自迎魏师于北平	李朗听说他的家眷全部被杀害，便集结二千多户居民，用以固守自己的城池，等到听说李旱突然回去，认为后燕国内部一定出现变化，所以不再设防，只是留下他的儿子李养据守令支，自己却去北平迎接北魏军
壬子，旱袭令支，克之，遣广威将军孟广平追及朗于无终，斩之	壬子，李旱袭击并攻破了令支，马上又派广威将军孟广平去追击李朗，在无终追上并把他杀了
魏主以穆崇为豫州刺史，镇野王	北魏国主拓跋任命穆崇为豫州刺史，镇守野王
西秦以金城太守辛静为右丞相	西秦任命金城太守辛静为右丞相
十二月，甲午，燕燕郡太守高湖帅户三千降魏	十二月，甲午，后燕燕郡太守高湖率部属三千多户居民投降北魏
湖，泰之子也	高湖是高泰的儿子
丙午，燕主盛封弟渊为章武公，虔为博陵公，子定为辽西公	丙午，后燕国主慕容盛封他的弟弟慕容渊为章武公，慕容虔为博陵公，封他的儿子慕容定为辽西公
丁未，燕太后段氏卒，谥曰惠德皇后	丁未，后燕皇太后段氏去世，谥号叫惠德皇后
是岁，燕主盛以河间公熙为都督中外诸军事、尚书左仆射，领中领军	这一年，后燕国主慕容盛任命河间公慕容熙为都督中外诸军事、尚书左仆射，兼中领军
春，正月，壬子朔，燕主盛大赦，自贬号为庶人天王	春季，正月，壬子朔，后燕国主慕容盛实行大赦，并贬低了自己的名号，称为庶人天王
乙亥，大赦	乙亥，东晋实行大赦
西秦王乾归迁都苑川	西秦王乞伏乾归把都城迁到苑川
秃发利鹿孤大赦，改元建和	秃发利鹿孤实行大赦，改年号为建和
高句丽王安事燕礼慢；二月，丙申，燕王盛自将兵三万袭之，以骠骑大将军熙为前锋，拔新城、南苏二城，开境七百余里，徙五千馀户而还	高句丽王高安对待后燕的礼数有些怠慢，二月，丙申，后燕国主慕容盛亲自带领三万兵马前去袭击，任命骠骑大将军慕容熙为前锋，攻克新城、南苏两座城池，扩大疆界七百多里，迁移裹胁五千多户居民之后回师
熙勇冠诸将，盛曰：叔父雄果，有世祖之风，但弘略不如耳	慕容熙的勇猛骠悍超出众将领，慕容盛说：叔父英雄果决，真有世祖的风度，不过在宏图大略方面稍逊一筹
桓玄既克荆、雍，表求领荆、江二州	桓玄攻克了荆州、雍州之后，向朝廷上疏请求管辖江、荆二州
诏以玄为都督荆・司・雍・秦・梁・益・宁七州诸军事、荆州刺史，以中护军桓为江州刺史	安帝下诏，任命桓玄为都督荆、司、雍、秦、梁、益、宁七州诸军事，荆州刺史；任命中护军桓为江州刺史
玄上疏固求江州；于是进玄督八州及扬・豫八郡诸军事，复领江州刺史	桓玄再次上疏，坚持要兼管江州，于是朝廷提升桓玄督八州及扬、豫等八郡诸军事，再兼江州刺史
玄辄以兄伟为雍州刺史，朝廷不能违	桓玄便擅自任命他的哥哥桓伟为雍州刺史，朝廷不敢拒绝
又以从子振为淮南太守	他又任命自己的侄儿桓振为淮南太守
辛卯，燕襄平令段登等谋反，诛	辛卯，后燕襄平令段登等人谋反被杀
丙寅，东晋卫将军、东亭献侯王去世	己巳，魏主东如涿鹿，西如马邑，观源
秦征西大将军陇西公硕德将兵五千伐西秦，入自南安峡	后秦征西大将军陇西公姚硕德带领五千人讨伐西秦，从南安峡攻入对方国界
西秦王乾归帅诸将拒之，军于陇西	西秦王乞伏乾归率诸将抵抗，驻扎在陇西
杨轨、田玄明谋杀武威王利鹿孤，利鹿孤杀之	杨轨、田玄明等人阴谋杀害南凉武威王秃发利鹿孤，被秃发利鹿孤处死
六月，庚辰朔，日有食之	六月，庚辰朔，出现日食
以琅邪王师何澄为尚书左仆射	东晋任命琅邪王师何澄为尚书左仆射
澄，准之子也	何澄是何准的儿子
甲子，燕大赦	甲子，后燕实行大赦
秋，七月，壬子，太太皇后李氏崩	秋季，七月，壬子，东晋太皇太后李氏驾崩
丁卯，大赦	丁卯，东晋实行大赦
丁亥，尚书右仆射王雅卒	丁亥，东晋尚书左仆射王雅去世
九月，癸丑，地震	九月，癸丑东晋发生地震
冬，十一月，高雅之与孙恩战于馀姚，雅之败，走山阴，死者什七、八	冬季，十一月，东晋宁朔将军高雅之与孙恩在余姚交战，高雅之大败，向山阴逃跑，战死的兵卒有十分之七八
诏以刘牢之都督会稽等五郡，帅众击恩，恩走入海	朝廷下诏，任命刘牢之都督会稽等五个郡，统帅兵众攻击孙恩，孙恩被迫逃回大海
牢之东屯上虞，使刘裕戍句章	刘牢之向东在上虞驻扎，派遣刘裕去戍守句章
吴国内史袁崧筑沪渎垒以备恩	吴国内史袁山松修筑沪渎垒，用来防备孙恩的袭击
崧，乔之孙也	袁山松是袁乔的孙子
会稽世子元显求领徐州，诏以元显为开府仪同三司、都督扬・豫・徐・兖・青・幽・冀・并・荆・江・司・雍・梁・益・交・广十六州诸军事、领徐州刺史，封其子彦玮为东海王	会稽王嫡长子司马元显请求兼管徐州，朝廷下诏任命司马元显为开府仪同三司，都督扬、豫、徐、兖、青、幽、冀、并、荆、江、司、雍、梁、益、交、广十六州诸军事，领徐州刺史，封他的儿子司马彦璋为东海王
乞伏乾归至长安，秦王兴以为都督河南诸军事、河州剌史、归义侯	乞伏乾归来到长安，后秦王姚兴让他担任都督河南诸军事、河州刺史，封为归义侯
秦王兴遣晋将刘嵩等二百余人来归	后秦王姚兴，把被他俘虏的东晋将领刘嵩等二百多人遣送回东晋
北凉晋昌太守唐瑶叛，移檄六郡，推李为冠军大将军、沙州剌史、凉公、领敦煌太守	北凉晋昌太守唐瑶叛变，并向其他六郡送去檄文，推举镇西将军李为冠军大将军、沙州刺史、凉公，兼任敦煌太守
赦其境内，改元庚子	李在他所管辖的范围内实行大赦，改年号为庚子
以瑶为征东将军，郭谦为军谘祭酒，索仙为左长史，张邈为右长史，尹建兴为左司马，张体顺为右司马	任命唐瑶为征东将军，郭谦为军咨祭酒，索仙为左长史，张邈为右长史，尹建兴为左司马，张体顺为右司马
遣从事中郎宋繇东伐凉兴，并击玉门已西诸城，皆下之	派遣从事中郎宋繇向东讨伐凉兴，并向玉门以西地区的那些城池发动进攻，宋繇把这些城池全部攻克
十二月，戊寅，有星孛于天津	十二月，戊寅，有异星出现在天津星旁
会稽世子元显以星变解录尚书事，复加尚书令	会稽王嫡长子司马元显，因为天象变化，被解除了录尚书事的官职，但是又加授了尚书令
吏部尚书车胤以元显骄恣，白会稽王道子，请禁抑之	吏部尚书车胤因为司马元显过于骄横放纵，晋见会稽王司马道子，请求加以制约
元显闻而未察，以问道子曰：车武子屏人言及何事	司马元显听说，但又不大清楚，便向司马道子说：车武子把旁边的人都打发开，说的是什么事
道子弗答	司马道子没有回答
固问之，道子怒曰：尔欲幽我，不令我与朝士语邪	司马元显坚持要问出个究竟，司马道子大怒地说：你打算把我幽禁起来，不让我与朝中的官员们说话吗
元显出，谓其徒曰：车胤间我父子	司马元显出来，对他的部下说：车胤离间我们父子间的关系
密遣人责之	于是，暗中派人去斥责车胤
胤惧，自杀	车胤非常害怕，自杀身亡
壬辰，燕主盛立燕台，统诸部杂夷	壬辰，后燕国主慕容盛设立燕台，统领夷族各个部落
丁酉，燕王盛尊献庄后丁氏为皇太后；立辽西公定为皇太子；太赦	丁酉，后燕国主慕容盛尊自己的母亲献庄皇后丁氏为皇太后，册立自己的儿子辽西公慕容定为皇太子，实行大赦
二月，丙子，孙恩出浃口，攻句章，不能拔	二月，丙子，孙恩又从浃口返回陆地，进攻句章，没有攻克
刘牢之击之，恩复走入海	刘牢之率兵向他发起进攻，孙恩再一次逃进大海的岛中
秦王兴使乞伏乾归还镇苑川，尽以其故部众配之	后秦王姚兴派乞伏乾归回去镇守苑川，把他过去的老部下、军队，全部分配给他
凉王纂嗜酒好猎，太常杨颖谏曰：陛下应天受命，当以道守之	后凉王吕纂生性喜欢喝酒，爱好打猎，太常杨颖劝告他说：陛下顺应上天的意旨，接受了治理国家的重任，所以应当用符合正道的方式恪守自己的使命
今疆宇日蹙，崎岖二岭之间，陛下不兢兢夕惕以恢弘先业，而沉湎游畋，不以国家为事，臣窃危之	现在，我们国家的疆土面积一天比一天缩小，仅仅局限在坎坷不平的两道山岭中间，陛下不小心谨慎地早晚考虑，用什么办法恢复弘扬祖先的事业，反而却沉溺于游玩打猎，不把国家的事情当做一回事，依臣下的愚见，这样是很危险的呀
纂逊辞谢之，然犹不悛	吕纂非常谦恭地向他道歉，感谢他的提醒，但是却没能改过
三月，孙恩北趣海盐，刘裕随而拒之，筑城于海盐故治	三月，孙恩又回到大陆，向北逼近海盐
恩日来攻城，裕屡击破之，斩其将姚盛	刘裕紧追不放，与他抵抗，在海盐的旧城址上修筑阵地
城中兵少不敌，裕夜偃旗匿众，明晨开门，使羸疾数人登城	孙恩几乎每天都来对刘裕阵地发动进攻，但刘裕几次都把孙恩击败，斩杀了他的将领姚盛
贼遥问刘裕所在	城里的部队因为太少难以抵挡，刘裕当夜就把战旗全部放倒，把精锐部队埋伏起来，第二天早晨打开城门，让几个老弱残兵登上城墙，变民部队一看，远远地向他们打听刘裕到哪里去了
曰，夜已走矣	他们说：昨天夜里已经逃跑了
贼信之，争入城	那些变民部队的士卒相信了他们的话，争先恐后地进了城
裕奋击，大破之	刘裕突然向他们发动了猛攻，将变民部队打得大败
恩知城不可拔，乃进向沪渎，裕复弃城追之	孙恩知道不可能把这座城攻克，于是改向沪渎进军，刘裕便也放弃了这座城池，追击孙恩
河西王利鹿孤伐凉，与凉王隆战，大破之，徙二千余户而归	南凉河西王秃发利鹿孤讨伐后凉，与后凉王吕隆接战，将吕隆打得大败，强行迁移二千多户居民之后便回去了
夏，四月，辛卯，魏人罢邺行台，以所统六郡置相州，以庚岳为刺史	夏季，四月，辛卯，北魏朝廷撤销设置在邺城的行台，把原由行台所管辖的六郡建置相州，任命庾岳为相州刺史
乞伏乾归至苑川，以边芮为长史，王松寿为司马，公卿、将帅皆降为僚佐、偏裨	后秦归义侯乞伏乾归回到苑川，任命边芮为长史，王松寿为司马，原来的公卿、将帅都降为慕僚佐属、偏军牙将等小官
孙恩陷沪渎，杀吴国内史袁崧，死者四千人	孙恩的军队攻克了沪渎，杀了吴国内史袁崧，在这场战斗中死亡四千人
秦陇西公硕德自金城济河，直趣广武，河西王利鹿孤摄广武守军以避之	后秦陇西公姚硕德从金城附近渡过黄河，径直向广武逼近，南凉河西王秃发利鹿孤调动他在广武的守军撤退，避开了后秦国讨伐后凉国的军队
秦军至姑臧，凉王隆遣辅国大将军超、龙骧将军邈等逆战，硕德大破之，生禽邈，俘斩万计	后秦军队到达姑臧，后凉王吕隆派遣辅国大将军吕超、龙骧将军吕邈等和后秦军迎战，姚硕德把他们打得大败，活捉了吕邈，俘虏杀戮的后凉军卒数以万计
隆婴城固守，巴西公佗帅东苑之众二万五千降于秦	吕隆围绕着都城，指挥固守阵地
西凉公、河西王利鹿孤、沮渠蒙逊各遣使奉表入贡于秦	后凉巴西公吕佗率领着东苑的部队二万五千人向后秦投降，西凉公李、南凉河西王秃发利鹿孤、北凉张掖公沮渠蒙逊等都分别派遣使节捧着奏章，去向后秦纳贡
十一月，刘裕追孙恩至沪渎、海盐，又破之，俘斩以万数，恩遂自浃口远窜入海	十一月，东晋刘裕追击变民孙恩的部队，来到沪渎、海盐，又一次把他们打败，俘虏斩杀的人数以万计，孙恩于是只好从浃口远远地逃向大海
十二月，辛亥，魏主遣常山王遵、定陵公和跋帅众五万袭没弈干于高平	十二月，辛亥，北魏国主拓跋派遣常山王拓跋遵、定陵公和跋，率领军卒五万人，在高平进攻后秦车骑将军没弈干
秃发檀克显美，执孟而责之，以其不早降	南凉车骑将军秃发檀攻克显美，抓住后凉国昌松郡守孟，对他大加斥责，因为他迟迟不降
曰：受吕氏厚恩，	孟说：我孟接受吕氏的厚诚恩戴，承蒙他分授给我虎符，让我镇守一方疆土，如果
癸丑，魏常山王遵等至高平，没弈干弃其部众，帅数千骑与刘勃勃奔秦州	癸丑，北魏常山王拓跋遵等率领袭击没弈干的部队，抵达高平，没弈干放弃他的所有部众，率数千名骑兵，跟刘勃勃一起逃奔秦州
魏军追至瓦亭，不及而还，尽获其府库蓄积，马四万馀匹，杂畜九万馀口，徙其民于代都，馀种分迸	北魏国的部队追赶到瓦亭，没有追上便回去了，把没弈干的仓库中所有的物资积蓄，全部收缴，并掠获了马匹四万多匹，其他各种牲畜九万多头，又把没弈干所属辖的百姓迁到代都去居住，剩下的为数不多的那个种族的人，也都分崩离析
平阳太守贰尘复侵秦河东，长安大震，关中诸城昼闭，秦人简兵训卒以谋伐魏	北魏平阳太守贰尘，再次侵犯后秦国河东郡，使后秦都城长安受到很大震动，函谷关以西关中地区的各个城池，在白天也都紧闭城门，后秦人选择武器，训练士卒，以此图谋征伐北魏
秦王兴立子泓为太子，大赦	后秦王姚兴立子姚泓为太子，实行大赦
泓孝友宽和，喜文学，善谈咏，而懦弱多病，兴欲以为嗣，而狐疑不决，久乃立之	姚泓为人孝顺友善，谦和宽厚，喜欢文学，擅长清谈歌咏，但是性格懦弱，身体一直多病，姚兴打算让他做自己的继承人，但又因此迟疑不决，拖了很长时间，才最后决定立他为太子
姑臧大饥，米斗直钱五千，人相食，饿死者十余万口	后凉都城姑臧发生严重的饥荒，一斗米价值五千钱，出现了人吃人的现象，被饿死的人达到了十多万口
城门昼闭，樵采路绝，民请出城为胡虏奴婢者，日有数百，吕隆恶其沮动众心，尽坑之，积尸盈路	城门白天紧紧关闭，人们出城砍柴的道路也被断绝，百姓中请求出城做胡人奴隶、婢女的人，每天都有几百人，吕隆讨厌他们这样扰乱人心，所以，把他们全部活埋在大坑之中，积攒起来的尸体堆满道路
桓玄发江陵，虑事不捷，常为西还之计，及过寻阳，不见官军，意甚喜，将士之气亦振	东晋荆州刺史桓玄，从江陵出发，担心这次大规模军事行劝不能取胜，因此，常常怀着向西回军的打算，等到过了寻阳，还是看不见朝廷的部队，心中非常高兴，其他将士的斗志和士气也振作、旺盛起来
大赦，改元大亨	东晋实行大赦，改年号为大亨
甲戌，燕大赦	甲戌，后燕实行大赦
夏，四月，太尉玄出屯姑孰，辞录尚书事，诏许之；而大政皆就谘焉，小事则决于尚书令桓谦及卞范之	夏季，四月，太尉桓玄出都城建康，去姑孰驻扎，辞去了录尚书事的官职，安帝下诏同意，但是凡是大政方针，却都还要去他那里请示，其他小事就由尚书令桓谦和卞范之决定
高句丽攻宿军，燕平州刺史慕容归弃城走	高句丽对宿军城发动进攻，后燕国平州刺史慕容归放弃城池逃走
八月，太尉玄讽朝廷以玄平元显功封豫章公，平殷、杨功封桂阳公，并本封南郡如故	八月，太尉桓玄婉转地暗示朝廷根据桓玄平定司马元显的功劳，封他为豫章公，又根据他平定殷仲堪、杨期的功劳，而封他为桂阳公，并且还像原来那样，保持他原来受封的南郡公的爵位
玄以豫章封其子升，桂阳封其兄子俊	桓玄把豫章公封给了他的儿子桓升，把桂阳公封给了他的侄儿桓俊
秦徙河西豪右万余户于长安	后秦把河西的豪门大户等一万多户迁移到都城长安居住
南凉王檀攻吕隆于姑臧	南凉王秃发檀进攻据守姑臧的吕隆
魏以庾岳为司空	北魏任命庾岳为司空
十二月，辛亥，魏主还云中	十二月，辛亥，北魏国主拓跋回到云中
袁虔之等至长安，秦王兴问曰：桓玄才略何如其父	袁虔之等人到达长安，后秦王姚兴问道：桓玄的才能谋略与他的父亲桓温相比，怎么样
卒能成功乎	最后能不能成就大的功业
虔之曰：玄乘晋室衰乱，盗据宰衡，猜忌安忍，刑赏不公，以臣观之，不如其父远矣	袁虔之说：桓玄乘晋室衰微动乱之机，窃取占据了可以操纵大局的宰相高位，为人多疑猜忌，刻薄残忍，刑罚赏赐又极不公平，根据我的观察，远不如他父亲
玄今已执大柄，其势必将篡逆，正可为他人驱除耳	桓玄现在已经掌据了朝中的大权，看他的趋势是一定要篡夺政权，叛逆晋朝的，这样，正可以为别的人起来驱逐铲除他提供口实
兴善之，以虔之为广州刺史	姚兴觉得这番话很有道理，任命袁虔之为广州刺史
西凉公自称大将军、大都督、领秦・凉二州牧，大赦，改元建初，遣舍人黄始梁兴间行奉表诣建康	西凉公李自己号称大将军、大都督并兼秦、凉二州牧，下令实行大赦，改年号为建初，派遣舍人黄始、梁兴携带奏章，抄小路去建康诣见东晋朝廷
二月，丁巳，留台备法驾迎帝于江陵，刘毅、刘道规留屯夏口，何无忌奉帝东还	二月，丁巳，东晋留台准备皇帝专用的车驾仪仗，去江陵迎接安帝，刘毅、刘道规留在夏口驻扎，何无忌陪同护卫安帝东下还都
初，毛璩闻桓振陷江陵，帅众三万顺流东下，将讨之，使其弟西夷校尉瑾、蜀郡太守瑗出外水，参军巴西谯纵、侯晖出涪水	当初，毛璩听说桓振攻陷了江陵，便率领三万人的部队顺长江向东进发，准备讨伐他，派遣他的弟弟西夷校尉毛瑾、蜀郡太守毛瑷从外水出发，参军巴西人谯纵、侯晖从涪水出发
蜀人不乐远征，晖至五城水口，与巴西阳昧谋作乱	蜀地的人不喜欢到远方征战，侯晖到了五城水口，与巴西人阳昧谋划发动叛乱
纵为人和谨，蜀人爱之，晖、昧共逼纵为主	谯纵为人谦和谨慎，蜀地的人都很拥戴他，侯晖、阳昧一起逼迫谯纵为盟主
纵不可，走投于水；引出，以兵逼纵登舆	谯纵严辞拒绝，纵身投江，被叛军救了上来
纵又投地，叩头固辞，晖缚纵于舆	他们又用兵刃逼迫谯纵登上车轿，谯纵又扑倒在地，向大家磕头，坚决拒绝，侯晖把谯纵绑在车上，回军，在涪城袭击毛瑾，并把他杀了，拥推谯纵为凉、秦二州刺史
还，袭毛瑾於涪城，杀之，推纵为梁、秦二州刺史	毛璩来到略城，听说军中发生叛乱，飞马回成都，派遣参军王琼带兵前去讨伐，被谯纵的弟弟谯明子打败，被杀死者十有八九
璩至略城，闻变，奔还成都，遣参军王琼将兵讨之，为纵弟明子所败，死者什八九	益州营户李腾打开城门迎入谯纵的军队，杀了毛璩和他的弟弟毛瑷，屠灭了他们全家
益州营户李腾开城纳纵兵，杀璩及弟瑗，灭其家	谯纵号称成都王，任命堂弟谯洪为益州刺史，任命谯明子为巴州刺史，驻守白帝
称成都王，以从弟洪为益州刺史，以明子为巴州刺史，屯白帝	从此，蜀地局势大乱，汉中的实力也十分空虚
于是蜀大乱，汉中空虚，氐王杨盛遣其兄子平南将军抚据之	氐王杨盛派遣他的侄儿平南将军杨抚占据了那里
癸亥，魏主还自豺山，罢尚书三十六曹	癸亥，北魏国主拓跋从豺山回京，撤销了尚书三十六曹等官署
五月，桂阳太守章武王秀及益州刺吏司马轨之谋反，伏诛	五月，东晋桂阳太守、章武王司马秀和益州刺史司马轨之阴谋反叛，被杀
秀妻，桓振之妹也，故自疑而反	司马秀的妻子是桓振的妹妹，所以他自己疑心受到牵连，索性反叛
桓玄余党桓亮、苻宏等拥众寇乱郡县者以十数，刘毅、刘道规、檀祗等分兵讨灭之，荆、湘、江、豫皆平	桓玄的余党桓亮、苻宏等人，裹胁着百姓，几十次侵扰为祸地方郡县，刘毅、刘道规、檀祗等人分别带兵将他们剿灭，荆、湘、江、豫等几个地方的局势全部得到平安
诏以毅为都督淮南等五郡军事、豫州刺史，何无忌为都督江东五郡军事、会稽内史	朝廷下诏，任命刘毅为都督淮南等五郡军事、豫州刺史，任命何无忌为都督江东五郡军事、会稽内史
北青州刺史刘该反，引魏为援，清河、阳平二郡太守孙全聚众应之	东晋北青州刺史刘该叛变，勾结北魏为外援，清河、阳平两个郡的太守孙全拉起队伍响应他
六月，魏豫州刺史索度真、大将斛斯兰寇徐州，围彭城	六月，北魏豫州刺史索度真、大将斛斯兰进犯徐州，围攻彭城
刘裕遣其弟南彭城内史道怜、东海太守孟龙符将兵救之，斩该及全，魏兵败走	刘裕派遣他的弟弟南彭城内史刘道怜、东海太守孟龙符带兵前去救援，斩杀了刘该和孙全，北魏军失败而退走
龙符，怀玉之弟也	孟龙符是孟怀玉的弟弟
刘裕遣使求和于秦，且求南乡等诸郡，秦王兴许之	刘裕派遣使节向后秦求和，并要求归还南乡等几个郡，后秦王姚兴答应了他
君臣咸以为不可，兴曰：天下之善一也	姚兴的大臣们都觉得这样不行，姚兴说：天底下的善行都是一样的
刘裕拔起细微，能诛讨桓玄，兴复晋室，内厘庶政，外修封疆，吾何惜数郡，不以成其美乎	刘裕从社会底层最卑贱的地位上发展起来，能够诛杀桓玄，重新振兴晋室，对内整顿日常政务，对外核查勘定封地疆土，我怎么能为了珍惜几个郡，便因此不成全他的好事呢
遂割南乡、顺阳、新野、舞阴等十二郡归于晋	于是割让南乡、顺阳、新野、舞阴等十二个郡，归还给东晋
魏咏之卒，江陵令罗谋举兵袭江陵，奉王慧龙为主	东晋魏咏之去世，江陵令罗阴谋发动兵变袭击江陵，拥奉王慧龙为盟主
刘裕以并州刺史刘道规为都督荆・宁等六州诸军事、荆州刺史	刘裕任命并州刺史刘道规为都督荆、宁等六州诸军事及荆州刺史
不果发，奉慧龙奔秦	罗来不及发动叛乱，只好随同王慧龙逃往后秦
乞伏乾归伐仇池，为杨盛所败	后秦归义侯乞伏乾归征伐仇池，被杨盛打败
十二月，燕王熙袭契丹	十二月，后燕王慕容熙进攻契丹
春，正月，甲申，魏主如豺山宫	春季，正月，甲申，北魏国主拓跋来到豺山宫
诸州置三刺史，郡置三太守，县置三令长；刺史、令长各之州县	并下令，每个州设置三个刺史，每个郡设置三个太守，每个县设置三个令长
太守虽置而未临民、功臣为州者皆征还京师，以爵归第	其中，刺史、令长等各去到所在州县上任，太守虽然设置了却并不上任，有功之臣管辖州所的，都被征召回京师，保持原有的爵位，回家
益州刺史司马荣期击谯明子于白帝，破之	东晋益州刺史司马荣期，在白帝进攻西蜀政权的谯明子，将他打败
柔然社仑侵魏边	柔然可汗郁久闾社仑，侵犯北魏边境
五月，燕主宝之子博陵公虔、上党公昭，皆以嫌疑赐死	五月，后燕国主慕容宝的儿子博陵公慕容虔、上党公慕容昭，都因为嫌疑而被逼自杀
秋，七月，魏太尉宜都丁公穆崇薨	秋季，七月，北魏太尉、宜都丁公穆崇去世
尚书论建义功，奏封刘裕豫章郡公，刘毅南平郡公，何无忌安成郡公，自馀封赏有差	东晋尚书评定勤王举义的功劳，秦请封刘裕为豫章郡公，刘毅为南平郡公，何无忌为安成郡公，其余的人加封赏赐高低、多少不等
梁州刺史刘稚反，刘毅遣将讨禽之	东晋梁州刺史刘稚叛变，刘毅派遣将领前去讨伐，并把他抓获
庚申，魏主还平城	庚申，北魏国主拓跋回到平城
乙亥，以左将军孔安国为尚书左仆射	乙亥，东晋任命左将军孔安国为尚书左仆射
十一月，秃发檀迁于姑臧	十一月，南凉国秃发檀把都城迁到姑臧
乞伏乾归入朝于秦	后秦归义侯乞伏乾归到长安去朝见后秦王姚兴
十二月，以何无忌为都督荆・江・豫三州八郡军事、江州刺史	十二月，东晋任命何无忌为都督荆、江、豫三州八郡军事，江州刺史
春，正月，辛丑朔，燕大赦，改元建始	春季，正月，辛丑朔，后燕实行大赦，改年号为建始
秦王兴以乞伏乾归寝强难制，留为主客尚书，以其世子炽磐行西夷校尉，监其部众	后秦王姚兴认为乞伏乾归的势力逐渐强大，难以控制，便把他留在都城长安，任命他做主客尚书，任命他的嫡长子乞伏炽磐代理西夷校尉的职务，监管他的部众
魏主立其子为河间王，处文为长乐王，连为广平王，黎为京兆王	北魏国主拓跋册立他的儿子拓跋为河间王，拓跋处文为长乐王，拓跋连为广平王，拓跋黎为京兆王
燕王熙为其后苻氏起承华殿，负土于北门，土与谷同价	后燕王慕容熙为他的皇后苻氏兴建承华殿，从北门外把土运来，使土的价格上涨到与粮食的价格一样
宿军典军杜静载棺诣阙极谏，熙斩之	宿军典军杜静带着棺木来到皇宫门外拜见后燕王，极力劝阻，慕容熙把他杀了
魏主北巡至濡源	北魏国主拓跋向北巡视，抵达濡源
魏常山王遵以罪赐死	北魏常山王拓跋遵因为犯罪，被勒令自杀
秦王兴以太子泓录尚书事	后秦王姚兴命太子姚泓录尚书事
秋，七月，戊戌朔，日有食之	秋季，七月，戊戌朔，出现日食
汝南王遵之坐事死	东晋汝南王司马遵之，被指控犯法，处死
遵之，亮之五世孙也	司马遵之是司马亮的五世孙
魏主自濡源西如参合陂，乃还平城	北魏国主拓跋从濡源向西抵达参合陂之后，才回到平城
魏主如豺山宫	北魏国主拓跋来到豺山宫
侯官告：司空瘐岳，服饰鲜丽，行止风采	候官报告说：司空瘐岳，衣服装饰新鲜华美，行为举止、风度神采，都模仿君王
拟则人君收岳，杀之	拓跋把瘐岳抓起来，杀掉了
北燕王云以冯跋为都督中外诸军事、开府仪同三司、录尚书事，冯万泥为尚书令，冯素弗为昌黎尹，冯弘为征东大将，孙护为尚书左仆射，张兴为辅国大将军	北燕王高云任命冯跋为都督中外诸军事、开府仪同三司、录尚书事，任命冯万泥为尚书令，冯素弗为昌黎尹，冯弘为征东大将军，孙护为尚书左仆射，张兴为辅国大将军
弘，跋之弟也	冯弘是冯跋的弟弟
九月，谯纵称藩于秦	九月，谯纵向后秦请求归降，成为藩属国
秃发檀将五万余人伐沮渠蒙逊，蒙逊与战于均石，大破之	南凉王秃发檀带领五万多人讨伐北凉王沮渠蒙逊，沮渠蒙逊与他在均石展开激战，将他打得大败
蒙逊进攻西郡太守杨统于日勒，降之	沮渠蒙逊又在日勒进攻西郡太守杨统，迫使杨统投降
魏主还平城	北魏国主拓跋返回平城
十二月，戊子，武冈文恭侯王谧网	十二月，戊子，东晋扬州刺史、武冈文恭侯王谧去世
是岁，西凉公以前表未报，复遣沙门法泉间行奉表诣建康	这一年，西凉公李因为上次呈送给东晋的奏表没有得到答复，又再次派遣和尚法泉带奏章，抄小路前往建康，拜谒东晋朝廷
春，正月，甲辰，以琅邪王德文领司徒	春季，正月，甲辰，东晋任命琅邪王司马德文兼司徒职务
庚申，武陵忠敬王遵薨	庚申，东晋武陵忠敬王司马遵去世
魏主如豺山宫，遂至宁川	北魏国主拓跋来到豺山宫，又到宁川
南燕主超尊其母段氏为皇太后，妻呼延氏为皇后	南燕国主慕容超尊奉他的母亲段氏为皇太后，封他的妻子呼延氏为皇后
超祀南郊，有兽如鼠而赤，大如马，来至坛侧	慕容超到南郊祭祀上天，有一种野兽，样子像老鼠一样，红毛，像马一般大，来到祭坛的旁边
须臾，大风昼晦，羽仪帷幄皆毁裂	一会儿，狂风骤起，天色昏暗，王室仪仗的羽饰帘帐全部被吹毁
超惧，以问太史令成公绥，对曰：陛下信用奸佞，诛戮贤良，赋敛繁多，事役殷重之所致也	慕容超非常恐惧，问太史令成公绥这是怎么回事，成公绥回答说：这是陛下宠信重用奸佞的小人，诛杀屠戮俊贤良才，赋税繁重，过分劳役百姓所导致
超乃大赦，黜公孙五楼等，俄而复用之	慕容超于是下令大赦，罢免了公孙五楼等人，但不久又再次任用了他
北燕王云立妻李氏为皇后，子彭城为太子	北燕王高云册立他的妻子李氏为皇后，立他的儿子高彭城为太子
北燕大赦	北燕实行大赦
司马叔自蕃城寇邹山，鲁郡太守徐邕弃城走，车骑长史刘钟击却之	东晋叛将军司马叔从蕃城进犯邹山，鲁郡太守徐邕放弃城池逃走，车骑长史刘钟迎击，并把他打退
北燕王云封慕容归为辽东公，使主燕祀	北燕王高云封慕容归为辽东公，让他主管燕帝室宗庙的祭祀工作
乞伏炽磐以秦政浸衰，且畏秦之攻袭，冬，十月，招结诸部二万余人筑城于山而据之	后秦河州刺史乞伏炽磐，认为后秦的政权越来越衰退，而且又害怕后秦前来进攻，冬季，十月，征召集结各部落的二万多人在山修城池进行据守
南燕汝水竭，河冻皆合，而渑水不冰	南燕汝水枯竭
南燕主超恶之，问于李宣，对曰：渑水无冰，良由逼带京城，近日月也	所有的河水全部结冻、冰封，而只有渑水没有结冰，南燕国主慕容超心里对此非常忌讳，向李宣询问这是怎么回事，李宣回答说：渑水没有冻冰，主要是因为它流经都城，跟日月靠得很近的缘故
超大悦，赐朝服一具	慕容超听后非常高兴，赐给李宣一套官服
十二月，乞伏炽磐攻彭奚念于罕，为奚念所败而还	十二月，后秦河州刺史乞伏炽磐在罕进攻叛将彭奚念，被彭奚念打败，撤回
是岁，魏主杀高邑公莫题	这一年，北魏国主拓跋诛杀高邑公莫题
初，拓跋窟咄之伐也，题以年少，潜以箭遗窟	当初，拓跋
辛卯，大赦	辛卯，东晋实行大赦
庚戌，以刘毅为卫将军、开府仪同三司	庚戌，东晋任命刘毅为卫将军、开府仪同三司
毅爱才好士，当世名流莫不辐凑，独扬州主簿吴郡张不往	刘毅爱好人才，喜欢读书人，所以，当时的知名人士几乎没有不聚集到他身边去的，惟独只有扬州主簿吴郡人张邵不去
或问之，曰：主公命世人杰，何烦多问	有人问他为什么，张邵说：我的主公刘裕是应运而生的人中豪杰，哪里还用多问
秦王兴遣使册拜谯纵为大都督、相国、蜀王，加九锡，承制封拜，悉如王者之仪	后秦王姚兴派遣使节前去册封谯纵为大都督、相国、蜀王，加授九锡，并可奉制书直接任命官员、封赏爵位，所用礼仪全部与君王一样
二月，南燕将慕容兴宗、斛谷提、公孙归等帅骑寇宿豫，拔之，大掠而去，简男女二千五百付太乐教之	二月，南燕将领慕容兴宗、斛谷提、公孙归等人率领骑兵进犯并攻克东晋的宿豫，大肆抢掠一番之后，便回去了，挑选俘虏的男女青年二千五百人，交付给管理王室音乐的机构，教习训练
归，五楼之兄也	公孙归是公孙五楼的哥哥
是时，五楼为侍中、尚书、领左卫将军，专总朝政，宗亲并居显要，王公内外无不惮之	这时，公孙五楼任侍中、尚书、领左卫将军，在朝中专权，总揽国家的一切政务，他的宗族亲属也都在朝廷官居显要位置，王公大臣、朝廷内外，对他没有不忌惮害怕的
南燕主超论宿豫之功，封斛谷提等并为郡、县公	南燕国主慕容超评定宿豫之战的功劳，封斛谷提等人为郡公、县公
桂林王镇谏曰：此数人者，勤民顿兵，为国结怨，何功而封	桂林王慕容镇劝阻说：这几个人，劳师动众，为国家结下仇怨，有什么功劳可封
超怒，不答	慕容超大怒，不予回答
尚书都令史王俨谄事五楼，比岁屡迁，官至左丞	尚书都令史王俨谄媚巴结公孙五楼，几年来屡次升迁，官职到了左丞
国人为之语曰：欲得侯，事五楼	所以当时百姓根据这些编了句歌谣：要想封侯，巴结五楼
超又遣公孙归等寇济南，俘男女千馀人而去	慕容超又派公孙归等侵犯济南，俘获了男女一千多人回去
自彭城以南，民皆堡聚以自固	因此，从彭城往南，东晋居民全都修筑城堡聚居一起，进行自卫
诏并州刺史刘道怜镇淮阴以备之	朝廷下诏，命并州刺史刘道怜镇守淮阴，用来戒备南燕骚扰
恒山崩	恒山出现山崩
夏，四月，乞伏乾归如罕，留世子炽磐镇之，收其众得二万，徙都度坚山	夏季，四月，后秦镇远将军乞伏乾归从苑川来到罕，留下嫡长子乞伏炽磐镇守那里，收集自己的部众共二万，把都城迁到度坚山
夏王勃勃率骑兵二万攻秦，掠取平凉杂胡七千余户，进屯依力川	夏王刘勃勃率领骑兵二万人进攻后秦，抢掠了平凉地区杂居的胡族七千多户，开进到依力川屯聚
乞伏乾归复即秦王位，大赦，改元更始，公卿以下皆复本位	后秦镇远将军乞伏乾归重新登上秦王之位，下令大赦，改年号为更始，公卿以下的官员，全部恢复以前的职位
慕容氏在魏者百馀家，谋逃去，魏主尽杀之	慕容氏家族，在北魏有一百多户，他们计划逃走，被北魏国主拓跋全部杀掉了
初，魏太尉穆崇与卫王仪伏甲谋弑魏主，不果；惜崇、仪之功，秘而不问	当初，北魏太尉穆崇与卫王拓跋仪，布下埋伏全副武装的兵士，阴谋刺杀北魏国主拓跋，没有成功
及有疾，杀大臣	拓跋惋惜穆崇、拓跋仪过去的赫赫战功，把此事压下，没有追查
仪自疑而出亡，追获之	到了拓跋有病之后，杀了许多大臣，拓跋仪担心自己难逃一死，逃亡外地，被追上抓获
八月，赐仪死	八月，命令拓跋仪自杀
封融诣刘裕降	南燕故臣、后来投奔北魏的封融，前去拜见刘裕，投降
十二月，乙巳，太白犯虚、危	十二月，乙巳，金星侵犯虚宿和危宿
南燕灵台令张光劝南燕主超出降，超手杀之	南燕灵台令张光劝南燕主慕容超出城投降，慕容超亲手把他杀了
柔然侵魏	柔然侵略北魏
魏长孙嵩将兵伐柔然	北魏长孙嵩领兵前去讨伐柔然
魏主嗣以群县豪右多为民患，悉以优诏征之	北魏国主拓跋嗣因为郡县之中的土豪劣绅大多数都是百姓的祸患，所以，便用措辞缓和的诏书征召他们全部来京
民恋土不乐内徙，长吏逼遣之，于是无赖少年逃亡相聚，所在寇盗群起	这些豪民留恋故土，不愿迁往都城，而郡县的官吏又逼迫他们前来，于是，有一些无赖的年轻人便逃出家乡聚在一起，因此，到处强盗、贼寇蜂起
嗣引八公议之曰：朕欲为民除蠹，而守宰不能绥抚，使之纷乱	拓跋嗣召见八公议论这件事说：我打算为民除害，但地方官吏却不能对他们平安抚慰，所以，反倒迫使他们纷纷起来叛乱
今犯者既众，不可尽诛，吾欲大赦以安之，何如	现在，犯法的人既然已经很多，又不能把他们全杀掉，因此，我想下令大赦，以此使他们安心，怎么样
元城侯屈曰：民逃亡为盗，不罪而赦之，是为上者反求于下也，不如诛其首恶，赦其馀党	元城侯拓跋屈说：百姓逃亡出去做了强盗，不治他们罪反而赦免，这是在上的人反过来求在下的人了，不如杀了他们为首作恶的，把那些党羽赦免
崔宏曰：圣王之御民，务在安之而已，不与之较胜负也	崔宏说：圣上统御人民，目的就是要让他们安定，不是要和他们比赛谁胜谁负
夫赦虽非正，可以行权	因此大赦虽然不是最好的办法，却可以通达权变
屈欲先诛后赦，要为两不能去，曷若一赦而遂定乎	拓跋屈打算先杀后赦，关键在于两个步骤缺一不可，哪里比得上大赦一次就把他们平定了呢
赦而不从，诛未晚也	大赦之后，如果有人不从，再杀也不晚哪
嗣从之	拓跋嗣接受他的意见
二月，癸未朔，遣将军于栗将骑一万讨不从命者，所向皆平	二月，癸未朔，派遣将军于栗带领骑兵一万人讨伐不听从大赦命令，仍然叛乱的人，所到之处，全部平定
南燕贺赖卢、公孙五楼为地道出击晋兵，不能却	南燕贺赖卢、公孙五楼挖了一条地道出来袭击东晋部队，却不能把他们击退
城久闭，城中男女病脚弱者太半，出降者相继	广固城门关闭太久，城中男女百姓患软脚病的人超过一半，因此出城投降的人一个接着一个
超辇而登城，尚书悦寿说超曰：今天助寇为虐，战士凋瘁，独守穷城，绝望外援，天时人事亦可知矣	慕容超乘辇车登上城墙，尚书悦寿劝说慕容超道：现在，上天帮助强盗制造罪恶，我们的将士疲惫凋零，单独困守这一座穷破的城池，外援已经毫无希望，天时和人心的倾向也是可以想见的
苟历数有终，尧、舜避位，陛下岂可不思变通之计乎	如果大数已尽，命该如此，那么，即使是尧、舜也都不能不退位，陛下怎么可以不想一下变通的办法呢
超叹曰：废兴，命也	慕容超叹息说：天下的兴起和覆亡，都是天命
吾宁奋剑而死，不能衔璧而生	我宁可高举利剑战斗而死，也决不能口里衔着璧玉投降求生
初，徐道覆闻刘裕北伐，劝卢循乘虚袭建康，循不从	当初，东晋始兴相徐道覆听说刘裕带兵向北征伐南燕，便劝说卢循乘东晋中空虚袭击建康，卢循没有听从
道覆自至番禺说循曰：本住岭外，忌以理极於此，传之子孙邪	徐道覆亲自来到番禺，向卢循游说道：我们住在这五岭以南的地区，难道你还以为是因为理该如此，并且可以把它传给子孙吗
正以刘裕难与为敌故也	我们正是因为刘裕力量强大，很难跟他为敌才这样的
今裕顿兵坚城之下，未有还期，我以此思归死击掩击何、刘之徒，如反掌耳	现在刘裕的大军集结在坚固的城池之下，什么时候回来还说不定，我们用手下这些希望回到故乡去的敢于拼命的士兵，突然进攻何无忌、刘毅这些小辈，不过就像把手掌翻过来罢了
不乘此机苟求一日之安，朝廷常以君为腹心之疾；若裕平齐之后，息甲岁馀，以玺书征君，裕自将屯豫章，遣诸将帅锐师过岭，虽复以将军之神武，恐必不能当也	不趁这个时机起事，而只是追求一天的平安，朝廷却一直把您当做心腹大患
今日之机，万不可失	如果刘裕平安三齐地区之后，让军队休息一二年，再先用诏书征召您进京，随后刘裕亲自在豫章屯兵，派遣几个将领率领部队翻过五岭，即使将军再有神机勇武，恐怕也一定不能抵挡了
若先克建康，倾其根蒂，裕虽南还，无能为也	今天这个机会，是万万不可错过的
君若不同，便当帅始兴之众直指寻阳	如果我们抢先攻克了建康，把他们的根基全部摧毁，刘裕即使回来，也没有什么办法了
循甚不乐此举，而无以夺其计，乃从之	您如果不同意，我就要率领始兴的兵众直接进攻寻阳
	卢
西秦王乾归攻秦金城郡，拔之	西秦王乞伏乾归进攻并攻克了后秦金城郡
卢循寇掠诸县无所得，谓徐道覆曰：师老矣，不如还寻阳，并力取荆州，据天下三分之二，徐更与建康争衡耳	卢循进犯掠夺了几个县，什么也没抢到，对徐道覆说：军队出来时间太长，已经疲惫不堪，我看不如回到寻阳，合力攻取荆州，这样，我们占据了三分这二的天下，就可以慢慢地再与建康的东晋政权争强斗胜了
秋，七月，庚申，循自蔡洲南还寻阳，留其党范崇民将五千人据南陵	秋季，七月，庚申，卢循从蔡州向南撤退回寻阳，留下他的部将范崇民带领五千人据守南陵
甲子，裕使辅国将军王仲德、广川太守刘、河间内史兰陵蒯恩、中军谘议参军孟怀玉等帅众追循	甲子，刘裕派遣辅国将军王仲德、广川太守刘钟、河间内史兰陵人蒯恩、中军谘议参军孟怀玉等人带兵追击卢循
乙丑，魏主嗣还平城	乙丑，北魏国主拓跋嗣回到平城
西秦王乾归讨越质屈机等十余部，降其众二万五千，徙于苑川	西秦王乞伏乾归讨伐越质屈机等十几个部落，收降当地的士民二万五千人，并把他们迁到苑川居住
八月，乾归复都苑川	八月，乞伏乾归恢复苑川为自己的都城
刘裕还东府，大治水军，遣建威将军会稽孙处、振武将军沈田子帅众三千自海道袭番禺	东晋刘裕回到东府，大规模建设水军
田子，林子之兄也	他派遣建威将军会稽人孙处、振武将军沈田子率领部众三千人从海上绕道，前去袭击番禺
众皆以为海道艰远，必至为难，且分撤见力，非目前之急	沈田子是沈林子的哥哥
裕不从，敕处曰：大军十二月之交必破妖虏，卿至时，先倾其巢窟，使彼走无所归也	大家都以为海上行军艰难遥远，一定要抵达那里是一件很难完成的任务，而且分出现有兵力去进攻广州，也不是当务之急
江州刺史庾悦以鄱阳太守虞丘进为前驱，屡破卢循兵，进据豫章，绝循粮道	江州刺史庾悦任用鄱阳太守虞丘进为前锋，几次打败卢循的部队，开进到豫章据守，切断了卢循的运粮通道
九月，刘遵斩苟林于巴陵	九月，刘遵在巴陵斩杀了苟林
西秦王乾归攻秦略阳、南安、陇西诸郡，皆克之，徙民二万五千户于苑川及罕	西秦王乞伏乾归进攻后秦略阳、南安、陇西等几个郡，都攻克了，把那里的百姓二万五千家迁移到苑川和罕居住
甲寅，葬魏主于盛乐金陵，谥曰宣武，庙号烈祖	甲寅，把北魏国主拓跋安葬在盛乐的金陵，谥号宣武，庙号烈祖
鲜卑仆浑、羌句岂、输报、邓若等帅户二万降于西秦	鲜卑族仆浑部落，羌族句岂部落、输报部落、邓若部落等，率领二万户居民向西秦投降
癸丑，益州刺史鲍陋卒	癸丑，东晋益州刺史鲍陋去世
谯道福陷巴东，杀守将温祚、时延祖	谯道福攻陷了巴东，杀死那里的守将温祚、时延祖
春，正月，己未，刘裕还建康	春季，正月，己未，刘裕回到建康
秦广平公弼有宠于秦王兴，为雍州刺史，镇安定	后秦广平公姚弼，受到后秦王姚兴的宠爱，担任雍州刺史，镇守安定
姜纪谄附于弼，劝弼结兴左右以求入朝	姜纪投靠姚弼，极尽谄媚，他劝说姚弼结交姚兴身边的人，争取回到朝廷任职
兴征弼为尚书令、侍中、大将军	姚兴征召姚弼为尚书令、侍中、大将军
弼遂倾身结纳朝士，收采名势，以倾东宫；国人恶之	姚弼于是谦恭地与朝中官员交往结纳，树立名望，培植势力，以此排挤太子姚泓，国内官民，对他非常讨厌
会兴以西北多叛乱，欲命重将镇抚之；陇东太守郭播请使弼出镇；兴不从，以太常索棱为太尉、领陇西内史，使招抚西秦	正赶上姚兴因为西北地区的叛乱层出不穷，打算派一名重要的将领到那里镇抚，所以陇东太守郭播便请求派姚弼去镇守
西秦王乾归遣使送所掠守宰，谢罪请降	姚兴并不听从，任命太常索棱为太尉、兼陇西内史，让他去招扶西秦
兴遣鸿胪拜乾归都督陇西・岭北・杂胡诸军事、征西大将军、河州牧、单于、河南王，太子炽磐为镇西将军、左贤王、平昌公	西秦王乞伏乾归派使节送还被他俘虏的守、宰等地方官，承认罪过，请求投降
	姚兴便派鸿胪拜乞伏乾归都督陇西、岭北、杂胡诸军事及征西大将军、河州牧、单于、河南王，封太子乞伏炽磐为镇
河南王乾归徙鲜卑仆浑部三千余户于度坚城，以子敕勃为秦兴太守以镇之	后秦刚刚加封的河南王乞伏乾归，把鲜卑族仆浑部落的三千多户居民强行迁往度坚城，任命儿子乞伏敕勃为秦兴太守，镇守那里
焦朗犹据姑臧，沮渠蒙逊攻拔其城，执朗而宥之；以其弟为秦州刺史，镇姑臧	南凉将军焦朗还占据着姑臧
遂伐南凉，围乐都，三旬不克；南凉王檀以子安周为质，乃还	北凉沮渠蒙逊攻克了这座城市，活捉焦朗，又把他宽释了，并任命自己的弟弟沮渠为秦州刺史，镇守姑臧
	于是，他们继续征伐南
吐谷浑树洛干伐南凉，败南凉太子虎台	吐谷浑可汗树洛干讨伐南凉国，打败了南凉太子秃发虎台
南凉王檀欲复伐沮渠蒙逊，邯川护军孟恺谏曰：蒙逊新并姑臧，凶势方盛，不可攻也	南凉王秃发檀打算再一次征伐沮渠蒙逊，邯川护军孟恺劝阻说：沮渠蒙逊刚刚吞并了姑臧，凶猛的势头正在极盛的时候，不可以去进攻他
檀不从，五道俱进，至番禾、苕，掠五千余户而还	秃发檀不听，兵分五路，同时进军，抵达番禾、苕，抢掠了五千多户居民回军
将军屈右曰：今既获利，宜倍道旋师，早度险厄	将军屈右说：这次既然已经得到了好处，就应该火速班师，早点摆脱危险的环境
蒙逊善用兵，若轻军猝至，大敌外逼，徙户内叛，此危道也	沮渠蒙逊善于指挥军队，如果他派一支轻装的部队突然来到，强大的敌人在外围步步威逼，我们裹胁的这些迁移百姓在里面叛乱，这可是危险的事呵
卫尉伊力延曰：彼步我骑，势不相及	卫尉伊力延说：他们步行我们骑马，按道理他们是赶不上我们的
今倍道而归则示弱，且捐弃资财，非计也	现在如果我们加速回去，就是向敌人显示我们懦弱，而且要扔掉许多军用物资，不是好办法
俄而昏雾风雨，蒙逊兵大至，檀败走	不久，天气昏暗，大雾弥漫，风雨交加，沮渠蒙逊的军队大批出现，秃发檀败退而走
蒙逊进围乐都，檀婴城固守，以子染干为质以请和，蒙逊乃还	沮渠蒙逊进军围困乐都，秃发檀绕着城池，坚持防守，最后又用儿子秃发染干作为人质，向对方请求和解，沮渠蒙逊才收兵回去
卢循行收兵至番禺，遂围之，孙处拒守二十余日	卢循在撤退的过程中收集残兵败将，来到番禺，于是把番禺包围，孙处在那里抵抗坚守了二十多天
沈田子言于刘藩曰：番禺城虽险固，本贼之巢穴；今循围之，或有内变	沈田子对刘藩说：番禺城池虽然险要坚固，但是却本来就是敌兵的老窝，现在被卢循围困着，或许城里会出现变乱
且孙季高众力寡弱，不能持久，若使贼还据广州，凶势复振矣	况且孙处的军队少，力量弱，不可能坚持太久，如果让这些贼兵回来占据了广州，那么他们的凶恶势力就要重振了
夏，四月，田子引兵救番禺，击循，破之，所杀万余人	夏季，四月，沈田子带兵去援救番禺，进攻卢循，并把他打败，杀死一万多人
循走，田子与处共追之，又破循于苍梧、郁林、宁浦	卢循逃跑，沈田子与孙处一起去追击他，又在苍梧、郁林、宁浦等地几次打败卢循
会处病，不能进，循奔交州	正巧此时孙处病倒，大军不能继续前进，卢循乘机投奔交州
秋，七月，燕王跋以太子永领大单于，置四辅	秋季，七月，北燕国主冯跋任命太子冯永兼任大单于，设置四位辅佐大臣
沮渠蒙逊帅轻骑袭西凉，西凉公曰：兵有不战而败敌者，挫其锐也	沮渠蒙逊率领轻装骑兵袭击西凉国，西凉公李说：用兵的人有不用战斗而把敌人打败的，那就是挫伤他的锐气
蒙逊新与吾盟，而遽来袭我，我闭门不与战，待其锐气竭而击之，蔑不克矣	沮渠蒙逊刚刚与我们结盟，却又突然前来袭击我们，我们关紧城门不和他们接战，等到他们锐气枯竭之后再来进攻他们，没有不获胜的
顷之，蒙逊粮尽而归，遣世子歆帅骑七千邀击之，蒙逊大败，获其将沮渠百年	不久，沮渠蒙逊的军队粮食吃完，撤军，李派嫡长子李歆率领骑兵七千人拦腰进攻他们，沮渠蒙逊部队惨败，西凉俘获了他们的大将沮渠百年
是岁，并州刺史刘道怜为北徐州刺史，移镇彭城	这一年，东晋并州刺史刘道怜改任北徐州刺史，迁移到彭城镇守
二月，丙子，以吴兴太守孔靖为尚书右仆射	二月，丙子，东晋任命吴兴太守孔靖为尚书右仆射
河南王乾归徙都谭郊，命平昌公炽磐镇苑川	河南王乞伏乾归把都城迁到谭郊，命令平昌公乞伏炽磐镇守苑川
乾归击吐谷浑阿若干于赤水，降之	乞伏乾归在赤水袭击吐谷浑汗国的阿若干，收降了他
夏，四月，刘道规以疾求归，许之	夏季，四月，东晋荆州刺史刘道规因为身体有病，请求解职回京，朝廷准许
道规在荆州累年，秋毫无犯	刘道规在荆州任职几年，丝毫也没有侵占百姓的利益
及归，府库帷幕，俨然若旧	到他回京的时候，府库的帷幕都和他刚来时一模一样
随身甲士二人迁席於舟中，道规刑之于市	他的随从中有两个卫兵把一条草席带上了船，刘道规也把他们拉到市井中斩首
乞伏炽磐攻南凉三河太守吴阴于白土，克之，以乞伏出累代之	乞伏炽磐在白土进攻南凉三河太守吴阴，击败了他，让乞伏出累代替吴阴镇守白土
闰月，庚子，南郡烈武公刘道规卒	闰六月，庚子，东晋南郡烈武公刘道规去世
皇后王氏崩	东晋皇后王氏去世
庚戌，魏主嗣还平城	庚戌，北魏国主拓跋嗣回到平城
九月，河南王炽磐以尚书令武始翟为相国，侍中、太子詹事赵景为御史大夫，罢尚书令、仆、尚书六卿、侍中等官	九月，西秦河南王乞伏炽磐任命尚书令武始人翟为相国，任命侍中、太子詹事赵景为御史大夫，撤销了尚书令、仆、尚书六卿、待中等官职
癸酉，葬僖皇后于休平陵	癸酉，东晋把僖皇后王氏安葬在休平陵
秦立昭仪齐氏为后	后秦册立昭仪齐氏为王后
沮渠蒙逊迁于姑臧	北凉沮渠蒙逊把都城迁到姑臧
分荆州十郡置湘州	东晋把荆州的十个郡分出来，设立湘州
加太尉裕太傅、扬州牧	东晋朝廷加授太尉刘裕为太傅、扬州牧
丁巳，魏主嗣北巡，至长城而还	丁巳，北魏国主拓跋嗣，巡视北方，到达长城后返回
春，二月，庚戌，魏主嗣如高柳川；甲寅，还宫	春季，二月，庚戌，回宫
庚午，秦王兴遣使至魏修好	庚午，后秦王姚兴派遣使节前往北魏建立友好关系
林邑范胡达寇九真，杜慧度击斩之	林邑国范胡达进犯东晋九真郡，杜慧度回击并把他杀了
夏，四月，乙卯，魏主嗣西巡，命郑兵将军奚斤、鸿飞将军尉古真、都将闾大肥等击越勤部于跋那山	夏季，四月，乙卯，北魏国主拓跋嗣向西巡视，下令郑兵将军奚斤、鸿飞将军尉古真、都将闾大肥等进军跋那山，袭击越勤部落
大翁，柔然人也	闾大肥是柔然人
河南王炽磐遣安北将军乌地延、冠军将军翟绍击吐谷浑别统句旁于	河南王乞伏炽磐派遣安北将军乌地延、冠军将军翟绍进攻吐谷浑所
河西王蒙逊立子政德为世子，加镇卫大将军、录尚书事	北凉河西王沮渠蒙逊册立儿子沮渠政德为世子，加封为镇卫大将军、录尚书事
朱龄石等至白帝发函书，曰：众军悉从外水取成都，臧熹从中水取广汉，老弱乘高舰十馀，从内水向黄虎	东晋朱龄石等人带兵抵达白帝，打开盒中刘裕写的书信，上面说：大部队全部从外水进攻成都，臧熹从水中进攻广汉，老弱残兵乘坐高大的战舰十几条，从内水向黄虎进发
于是诸军倍道兼行	于是，几路大军火速向目标进发
谯纵果命谯道福将重兵镇涪城，以备内水	谯纵果然命令谯道福带领主力部队镇守涪城，用来防备从内水进攻的敌人
魏奚斤等破越勤于跋那山西，徙二万余家于大宁	北魏奚斤等人在跋那山以西的地区打败越勤部落，把当地居民二万多家强行迁移到大宁
河西胡曹龙等拥部众二万人来入蒲子，张外降之，推龙为大单于	河西的胡人曹龙等人带领部众二万多人前来进犯蒲子，西河胡人张外向他投降，推举曹龙为大单于
丙戌，魏主嗣如定襄大洛城	丙戌，北魏国主拓跋嗣前往定襄郡大洛城
河南王炽磐击吐谷浑支旁于长柳川，虏旁及其民五千余户而还	河南王乞伏炽磐在长柳川进攻吐谷浑的支帝部落，把支旁和他的部众五千多户俘虏，然后回师
八月，癸卯，魏主嗣还平城	八月，癸卯，北魏国主拓跋嗣回到平城
河南王炽磐击吐谷浑别统掘逵于渴浑川，大破之，虏男女二万三千	河南王乞伏炽磐进军渴浑川袭击吐谷浑的属下掘逵部落，并把那里攻破，俘虏了当地男女百姓二万三千人
冬，十月，掘逵帅其馀众降于炽磐	冬季，十月，掘逵率领他的剩下的部众向乞伏炽磐投降
吐京胡与离石胡出以眷叛魏，魏主嗣命元城侯屈督会稽公刘、永安侯魏勤以讨之	吐京胡人与离石胡人的首领出以眷背叛北魏，北魏国主拓跋嗣命令元城侯拓跋屈督率会稽公刘、记安侯魏勤等带兵前去讨伐
丁巳，出以眷引夏兵邀击，禽之以献于夏；勤战死	丁巳，出以眷带领夏国军队拦腰阻击刘，并把刘活捉献给夏国
嗣以屈亡二将	魏勤战死
欲诛之；既而赦之，使摄并州刺史	拓跋嗣因为拓跋屈损失了两员大将，打算杀了他，但不久又把他赦免了，让他暂时代理并州刺史
屈到州，纵酒废事，嗣积其前后罪恶，槛车征还，斩之	拓跋屈来到并州治所，天天酗酒，荒废政事，拓跋嗣把他前前后后的罪恶积累到一起，用囚车将他押解回京，斩首
春，正月，辛酉，魏大赦，改元神瑞	春季，正月，辛酉，北魏实行大赦，改年号为神瑞
夏王勃勃侵魏河东蒲子	夏王赫连勃勃入侵北魏河东的蒲子
庚戌，魏主嗣如豺山宫	庚戌，北魏国主拓跋嗣前往豺山宫
魏并州刺史娄伏连袭杀夏所置吐京护军及其守兵	北魏并州刺史娄伏连，进攻并杀死了夏国所设置的吐京护军和那里的守卫士卒
夏，五月，辛酉，魏主嗣还平城	夏季，五月，辛酉，北魏国主拓跋嗣回到平城
秦后将军敛成讨叛羌，为羌所败，惧罪，出奔夏	后秦后将军敛成，讨伐叛乱的羌族部落，被羌人打败，为此他非常害怕，出去投奔夏国
秦王兴有疾	后秦王姚兴有病
妖贼李弘与氐仇常反于贰城，兴舆疾往讨之，斩常，执弘而还	妖贼首领李弘与氐人部落首领仇常在贰城反叛，姚兴带病坐在车轿上前去讨伐他们，斩杀了仇常，活捉李弘而回京
六月，泰山太守刘研等帅流民七千余家、河西胡酋刘遮等帅部落万余家，皆降于魏	六月，东晋泰山太守刘研等人率领流亡难民七千多家，河西的匈奴部落酋长刘遮等帅领部落的一万多家，都向北魏国投降
魏主嗣以博士王谅为平南参军，使以平南将军、相州刺史尉太真书与太裕相闻	北魏国主拓跋嗣任命博士王谅为平南参军，让他以平南将军、相州刺史尉太真的名义写信给东晋太尉刘裕，致以问侯
太真，古真之弟也	尉太真是尉古真的弟弟
九月，丁巳朔，日有食之	九月，丁巳逆，出现日食
冬，十月，河南王炽磐复称秦王，置百官	冬季，十月，河南王乞伏炽磐再一次号称秦王，设置文武百官
燕主跋与夏连和，夏王勃勃遣御史中丞乌洛孤如燕莅盟	北燕王冯跋与夏国联合，夏王赫连勃勃派遣御史中丞乌洛孤前往北燕签订盟约
十一月，壬午，魏主嗣遣使者巡行诸州，校阅守宰资财，非家所赍，悉簿为赃	十一月，壬午，北魏国主拓跋嗣派遣使者到各州巡察，检查核对守宰等地方官的资产钱财，凡不是从家里自己带出来的东西，全部当作赃物记录下来
西秦王炽磐立妃秃发氏为后	西秦王乞伏炽磐册立妃子秃发氏为皇后
河内人司马顺宰自称晋王，魏人讨之，不克	北魏国河内人司马顺宰自称为晋王，北魏军队讨伐他，没有攻克
燕辽西公素弗卒，燕王跋比葬七临之	北燕辽西公冯素弗去世，北燕王冯跋到安葬他的时候，已经前去吊唁了七次
春，正月，丙辰，魏主嗣还平城	春季，正月，丙辰，北魏国主拓跋嗣回到平城
丁丑，以吏部尚书谢裕为尚书左仆射	丁丑，东晋朝廷任命吏部尚书谢裕为尚书左仆射
琅邪太守刘朗帅二千余家降魏	东晋琅邪太守刘朗率领二千多家百姓投降了北魏
庚子，河西胡刘云等帅数万户降魏	庚子，河西一带的胡族首领刘云等人统率几万户投降北魏
太尉裕使参军檀道济、朱超石将步骑出襄阳	东晋太尉刘裕派遣参军檀道济、朱超石带领步兵骑兵进攻襄阳
超石，龄石之弟也	朱超石是朱龄石的弟弟
江夏太守刘虔之将兵屯三连，立桥聚粮以待，道济等积日不至	江夏太守刘虔之带领部队屯驻在三连，修筑桥梁，积聚粮草，等待他们的到来，但是檀道济的军队却过了许多天也没有到来
鲁轨袭击虔之，杀之	鲁轨袭击刘虔之，并把他杀了
裕使其振威将军东海徐逵之统参军蒯恩、王允之、沈渊子为前锋，出江夏口	刘裕派他的女婿、振威将军、东海人徐逵之统领参军蒯恩、王允之、沈渊子等为前锋，出击江夏口
逵之等与鲁轨战于破冢，兵败，逵之、允之、渊子皆死，独蒯恩勒兵不动	徐逵之等人在破冢与鲁轨交战，大军失败，徐逵之、王允之、沈渊子等都被杀，只有蒯恩的部队压住了阵脚，没有败退下去
轨乘胜力攻之，不能克，乃退	鲁轨乘胜对他发动了猛攻，却不能攻克他的防守，于是退了下去
渊子，林子之兄也	沈渊子是沈林子的哥哥
夏王勃勃攻秦杏城，拔之，执守将逃逵，坑士卒二万人	夏王赫连勃勃进攻后秦杏城，攻克，抓获了那里的守将姚逵，把敌军的二万士卒全部活埋
秦王兴如北地，遣广平公弼及辅国将军敛曼嵬向新平，兴还长安	后秦王姚兴前往北地，派遣广平公姚弼以及辅国将军敛曼嵬率军向新平进发，姚兴回长安
河西饥胡相聚于上党，推胡人白亚栗斯为单于，改元建平	河西一带受饥饿困扰的胡族人在上党聚集在一起，推举胡人白亚栗斯为单于，改年号为建平
以司马顺宰为谋主，寇魏河内	他们任用司马顺宰为主要谋士，进犯北魏的河内
夏，四月，魏主嗣命公孙表等五将讨之	夏季，四月，北魏国主拓跋嗣命令公孙表等五位大将前去讨伐他们
青、冀二州刺史刘敬宣参军司马道赐，宗室之疏属也	东晋青、冀二州刺史刘敬宣的参军司马道赐是晋朝宗室的远亲
闻太尉裕攻司马休之，道赐与同府壁闾道秀、左右小将王猛子谋杀敬宣，据广固以应休之	听说太尉刘裕进攻司马休之，司马道赐便与同僚辟闾道秀、身边的小将王猛子阴谋刺杀刘敬宣，然后占据广固，响应司马休之
乙卯，敬宣召道秀，屏人语，左右悉出户	乙卯，刘敬宣召见辟闾道秀，把别人全部屏退，秘密交谈，他身边的侍卫也全部被隔在窗外
猛子逡巡在后，取敬宣备身刀杀敬宣	王猛子慢慢绕到刘敬宣身后，突然抢过刘敬宣防身用的佩刀，把刘敬宣杀了
文武佐吏即时讨道赐等，皆斩之	刘敬宣手下的文武将佐、官吏马上声讨司马道赐等人，并把他们全部斩杀
己卯，魏主嗣北巡	己卯，北魏国主拓跋嗣向北巡视
五月，丁亥，魏主嗣如大宁	五月，丁亥，北魏国主拓跋嗣前往大宁
益州刺史朱龄石遣使诣河西王蒙逊，谕以朝廷威德	东晋益州刺史朱龄石派遣使节前去拜见北凉河西王沮渠蒙逊，宣扬东晋朝廷的威势和德政
蒙逊遣舍人黄迅诣龄石，且上表言：伏闻车骑将军裕欲清中原，愿为右翼，驱除戎虏	沮渠蒙逊派遣舍人黄迅前来拜见朱龄石，并且呈上奏表，说：听说车骑将军刘裕打算清剿中原地区，我甘愿做他的右翼部队，帮助他驱逐戎族强盗
夏王勃勃遣御史中丞乌洛孤与蒙逊结盟，蒙逊遣其弟湟河太守汉平莅盟于夏	夏王赫连勃勃派遣御史中丞乌洛孤与沮渠蒙逊缔结盟约，沮渠蒙逊派他的弟弟湟河太守沮渠汉平前往夏国，在盟约上签字
西秦王炽磐率众三万袭湟河，沮渠汉平拒之，遣司马隗仁夜出击炽磐，破之	西秦王乞伏炽磐统率三万大军袭击湟河，沮渠汉平抵抗，派遣司马隗仁连夜出击乞伏炽磐，把他打败
炽磐将引去，汉平长史焦昶、将军段景潜召炽磐，炽磐复攻之；昶、景因说汉平出降	乞伏炽磐刚打算带兵回去，沮渠汉平的长史焦昶、将军段景暗地里召引乞伏炽磐来攻，乞伏炽磐再次挥师进攻，焦昶、段景于是劝说沮渠汉平出城投降
仁勒壮士百余据南门楼，三日不下，力屈，为炽磐所禽	隗仁带领一百多名壮士占据南门楼，坚决不投降，围攻了三天也没有攻下，最后，他们精疲力尽，被乞伏炽磐抓获
炽磐欲斩之，散骑常侍武威段晖谏曰：仁临难不畏死，忠臣也，宜宥之以厉事君	乞伏炽磐打算杀了他，散骑常侍武威人段晖劝说道：隗仁面临危难不怕死，是一个忠臣，应该宽宥他，以此鼓励那些忠于君王的人们
乃囚之	于是，把他囚禁起来
炽磐以左卫将军匹达为湟河太守，击乙弗窟乾，降其三千余户而归	乞伏炽磐任命左卫将军乞伏匹达为湟河太守，进攻乙弗窟乾，收降了那里的三千多户百姓回来
以尚书右仆射出连虔为都督岭北诸军事、凉州刺史；以凉州刺史谦屯为镇军大将军、河州牧	又任命尚书右仆射出连虔为都督岭北诸军事、凉州刺史；任命凉州刺史乞伏谦屯为镇军大将军、河州牧
隗仁在西秦五年，段晖又为之请，炽磐免之，使还姑臧	隗仁在西秦被囚五年之后，段晖又为他求情，乞伏炽磐赦免了他，让他回姑臧
西秦王炽磐以秦州刺史昙达为尚书令，光禄勋王松寿为秦州刺史	西秦王乞伏炽磐任命秦州刺史乞伏昙达为尚书令，任命光禄勋王松寿为秦州刺史
辛亥晦，日有食之	辛亥晦，出现日食
八月，甲子，太尉裕还建康，固太傅、州牧，其馀受命	八月，甲子，东晋太尉刘裕回到建康，坚决辞让太傅、扬州牧，接受其余任命
以豫章公世子义符为兖州刺史	任命世子豫章公刘义符为兖州刺史
丁未，谢裕卒；以刘穆之为左仆射	丁未，东晋尚书左仆射谢裕去世，任命刘穆之为尚书左仆射
九月，己亥，大赦	九月，己亥，东晋实行大赦
夏赫连建将兵击秦，执平凉太守姚军都，遂入新平	夏国赫连建带领部队进攻后秦，抓获了平凉太守姚军都，于是又进犯新平
广平公弼与战于龙尾堡，禽之	后秦广平公姚弼与他们在龙尾堡接战，把赫连建活捉
林邑寇交州，州将击败之	林邑进犯东晋的交州，州的守将把来敌打败
西秦王炽磐攻秦洮阳公彭利和於川，沮渠蒙逊攻石泉以救之	西秦王乞伏炽磐在川进攻后秦洮阳公彭利和，沮渠蒙逊进攻西秦所属的石泉，以此解救彭利和
炽磐至沓中，引还	乞伏炽磐的大军抵达沓中，听说消息后，带兵回国
二月，炽磐遣襄武侯昙达救石泉，蒙逊亦引去	二月，乞伏炽磐派遣襄武侯乞伏昙达营救石泉，沮渠蒙逊也带兵回去了
蒙逊遂与炽磐结和亲	沮渠蒙逊于是和乞伏炽磐通婚讲和
夏，四月，壬子，魏大赦，改元泰常	夏季，四月，壬子，北魏实行大赦，改年号为泰常
西秦襄武侯昙达等击秦秦州刺史姚艾于上，破之，徙其民五千余户於罕	西秦国襄武侯乞伏昙达等在上袭击后秦国秦州刺史姚艾，并把他打败，把当地的五千多户居民强行迁移到罕
五月，癸巳，加太尉裕领北雍州刺史	五月，癸巳，东晋加授太尉刘裕兼任北雍州刺史
六月，丁巳，魏主嗣北巡	六月，丁已，北魏国主拓跋嗣巡视北方
并州胡数万落叛秦，入于平阳，推匈奴曹弘为大单于，攻立义将军姚成都于匈奴堡	并州的几万帐落的胡人背叛后秦，来到平阳，推举匈奴人曹弘为大单于，向匈奴堡开进，攻伐立义将军姚成都
征东将军姚懿自蒲坂讨之，执弘，送长安，徙其豪右万五千落于雍州	征东将军姚懿从蒲坂发兵讨伐他们，抓住了曹弘，押送到长安，并把他们中间的一万五千落篷帐的豪门大族迁往雍州
八月，丙午，大赦	八月，丙午，东晋实行大赦
宁州献琥珀枕于太尉裕	东晋宁州把一个琥珀做的枕头进献给太尉刘裕
裕以虎珀治金创，得之大喜，命碎捣分赐北征将士	刘裕因为琥珀可以治疗外伤，所以得到这个枕头非常高兴，命令把它捣碎，分别赐给即将要去北方征战的将士
初，魏主嗣使公孙表讨白亚栗斯，曰：必先与秦洛阳戍将相闻，使备河南岸，然后击之	当初，北魏国主拓跋嗣派遣公孙表前去讨伐白亚栗斯，说：一定事先通知秦国的洛阳守将，让他们在黄河南岸严密设防，然后进攻他
表未至，胡人废白亚栗斯，更立刘虎为率善王	公孙表还没有到达，胡人便废黜了白亚栗斯，重新拥立刘虎为率善王
表以胡人内自携贰，势必败散，遂不告秦将而击之，大为虎所败，士卒死伤甚众	公孙表以为胡人内部勾心斗角、毫不团结，结果一定会失败溃散，于是并不通告后秦的守将，便发动了进攻，被刘虎打得大败，士卒中死伤的人很多
冬，十月，壬戌，魏主嗣如豺山宫	冬季，十月，壬戌，北魏国主拓跋嗣前往豺山宫
西秦王炽磐使秦州刺史王松寿镇马头，以逼秦之上	西秦王乞伏炽磐派遣秦州刺史王松寿镇守马头，用来对后秦的上造成压力
十一月，甲戌，魏主嗣还平城	十一月，甲戌，北魏国主拓跋嗣回到平城
太尉裕遣左长史王弘还建康，讽朝廷求九锡	太尉刘裕派遣左长史王弘返回建康，委婉地向安帝请求，加授自己九锡
时刘穆之掌留任，而旨从北来，穆之由是愧惧发病	这时刘穆之执掌留守的大权，但是这旨意却是刘裕自己在北方提出，又通过别人传来，刘穆之从此既惭愧又害怕，得了疾病
弘，之子也	王弘是王的儿子
十二月，壬申，诏以裕为相国、总百揆、扬州牧，封十郡为宋公，备九锡之礼，位在诸侯王上，领征西将军、司・豫・北徐・雍四州刺史如故	十二月，壬申，安帝下诏任命刘裕为相国、总百揆、扬州牧，加封为食邑十郡的宋公，备办九锡的礼仪，尊位在各诸侯王之上，并仍像原来那样兼任征西将军，司、豫、北徐、雍四州刺史
裕辞不受	刘裕推辞，不接受任命
西秦王炽磐遣使诣太尉裕，求击秦以自效	西秦王乞伏炽磐派遣使节前来拜见东晋太尉刘裕，请求进攻后秦，主动为刘裕效力
裕拜炽磐平西将军、河南公	刘裕授乞伏炽磐为平西将军、河南公
秦姚懿司马孙畅说懿使袭长安，诛东平公绍，废秦主泓而代之	后秦姚懿的司马孙畅劝说姚懿，让他去回击长安，杀死东平公姚绍，废掉国主姚泓，自己代替他登基
懿以为然，乃散谷以赐河北夷、夏，欲树私恩	姚懿认为很对，于是把粮食发放给河北的夷族与汉族，打算以此树立一些个人的恩德，收买民心
左常侍张敞、侍郎左雅谏曰殿下以母弟居方面，安危休戚，与国同之	左常侍张敞、侍郎左雅劝阻他说：殿下以皇帝的同母弟弟的身份坐镇一方，自己的安危悲喜，与皇帝和国家是一样的
今吴寇内侵，四州倾没，西虏扰边，秦、凉覆败，朝廷之危，有如累卵	现在吴地的敌人前来侵犯，四州已经丧失，西部的强盗也不断地骚扰边境，秦州、凉州已经倾覆失败，朝廷的危险程度，像垒在一起的鸡蛋那样
谷者，国之本也，而殿下无故散之，虚损国储，将若之何	粮食是国家政权稳定的基础，殿下无缘无故地把它散发掉，倒空损耗国家的储备，将来怎么办
懿怒，笞杀之	姚懿勃然大怒，鞭打他们至死
是岁，魏卫将军安城孝元王叔孙俊卒	这一年，北魏卫将军、安城孝元王叔孙俊去世
魏主嗣甚惜之，谓其妻桓氏曰；生同其荣，能没同其戚乎	北魏国主拓跋嗣非常惋惜他，对他的妻子桓氏说：生的时候可以和他一起享受荣华富贵，死后能和他一起承受悲哀吗
桓氏乃缢而焉	桓氏于是自己上吊而死，死后二人合葬
春，正月，甲戌朔，日有食之	春季，正月，甲戌朔，出现日食
太尉裕引水军发彭城，留其子彭城公义隆镇彭城	东晋太尉刘裕从彭城率水军出发西上，留下他的儿子、彭城公刘义隆镇守彭城
诏以义隆为监徐・兖・青・冀四州诸军事、徐州刺史	晋安帝司马德宗下诏，任命刘义隆为监徐、兖、青、冀四州诸军事，兼徐州刺史
西秦安东将军木弈干击吐谷浑树洛干，破其弟阿柴干尧杆川，俘五千余口而还	西秦安东将军乞伏木弈干，进攻吐谷浑汗国可汗树洛干，在尧杆川大败他的弟弟阿柴，俘虏五千多人班师
树洛干走保白兰山，惭愤发疾，将卒，谓阿柴曰：吾子拾虔幼弱，今以大事付汝	树洛干逃走，退保白兰山；他又羞又愤，大病不起，临死前，他对阿柴说：我的儿子慕容拾虔年小，我如今把身后大事托付给你
树洛干卒，阿柴立，自称骠骑将军、沙州刺史	树洛干去世，阿柴继位，自称为骠骑将军、沙州刺史
谥树洛干曰武王	追赠树洛干为武王
阿柴稍用兵侵并其傍小种，地方数千里，遂为强国	阿柴逐渐兴兵向外扩张，吞并吐谷浑周围的弱小部落，扩展疆域数千里，于是成为一个强大国家
丁巳，魏主嗣如高柳；壬戌，还平城	丁巳，返回京都平城
河西王蒙逊大赦	北凉河西王沮渠蒙逊大赦天下
遣张掖太守沮渠广宗诈降以诱凉公歆，歆发兵应之	他派张掖太守沮渠广宗向西凉诈降，引诱西凉公李歆派兵出来迎接，李歆果然发兵接应
蒙逊将兵三万伏于蓼泉，歆觉之，引兵还	而沮渠蒙逊率领三万士兵埋伏在蓼泉，李歆发觉，率兵撤退
蒙逊追之，歆与战于解支涧，大破之，斩首七千余级	沮渠蒙逊率众追击，李歆与沮渠蒙逊在解支涧会战，李歆大破北凉军，斩杀七千余人
蒙逊城建康，置戍而还	沮渠蒙逊修建建康城，设置戍所，然后回国
五月，乙未，齐郡太守王懿降于魏，上书言：刘裕在洛，宜发兵绝其归路，可不战而克	五月，乙未，东晋齐郡太守王懿投降了北魏，他上书北魏朝廷说：刘裕现在洛阳，应该迅速发兵切断他的归路，可以不战而胜
魏主嗣善之	北魏国主拓跋嗣表示赞许
魏主嗣西巡至云中，遂济河，畋于大漠	北魏国主拓跋嗣向西巡视，抵达云中；然后渡过黄河，在大漠上狩猎
魏置天地四方六部大人，以诸公为之	北魏朝廷设置天、地、东、西、南、北六部大人，一律选用爵以及地位相当于公爵的大臣担任
秋，七月，太尉裕至陕	秋季，七月，东晋太尉刘裕抵达陕城，沈田子、傅弘之等率兵进入武关，后秦的守将纷纷弃城逃走
沈田子、傅弘之入武关，秦戍将皆委城走	沈田子等进兵驻守青泥
田子等进屯青泥，秦主泓使给事黄门侍郎姚和都屯柳以拒之	后秦国主姚泓命给事黄门侍郎姚和都，在柳驻兵屯守，阻截东晋军
癸酉，司马休之、司马文思、马国、司马道赐、鲁轨、韩延之、刁雍、王慧龙及桓温之孙道度、道子、族人桓谧、桓、陈郡袁式等皆诣魏长孙嵩降	癸酉，先后从东晋流亡后秦的司马休之、司马文思、司马国、司马道赐、鲁轨、韩延之、刁雍、王慧龙，以及桓温的孙子桓道度、桓道子、族人桓谧、桓、陈郡人袁式等，全都投降了北魏司徒长孙嵩
秦匈奴镇将姚成都及弟和都举镇降魏	后秦匈奴堡守将姚成都与他的弟弟姚和都，举献城池，投降了北魏
魏主嗣诏民间得姚氏子弟送平城者赏之	北魏国主拓跋嗣下诏，声称民间百姓凡是救出姚氏子弟送到平城的人，重重有赏
冬，十月，己酉，嗣召长孙嵩等还	冬季，十月，己酉，拓跋嗣征召长孙嵩等班师回朝
司马休之寻卒于魏	不久，司马休之死在北魏
魏赐国爵淮南公、道赐爵池阳子、鲁轨爵襄阳公	北魏朝廷赐封司马国为淮南公、司马道赐为池阳子、鲁轨为襄阳公
刁雍表求南鄙自效，嗣以雍为建义将军	刁雍上书请求到南部边疆，报效北魏，拓跋嗣任命刁雍为建义将军
雍聚众于河、济这间，扰动徐、兖；太尉裕遣兵讨之，不克	刁雍在黄河、济水之间集结部队，骚扰东晋所属的徐州、兖州；太尉刘裕出兵讨伐，不能攻克
雍进屯固山，众至二万	刁雍进驻固山，手下兵员达二万人
诏进宋公爵为王，增封十郡；辞不受	东晋安帝司马德宗下诏封宋公刘裕为宋王，采邑增加十个郡，刘裕辞让，没有接受
十一月，魏叔孙建等讨西山丁零翟蜀洛支等，平之	十一月，北魏征南大将军叔孙建等征讨西山丁零部落酋长翟蜀洛支，平定了该部
三秦父老闻裕将还，诣门流涕诉曰：残民不沾王化，于今百年，始睹衣冠，人人相贺	三秦地区的父老，听说刘裕就要返回江南，都痛哭流涕地来到大营门前诉说：我们这些残余的汉人，没有接受朝廷的教化，至今已有一百年之久，直到今天才看到汉民族衣冠装束，人人都互相庆贺
长安十陵是公家坟墓，咸阳宫殿是公家室宅，舍此欲何之乎	长安十陵是你们刘家的坟墓，咸阳宫殿是你们刘家的住宅，你放弃它们想要去哪里
裕为之愍然，慰谕之曰：受命朝廷，不得擅留	刘裕也很伤感，安慰他们说：我接受朝廷的命令，不敢擅自停留
诚多诸君怀本之志，今以次息与文武贤才共镇此境，勉与之居	感谢诸位怀念故国的诚意，现在留下我的次子与文武贤才共同镇守这里，希望你们和好共处
十二月，庚子，裕发长安，自洛入河，开汴渠而归	十二月，庚子，刘裕从长安出发，自洛水进入黄河，开掘汴渠东返
氐豪徐骇奴、齐元子等拥部落三万在雍，遣使请降于魏	氐族酋长徐骇奴、齐元子等率领部落部众三万人在雍城，派遣使臣投降了北魏
魏主嗣遣将军王洛生、河内太守杨声等西行以应之	北魏国主拓跋嗣，派遣将军王洛生、河内太守杨声等向西行进，接应氐族部落
闰月，壬申，魏主嗣如大宁长川	闰十二月，壬申，北魏国主拓跋嗣前往大宁、长川
是岁，魏都坐大官章安侯封懿卒	这一年，北魏都坐大官、章安侯封懿去世
辛巳，大赦	辛巳，东晋下令实行大赦
秦王炽磐以乞伏木弈干为沙州刺史，镇乐都	西秦王乞伏炽磐任命乞伏木弈干为沙州刺史，镇守乐都
二月，乙弗乌地延帅户二万降秦	二月，乙弗部落、乌地延部落酋长率二万户部众归降西秦
三月，遣使聘魏	三月，东晋朝廷派遣使臣访问北魏
夏，四月，己巳，魏徙冀、定、幽三州徒河于代都	夏季，四月，己巳，北魏强行迁徙散居在冀州、定州、幽州三州的徒河人到代郡
魏天部大人白马文贞公崔宏疾笃，魏主遣侍臣问病，一夜数返	北魏天部大人、白马公崔宏病重，北魏国主拓跋嗣派他的侍从询问病情，一夜之间，返往数次
及卒，诏群臣及附国渠帅皆会葬	不久，崔宏去世，拓跋嗣下诏，命群臣和归附的部落酋长都来参加葬礼
秋，七月，戊午，魏主嗣至平城	秋季，七月，戊午，北魏国主拓跋嗣抵达平城
九月，甲寅，魏人命诸州调民租，户五十石，积于定、相、冀三州	九月，甲寅，北魏朝廷命令各州县征收租赋，每户交纳五十石，屯积在定州、相州、冀州三州
河西王蒙逊复引兵伐凉，凉公歆将拒之，左长史张体顺固谏，乃止	北凉河西王沮渠蒙逊再次率兵讨伐西凉，西凉公李歆准备出兵迎战，左长史张体顺坚决劝阻，李歆才停止行动
蒙逊芟其秋稼而还	沮渠蒙逊收割了长成的庄稼，班师回国
姚艾叛秦，降河西王蒙逊，蒙逊引兵迎之	西秦秦州牧姚艾叛变，投降了北凉河西王沮渠蒙逊，沮渠蒙逊出兵迎接
艾叔父隽言于众曰：秦王宽仁有雅度，自可安居事之，何为从河西王西迁	姚艾的叔父姚隽对他的部众说：秦王乞伏炽磐宽厚仁爱有雅量，我们可以安心留下来事奉他，为什么要跟随沮渠蒙逊西迁
众咸以为然，乃相与逐艾，推隽为主，复归于秦	部众都认为有理，就联合起来驱逐了姚艾，推举姚隽为首领，又归附了西秦
秦王炽磐征隽为侍中、中书监，赐爵陇西公，以左丞相昙达为都督洮・罕以东诸军事、征东大将军、秦州牧，镇南安	西秦王乞伏炽磐委任姚隽为侍中、中书监，赐封陇西公；又任命左丞相乞伏昙达为都督洮、罕以东诸军事、征东大将军、秦州牧，镇守南安
夏王勃勃筑坛于灞上，即皇帝位，改元昌武	夏王赫连勃勃，在灞上建筑高台，正式登上皇帝宝座，改年号为昌武
西秦王炽磐东巡；十二月，徙上民五千余户于罕	西秦王乞伏炽磐向东巡视；十二月，强行将上的百姓五千余户迁徙到罕
尚书右仆射袁湛卒	东晋尚书右仆射袁湛去世
春，正月，壬辰朔，改元	春季，正月，壬辰朔，东晋改年号元熙
立琅邪王妃褚氏为皇后；后，裒之曾孙也	东晋朝廷立琅邪王妃褚氏为皇后；褚皇后是褚裒的曾孙女
魏主嗣畋于犊渚	北魏国主拓跋嗣在犊渚狩猎
癸卯，魏主嗣还平城	癸卯，北魏国主拓跋嗣返回平城
庚申，葬安皇帝于休平陵	庚申，东晋朝廷在休平陵安葬晋安帝司马德宗
刺刘道怜司空出镇京口	东晋恭帝司马德文，诏命刘道怜为司空，镇守京口
夏主勃勃征隐士京兆韦祖思	夏主赫连勃勃征召隐士、京兆人韦祖思
祖思既至，恭惧过甚，勃勃怒曰：我以国士征汝，汝乃以非类遇我	韦祖思来到长安，过于谦卑恐惧，赫连勃勃大怒道：我把你当成国家的高士，征召来京，你却把我当作异族来对待
汝昔不拜姚兴，今何独拜我	你当年不向姚兴叩头，今天为什么偏偏来拜见我
我在，汝犹不以我为帝王；我死，汝曹弄笔，当置我于何地邪	我活着的时候，你就不把我当作帝王；我死后，你们这些人舞文弄墨，还不知把我作践到何种地步
遂杀之	于是，杀掉了韦祖思
夏，四月，秦征西将军孔子帅骑五千讨吐谷浑觅地于弱水南，大破之，觅地帅其众六千降于秦，拜弱水护军	夏季，四月，西秦征西将军乞伏孔子，率领骑兵五千人，在弱水之南进攻吐谷浑国酋长觅地，大破吐谷浑军队，觅地率领他的部众六千人归降了西秦，被西秦委任为弱水护军
辛未，魏主嗣东巡；甲申，还平城	辛未，返回平城
九月，宋王裕自解扬州牧	九月，东晋宋王刘裕主动辞去扬州牧一职
宋王裕以河南萧条，乙酉，徙司州刺史义真为扬州刺史，镇石头	东晋宋王刘裕鉴于河南人稀荒凉，乙酉，召回司州刺史刘义真，改任扬州刺史，镇守石头
萧太妃谓裕曰：道怜汝布衣兄弟，宜用为扬州	萧太妃对刘裕说：刘道怜是你从小患难与共的兄弟，应该让他担任扬州刺史
裕曰：寄奴于道怜，岂有所惜	刘裕说：我对于道怜，还有什么舍不得的
扬州根本所寄，事务至多，非道怜所了	可是扬州是京师重地，国家的根本，事务繁多，恐怕不是道怜所能胜任的
太妃曰：道怜年出五十，岂不如汝十岁儿邪	萧太妃说：刘道怜已经年过五十，难道还不如你那十几岁的小儿吗
裕曰：义真虽为刺史，事无大小，悉由寄奴	刘裕说：刘义真虽然名为刺史，但事无大小，都由我亲自决定
道怜年长，不亲其事，于听望不足	道怜年长，不亲自处理事务，有损于声望名位
太妃乃无言	萧太妃才无言以对
道怜性愚鄙而贪纵，故裕不肯用	刘道怜生性愚蠢卑鄙，贪婪放纵，所以刘裕不肯任用他
十一月，丁亥朔，日有食之	十一月，丁亥朔，出现日食
辛卯，宋王裕加殊礼，进王太妃为太后，世子为太子	辛卯，东晋宋王刘裕被朝廷加授特殊礼仪，进封萧太妃为太后，称世子刘义符为太子
春，正月，己亥，魏主还宫	春季，正月，乙亥，北魏国主拓跋嗣回宫
秦王炽磐立其子乞伏暮末为太子，仍领抚军大将军、都督中外诸军事，大赦，改元建弘	西秦王乞伏炽磐封他的儿子乞伏暮末为太子，仍然兼任抚军大将军，总掌全国内外的军事，宣布大赦，改年号为建弘
宋王欲受禅而难于发言，乃集朝臣宴饮，从容言曰：桓玄篡位，鼎命已移	东晋宋王刘裕希望晋恭帝司马德文能以禅让的形式把帝位传给自己，却难于启齿，于是，他召集手下朝臣饮酒欢宴
我首唱大义，兴复帝室，南征北伐，平定四海，功成业著，遂荷九锡	在筵席上，刘裕若无其事地说：当年桓玄篡位，晋国大权旁落
今年将衰暮，崇极如此，物忌盛满，非可久安；今欲奉还爵位，归老京师	是我首先提倡大义，复兴皇帝宗室，南征北讨，平定了天下，可谓大功告成，业绩卓著，于是承蒙皇上恩赐而有九锡之尊
群臣惟盛称功德，莫谕其意	如今我的年纪也快老了，地位又如此尊崇，无以复加，天下的事最忌讳装得太满而盈溢出来，那样就不可以得到长久的安宁了，现在我要将爵位奉还皇上，回到京师颐养天年
日晚，坐散	群臣不理解他的真正含意，只是一味盛称他的功德
中书令傅亮还外，乃悟，而宫门已闭，亮叩扉请见，王即开门见之	这日天色已晚，群臣散去
亮入，但曰：卧暂宜还都	中书令傅亮走出宫门，方才悟出宋王一席话的真实用意，但是宫门已经关闭，傅亮便叩门请求见宋王，宋王即令开门召见他
王解其意，无复他言，直云：须几人自送	傅亮入宫，只说：我应该暂且返回京师
亮曰：数十人可也	宋王刘裕明白他的用意，也不再多说别的，直接问：你需要多少人护送
即时奉辞	傅亮回答说：数十人就足够了
亮出，已夜，见长星竟天，拊髀叹曰：我常不信天文，今始验矣	随即与宋王刘裕辞别
亮至建康，夏，四月，征王入辅	傅亮出宫时已是半夜时分，只见彗星划过夜空，傅亮拍腿叹曰：我过去常常不信天象，今天看来天象开始应验了
王留子义康为都督豫・司・雍・并四州诸军事、豫州刺史，镇寿阳	傅亮来到京师建康，当时正值初夏四月，晋恭帝征召刘裕入京辅弼
义康尚幼，以相国参军南阳刘湛为长史，决府、州事	宋王刘裕让他的儿子刘义康留守，都督豫、司、雍、并四州诸军事，豫州刺史，坐镇寿阳
湛自弱年即有宰物之情，常自比管、葛，博涉书史，不为文章，不喜谈议	刘义康年纪还很幼小，刘裕于是任用相国参军南阳人刘湛为长史，帮助决策和处理府、州日常军政事务
王甚重之	刘湛自幼就有做宰辅的远大志向，常常以管仲、诸葛亮自比，他博览书史，却不喜做文章，不爱空发议论，因此刘裕特别器重他的才干
五月，乙酉，魏更谥宣武帝曰道武帝	五月，乙酉，北魏变更宣武帝拓跋的谥号，改称道武帝
魏淮南公司马国、池阳子司马道赐谋外叛，司马文思告之	北魏淮南公司马国、池阳子司马道赐阴谋反叛，司马文思告发了他们
庚戌，魏主杀国、道赐，赐文思爵郁林公	庚戌，北魏国主拓跋嗣杀司马国与司马道赐，赐封司马文思为郁林公
国等连引平城豪杰，坐族诛者数十人，章安侯封懿之子玄之当坐	司马国一伙的阴谋牵连了平城的大户豪强，全族被诛的就有数十人，章安侯封懿的儿子封玄之也应斩首
魏主以玄之燕朝旧族，欲宥其一子	北魏国主念及封玄之是燕朝旧族，想要宽宥他的一个儿子
玄之曰：弟子磨奴早孤，乞全其命	封玄之说：我的侄儿封磨奴幼年丧父，乞求您留他一命
乃杀玄之四子而宥磨奴	北魏国主于是杀掉了封玄之的四个儿子而饶恕了封磨奴
六月，壬戌，王至建康	六月，壬戌，宋王刘裕来到建康
傅亮讽晋恭帝禅位于宋，具诏草呈帝，使书之	傅亮用委婉的语言暗示晋恭帝将帝位禅让给宋王，并且草拟了退位诏书呈给晋恭帝，让他亲自抄写一遍
帝欣然操笔，谓左右曰：桓玄之时，晋氏已无天下，重为刘公所延，将二十载；今日之事，本所甘心	晋恭帝欣然提笔，并对左右侍臣说：桓玄之乱的时候，晋朝已失掉天下，后来幸赖刘公才得以延续将近二十年；今日禅位给他，是我甘心所为
遂书赤纸为诏	于是将傅亮呈来的草稿作为正式诏书抄写在红纸上
魏主如翳犊山，遂至冯卤池	北魏国主拓跋嗣前往翳犊山，又西去冯卤池
闻上受禅，驿召崔浩告之曰：卿往年之言验矣，朕于今日始信天道	他闻知刘裕接受禅让，用驿车征召崔浩，对他说：你当年的预言全部都应验了，我到今日才开始相信天道
秋，七月，丁酉，魏主如五原	秋季，七月，丁酉，北魏国主拓跋嗣抵达五原
甲辰，诏以凉公歆为都督高昌等七郡诸军事、征西大将军、酒泉公；	甲辰，刘裕下诏，任命西凉公李歆为都督高昌等七郡诸
己未，魏主如云中	己未，北魏国主拓跋嗣抵达云中
河西王蒙逊欲伐凉，先引兵攻秦浩；既至，潜师还屯川岩	北凉河西王沮渠蒙逊准备进攻西凉，于是，他设计先在东方进攻西秦的浩，大军一到浩，立即秘密回师，驻军川岩
八月，辛未，追谥妃臧氏为敬皇后	八月，辛未，刘裕追赠妃臧爱亲谥号敬皇后
癸酉，立王太子义符为皇太子	癸酉，立王太子刘义符为皇太子
闰月，壬午，诏晋帝诸陵悉置守卫	闰月，壬午，刘裕下诏：东晋历代皇帝陵墓，都设置守卫
九月，秦振武将军王基等袭河西王蒙逊胡园戍，俘二千余人而还	九月，西秦振武将军王基等在胡园戍地方袭击了北凉河西王沮渠蒙逊的部队，俘获二千余人而回
李恂在敦煌有惠政；索元绪粗险好杀，大失人和	西凉敦煌太守李恂在任时，对百姓有德政，深得民心，而北凉新派的太守索元绪粗暴凶狠、阴险嗜杀，大失人心
郡人宋承、张弘密信招恂	敦煌人宋承、张弘秘密写信给前太守李恂，请他回来主政
冬，恂帅数十骑入敦煌，元绪东奔凉兴	这年冬季，李恂率领骑兵数十人进入敦煌，索元绪向东逃往凉兴
承等推恂为冠军将军、凉州刺史，改元永建	宋承等推举李恂为冠军将军、凉州刺史，改年号为永建
河西王蒙逊遣世子政德攻敦煌，恂闭城不战	北凉河西王沮渠蒙逊派遣世子沮渠政德进攻敦煌，李恂等紧闭城门，不出来应战
十二月，丁亥，杏城羌酋狄温子帅三千余家降魏	十二月，丁亥，夏国所属杏城羌族部落酋长狄温子，率三千余家背叛夏国，投奔北魏
春，正月，辛酉，上祀南郊，大赦	春季，正月，辛酉，刘宋武帝到南郊圜丘，祭祀天神，大赦天下
以扬州刺史庐陵王义真为司徒，尚书仆射徐羡之为尚书令、扬州刺史，中书令傅亮为尚书仆射	刘宋武帝任命扬州刺史庐陵王刘义真为司徒，尚书仆射徐羡之为尚书令、扬州刺史，中书令傅亮为尚书仆射
辛未，魏主嗣行如公阳	辛未，北魏国主拓跋嗣一行前往公阳
河西王蒙逊帅众二万攻李恂于敦煌	北凉河西王沮渠蒙逊亲自率兵二万人攻打西凉李恂所据守的敦煌
三月，甲子，魏阳平王熙卒	三月，甲子，北魏阳平王拓跋熙去世
魏主发代都六千人筑苑，东包白登，周三十余里	北魏国主拓跋嗣征调代郡百姓六千人兴筑御花园，东面包括白登，周围三十余里
夏，四月，己卯朔，诏所在淫祠自蒋子文以下皆除之；其先贤及以勋德	夏季，四月，己卯朔，刘宋武帝下诏：所有不正规的祠庙，
六月，乙酉，魏主北巡至蟠羊山；秋，七月，西巡至河	六月，乙酉，北魏国主拓跋嗣向北巡视，抵达蟠羊山；秋季，七月，拓跋嗣又向西巡视，抵达黄河
河西王蒙逊遣右卫将军沮渠鄯善、建节将军沮渠苟生帅众七千伐秦	北凉河西王沮渠蒙逊派遣右卫将军沮渠鄯善、建节将军沮渠苟生率军七千人攻打西秦
秦王炽磐遣征北将军木弈干等帅步骑五千拒之，败鄯善等于五涧，虏苟生，斩首二千而还	西秦王乞伏炽磐派遣征北将军乞伏木弈干等率领步、骑兵五千人抵抗北凉军队的进攻，在五涧大败沮渠鄯善的军队，生擒沮渠苟生，斩首二千人，班师告捷
庚戌，魏主还宫	庚戌，北魏国主拓跋嗣回宫
己亥，魏主如代	己亥，北魏国主拓跋嗣前往代郡
十二月，丙申，魏主西巡，至云中	十二月，丙申，北魏国主拓跋嗣视察西部边防，抵达云中
秦王炽磐遣征西将军孔子等帅骑二万击契汗秃真于罗川	西秦王乞伏炽磐派遣征西将军乞伏孔子等率领骑兵二万人，袭击匈奴部落酋长契汗秃真据守的罗川
河西王蒙逊所署晋昌太守唐契据郡叛，蒙逊遣世子政德讨之	北凉河西王沮渠蒙逊所属的晋昌太守唐契据郡叛变，沮渠蒙逊派遣其世子沮渠政德讨伐叛军
契，瑶之子也	唐契是唐瑶的儿子
春，正月，甲辰朔，魏主自云中西巡，至屋窦城	春季，正月，甲辰朔，北魏国主拓跋嗣从云中出发继续向西巡视，抵达屋窦城
癸丑，以徐羡之为司空、录尚书事，刺史如故	癸丑，刘宋武帝任命徐羡之为司空、录尚书事，继续兼任扬州刺史
江州刺史王弘为卫将军、开府仪同三司；中领军谢晦为领军将军兼散骑常侍，入直殿省，总统宿卫	任命江州刺史王弘为卫将军、开府仪同三司；中领军谢晦为领军将军兼散骑常侍，入宫值班，总管宫廷安全保卫事务
徐羡之起自布衣，又无术学，直以志力局度，一旦居廊庙，朝野推服，咸谓有宰臣之望	徐羡之由平民起家，又没有学问，但有很大的志向和气度，一旦居于高位，掌理国家大权，朝野上下，都推崇佩服，都认为他有宰相的声望
沈密寡言，不以忧喜见色；颇工奕棋，观戏，常若未解，当世倍以此推之	徐羡之平时沉默寡言，喜怒不形于色，精于奕棋，但观看别人对局，又好像什么都不懂，当时的人因此加倍推崇他
傅亮、蔡廊常言：徐公晓万事，安异同	傅亮、蔡廓常说：徐公通晓万事，善于调解纠纷
尝与傅亮、谢晦宴聚，亮、晦才学辩博，羡之风度详整，时然后言	徐羡之曾经与傅亮、谢晦酒筵欢聚，傅亮、谢晦才学渊博，善于辞辩，徐羡之风度庄重严肃，在适当的时候才发言
郑鲜之叹曰：观徐、傅言论，不复以学问为长	奉常官郑鲜之曾叹息地说：观察徐羡之、傅亮的言论，已经不再是以学问见长了
二月，丁丑，诏分豫州淮以东为南豫州，治历阳，以彭城王义康为刺史	二月，丁丑，刘宋武帝下诏，分割豫州淮河以东土地为南豫州，州治设在历阳，任命彭城王刘义康为南豫州刺史
又分荆州十郡置湘州，治临湘，以左卫将军张为刺史	又分割荆州十个郡，建立湘州，州治设在临湘，任命左卫将军张为湘州刺史
丙戌，魏主还宫	丙戌，北魏国主拓跋嗣回宫
三月，上不豫，太尉长沙王道怜、司空徐羡之、尚书仆射傅亮、领军将军谢晦、护军将军檀道济并入侍医药	三月，刘宋武帝病重，太尉长沙王刘道怜、司空徐羡之、尚书仆射傅亮、领军将军谢晦、护军将军檀道济一道进宫，侍侯刘裕治疗服药
群臣请祈祷神祗，上不许，唯使侍中谢方明以疾告宗庙而已	朝中大臣们请求向神灵祈祷，刘裕不许，只派侍中谢方明到宗庙焚香，把病情向祖先报告
上性不信奇怪，微时多符瑞，及贵，史官审以所闻，上拒而不答	刘裕一向不信神怪，当他还是一个平民的时候，曾有许多祥兆，等到后来大贵，史官们向他查证传闻，刘裕都拒而不答
帝疾瘳，己未，大赦	刘宋武帝大病稍愈，己未，大赦天下
秦、雍流民南入梁州；庚申，遣使送绢万匹，且漕荆、雍之谷以赈之	秦州、雍州逃难的流民南下进入了刘宋所辖的梁州；庚申，刘宋武帝派遣使臣送一万匹绢，并且将荆州、雍州二处的谷米漕运到梁州，赈济那里的流民
刁逵之诛也，其子弥亡命	当初，刁逵伏诛，他的儿子刁弥逃亡
辛酉，弥帅数十人入京口，太尉留府司马陆仲元击斩之	辛酉，刁弥率领数十人攻入京口，太尉留府司马陆仲元迎击，并斩杀了刁弥
乙丑，魏河南王曜卒	乙丑，北魏河南王拓跋曜去世
夏，四月，甲戌，魏立皇子焘为太平王，拜相国，加大将军；丕为乐平王，弥为安定王，范为乐安王，健为永昌王，崇为建宁王，俊为新兴王	夏季，四月，甲戌，北魏国主拓跋嗣封皇子拓跋焘为太平王，拜授相国，加授大将军；封皇子拓跋丕为乐平王、拓跋弥为安定王、拓跋范为乐安王、拓跋健为永昌王、拓跋崇为建宁王、拓跋俊为新兴王
乙亥，诏封仇池公杨盛为武都王	乙亥，刘宋武帝下诏封仇池公杨盛为武都王
秦王炽磐以折冲将军乞伏是辰为西胡校尉，筑列浑城于汁罗以镇之	西秦王乞伏炽磐，任命折冲将军乞伏是辰为西胡校尉，并在汁罗兴筑列浑城对胡人加以镇抚
戊子，长沙景王道怜卒	戊子，长沙景王刘道怜去世
魏建义将军刁雍寇青州，州兵击破之	北魏建义将军刁雍进犯刘宋的青州，青州守兵击退了敌人的进攻
雍收散卒，走保大乡山	刁雍于是收集残兵，逃入大乡山自保
秋，七月，己酉，葬武皇帝于初宁陵，庙号高祖	秋季，七月，己酉，刘宋在初宁陵安葬了武帝刘裕，庙号高祖
河西王蒙逊遣前将军沮渠成都帅众一万，耀兵岭南，遂屯五涧	北凉河西王沮渠蒙逊派遣前将军沮渠成都，率军一万人，到岭南显示武力，然后大军屯驻在五涧
九月，秦王炽磐遣征北将军出连虔等帅骑六千击之	九月，西秦王乞伏炽磐，派遣征北将军出连虔等，率领骑兵六千人袭击沮渠成都的部队
乙巳，魏主如南宫，遂如广宁	乙巳，北魏国主拓跋嗣抵达南宫，又前往广宁
辛亥，魏人筑平城外郭，周围三十二里	辛亥，北魏在平城兴筑外城，周围三十二里
魏主如乔山	北魏国主拓跋嗣抵达乔山，再东行到达幽州
遂东如幽州；冬，十月，甲戌，还宫	冬季，十月，甲戌，回宫
秦出连虔与河西沮渠成都战，禽之	西秦征北将军出连虔，与河西沮渠成都交战，生擒沮渠成都
十一月，魏太子焘将兵出屯塞上，使安定王弥与安同居守	十一月，北魏国太子拓跋焘率军出京，在塞上屯聚军队，命令安定王拓跋弥和北新公安同留守京师
秦王炽磐征秦州牧昙达为左丞相、征东大将军	西秦王乞伏炽磐，召回秦州牧乞伏昙达，任命他为左丞相、征东大将军
春，正月，己亥朔，大赦，改元	春季，正月，己亥朔，刘宋大赦天下，改年号为景平
辛丑，帝祀南郊	辛丑，刘宋少帝刘义符到南郊祭祀天神
庚申，檀道济军于彭城	庚申，刘宋檀道济的大军驻扎在彭城
柔然寇魏边	柔然汗国南下侵略北魏的边境
二月，戊辰，魏筑长城，自赤城西至五原，延袤二千余里，备置戍卒，以备柔然	二月，戊辰，北魏兴筑长城，从赤城往西直到五原，连绵二千余里，同时在边境各要塞配备戍卒，以抵御柔然
丁丑，太皇太后萧氏殂	丁丑，刘宋太皇太后萧氏去世
河西王蒙逊及吐谷浑王阿柴皆遣使入贡	北凉河西王沮渠蒙逊和吐谷浑王慕容阿柴都派遣使臣向刘宋进贡
庚辰，诏以蒙逊为都督凉・秦・河・沙四州诸军事、骠骑大将军、凉州牧、河西王；以阿柴为督塞表诸军事、安西将军、沙州刺史、浇河公	庚辰，刘宋下诏，任命沮渠蒙逊为都督凉、秦、河、沙四州诸军事及骠骑大将军、凉州牧、河西王；任命慕容阿柴为督塞表诸军事、安西将军、沙州刺史、浇河公
三月，壬子，葬孝懿皇后于兴宁陵	三月，壬子，刘宋在兴宁陵安葬孝懿皇后
魏奚斤、公孙表等共攻虎牢，魏主自邺遣兵助之	北魏大将奚斤、公孙表等合兵进攻虎牢，北魏国主拓跋嗣从邺城遣兵助战
毛德祖于城内穴地入七丈，分为六道，出魏围外；募敢死之士四百人，使参军范道基等帅之，从穴中出，掩袭其后	刘宋司州刺史毛德祖，在虎牢城内挖掘地道，深达七丈，分为六道，直通魏军的包围圈外
魏军惊扰，斩首数百级，焚其攻具而还	同时又招募敢死勇士四百人，由参军范道基率领，从地道爬出去袭击敌人的后背，北魏军队不胜惊慌
魏兵虽退散，随复更合，攻之益急	范道基斩杀敌人数百，然后焚毁了敌人攻城的器械，返回城中
	北魏兵虽然暂时溃散，很快又集结到一起，更
蛮王梅安帅渠帅数十人入贡于魏	中原蛮族首领梅安率领手下将帅数十人，向北魏进贡
初，诸蛮本居江、淮之间，其后种落滋蔓，布于数州，东连寿春，西通巴、蜀，北接汝、颍，往往有之	最初，各个蛮族部落本来居住在淮河、长江之间地带，后来部落人口增长很快，使蛮族人的势力遍布数州，东连寿春，西达巴、蜀，北到汝水、颍水，到处都有
在魏世不甚为患；及晋，稍益繁昌，渐为寇暴	在曹魏时期，为患还不太大；到了晋朝，蛮族更加繁盛，于是渐渐变成强大的强盗势力
及刘、石乱中原，诸蛮无所忌惮，渐复北徙，伊阙以南，满于山谷矣	等到刘曜、石勒等南侵大乱中原时，这些蛮族部落更加肆无忌惮，又逐渐向北迁徙，于是，伊阙以南的地区，山间谷底遍布的全是蛮人
秦王炽磐谓其群臣曰：今宋虽奄有江南，夏人雄据关中，皆不足与也	西秦王乞伏炽磐，对他的文武百官说：现在宋虽然拥有江南，夏国雄据关中，都没有什么了不起
独魏主奕世英武，贤能为用，谶云，恒代之北当有真人，吾将举国而事之	唯独魏主，世代英明威武，能任用贤才，而且谶书说：恒山及代郡之北，一定有真龙天子，我将统率全国官民，事奉魏主
乃遣尚书郎莫者阿胡等入见于魏，贡黄金二百斤，并陈伐夏方略	于是，乞伏炽磐派遣尚书郎莫者阿胡等人，前往北魏朝见，进贡黄金二百斤，并呈献讨伐夏国方略
徐羡之兄子吴郡太守佩之颇豫政事，与侍中王韶之、程道惠、中书舍人邢安泰、潘盛结为党友	徐羡之的侄儿、吴郡太守徐佩之经常干预朝廷政事，与侍中王韶之、程道惠，中书舍人邢安泰、潘盛，结成党羽
时谢晦久病，不堪见客	当时谢晦一直患病，不能接见宾客
佩之等疑其诈疾，有异图，乃称羡之意以告傅亮，欲令亮作诏诛之	徐佩之怀疑谢晦装病，另有阴谋，于是他声称这是徐羡之的想法，把它告诉了傅亮，想要让傅亮草拟诏书，诛杀谢晦
亮曰：我等三人同受顾命，岂可自相诛戮	傅亮说：我们三人共同接受先帝遗诏，怎么可以自相残杀
诸君果行此事，亮当角巾步出掖门耳	你们一定要这样做，我只好换上平民衣服，徒步走出宫城侧门
佩之等乃止	徐佩之一伙才罢休
五月，魏主还平城	五月，北魏国主拓跋嗣返回平城
六月，己亥，魏宜都文成王穆观卒	六月，己亥，北魏宜都文成王穆观去世
丙辰，魏主北巡，至参合陂	丙辰，北魏国主向北视察，抵达参合陂
秋，七月，尊帝母张夫人为皇太后	秋季，七月，刘宋少帝尊母亲张夫人为皇太后
冬，十月，癸卯，魏人广西宫外垣，周二十里	冬季，十月，癸卯，北魏扩建平城西宫外墙，周围长二十里
十一月，魏周几寇许昌，许昌溃，颍川太守李元德奔项	十一月，北魏将军周几进攻许昌，许昌城崩溃，刘宋颍川太守李元德逃奔项城
戊辰，魏人围汝阳，汝阳太守王公度亦奔项	戊辰，北魏军围攻汝阳，刘宋汝阳太守王公度也逃到项城
刘粹遣其将姚耸夫等将兵助守项城	于是，刘宋豫州刺史刘粹派遣将领姚耸天等率兵增援，固守项城
魏人夷许昌城，毁钟城，以立封疆而还	北魏军夷平了许昌城，毁坏了钟城的城墙，确定魏宋新的边界，然后便回去了
己巳，魏太宗殂	己巳，北魏国主拓跋嗣去世
壬申，世祖即位，大赦	壬申，太子拓跋焘登极，大赦天下
春，正月，魏改元始光	春季，正月，北魏改年号为始光
丙寅，魏安定殇王弥卒	丙寅，北魏安定殇王拓跋弥去世
夏，四月，甲辰，魏主东巡大宁	夏季，四月，甲辰，北魏国主拓跋焘向东巡视，抵达大宁
秦王炽磐遣镇南将军吉毗等帅步骑一万南伐白苟、车孚、崔提、旁为四国，皆降之	西秦王乞伏炽磐派遣镇南将军乞伏吉毗等，率领步、骑兵共一万人，向南讨伐白苟、车孚、崔提、旁为等四个部族，全部降服
魏主还宫	北魏国主拓跋焘回宫
秦王炽磐遣太子暮末帅征北将军木弈干等步骑三万出貂渠谷，攻河西白草岭、临松郡，皆破之，徙民二万余口而还	西秦王乞伏炽磐派遣太子乞伏暮末率征北将军木弈干等以及步、骑兵三万人向貂渠谷出击，进攻北凉的白草岭和临松郡，秦军都攻破这几个地方，俘虏居民二万余人而还
八月，丙申，宜都王至建康，群臣迎拜于新亭	八月，丙申，宜都王刘义隆抵达京师建康，朝廷文武百官都赶赴新亭迎接叩拜
徐羡之问傅亮曰：王可方谁	徐羡之问傅亮说：宜都王可以比历史上的谁
亮曰：晋文、景以上人	傅亮说：比晋文帝，景帝还要高明
羡之曰：必能明我赤心	徐羡之说：他一定明白我们的一片忠心
亮曰：不然	傅亮说：未必
诏拜营阳王母张氏为营阳太妃	刘宋文帝下诏，封营阳王的母亲张氏为营阳太妃
林邑王范阳迈寇日南、九德诸郡	林邑王范阳迈，进犯刘宋日南、九德等郡
夏主将废太子而立少子酒泉公伦	夏王赫连勃勃，准备废黜太子赫连而改立幼子酒泉公赫连伦
闻之，将兵七万北伐伦	赫连听到这个消息，立即率兵七万人北上进攻赫连伦
伦将骑三万拒之，战于高平，伦败死	赫连伦率兵三万人迎击，双方在高平大战
伦兄太原公昌将骑一万袭，杀之，并其众八万五千，归于统万	赫连伦兵败身死
夏主大悦，立昌为太子	赫连伦的同胞兄、太原公赫连昌率骑兵一万人袭击赫连的大军，斩杀赫连，收服了他的部众八万五千人，回到国都统万，夏王大喜，封赫连昌为太子
己卯，魏主还平城	己卯，北魏国主拓跋焘返回平城
丁巳，魏以长孙嵩为太尉，长孙翰为司徒，奚斤为司空	丁巳，北魏国主拓跋焘任命长孙嵩为太尉，长孙翰为司徒，奚斤为司空
夏，四月，秦王炽磐遣平远将军叱卢犍等袭河西镇南将军沮渠白蹄于临松，擒之，徙其民五千余户于罕	夏季，四月，西秦王乞伏炽磐派遣平远将军叱卢犍等袭击北凉国镇南将军沮渠白蹄镇守的临松，擒获沮渠白蹄，把临松五千余户居民强行迁徙到罕
魏主遣龙骧将军步堆等来聘，始复通好	北魏国主拓跋焘派遣龙骧将军步堆等前来刘宋访问，两国又恢复了友好关系
秋，七月，秦王炽磐遣镇南将军吉毗等南击黑水羌酋丘担，大破之	秋季，七月，西秦王乞伏炽磐派镇南将军乞伏吉毗等，南下袭击黑水羌族部落酋长丘担，大败丘担的军队
王弘自以始不预定策，不受司空；表让弥年，乃许之	王弘因最初未能参与废黜少帝、拥戴文帝的政变，因此不接受司空一职的任命，不断地呈上奏章，辞让了一年，文帝才下诏批准
乙酉，以弘为车骑大将军、开府仪同三司	乙酉，宋文帝任命王弘为车骑大将军、开府仪同三司
十一月，以武都世子玄为北秦州刺史、武都王	十一月，刘宋任命武都惠文王杨盛的世子杨玄为北秦州刺史和武都王
秦王炽磐复遣使如魏，请用师于夏	西秦王乞伏炽磐，再次派使臣前往北魏，请求对夏国采取军事行动
初，袁皇后生皇子劭，后自详视，使驰白帝曰：此儿形貌异常，必破国亡家，不可举	最初，刘义隆的皇后袁氏，生下皇子刘劭以后，端详婴儿良久，派人飞快报告刘义隆，说：此儿相貌异常，将来一定会弄得国破家亡，不能养他
即欲杀之	就要动手把婴儿弄死
帝狼狈至后殿户外，手拨幔禁之，乃止	刘义隆急急忙忙赶到后殿门外，用手拨开门帘阻止，这才留下刘劭一命
以尚在谅暗，故秘之	只是在为父亲守丧期间生子，违犯礼教，所以一直保密
闰月，丙戌，始言劭生	闰正月，丙戌，才宣布皇子刘劭诞生
帝下诏戒严，大赦，诸军相次进路以讨谢晦	文帝下诏戒严，实行大赦，各路军队依次出发，讨伐谢晦
晦以弟遁为竟陵内史，将万人总留任，帅众二万发江陵，列舟舰自江津至于破冢，旌旗蔽日	谢晦任命他的弟弟谢遁为竟陵内史，率领一万人留守江陵
叹曰：恨不得以此为勤王之师	他自己则亲自率兵二万人从江陵出发，他指挥的战舰，从江津一直排列到破冢，旌旗招展，遮天蔽日，谢晦长叹一声，说：真恨不得这是一支保护皇家的大军
诏殿中将军吉恒聘于魏	刘宋文帝下诏，派殿中将军吉恒出使北魏
燕太子永卒，立次子翼为太子	北燕太子冯永去世，封次子冯翼为太子
秦王炽磐伐河西，至廉川，遣太子暮末等步骑三万攻西安，不克，又攻番禾	西秦王乞伏炽磐讨代北凉，大军抵达廉川，乞伏炽磐派遣太子乞伏暮末等率领步、骑兵共三万人，进攻西安，不能攻克，于是又转攻番禾
河西王蒙逊发兵御之，且遣使说夏主，使乘虚袭罕	北凉河西王沮渠蒙逊出军迎战，极力抵御，同时又派使臣出使夏国游说，请夏国国主赫连昌乘西秦国内空虚之际，袭击西秦的都城罕
夏主遣征南大将军呼卢古将骑二万攻苑川，车骑大将军韦伐将骑三万攻南安	夏国国主赫连昌派遣征南大将军呼卢古率领骑兵二万人，进攻西秦的苑川；派车骑大将军韦伐率领骑兵三万人，进攻南安
炽磐闻之，引归	西秦国王乞伏炽磬听到这个消息，立即从北凉撤军回国
九月，徙其境内老弱、畜产于浇河及莫河仍寒川，留左丞相昙达守罕	九月，乞伏炽磐把境内的老弱妇孺和家畜，集中迁徙到浇河郡和莫河的仍寒川，同时又命令左丞相乞伏昙达留守京师罕
韦伐攻拔南安，获秦秦州刺史翟爽、南安太守李亮	夏国的车骑大将军韦伐率众攻陷南安城，生擒西秦秦州刺史翟爽和南安太守李亮
吐谷浑握逵等帅部众二万落叛秦，奔昴川，附于吐谷浑王慕	隶属西秦的吐谷浑部落酋长慕容握逵率所属二万帐落背叛西秦，逃到昂川，归附了吐谷浑可汗慕容慕
大旱，蝗	天下大旱，出现蝗灾
左光禄大夫范泰上表曰：妇人有三从之义，无自专之道	刘宋左光禄大夫范泰上疏说：女子有三从的大义，而没有自作主张的道理
谢晦妇女犹在尚方，唯陛下留意	现在谢晦家的妇女仍被羁押在尚方作坊里做苦工，敬请陛下留意
有诏原之	于是，刘宋文帝下诏赦免了她们
仇池氐杨兴平求内附	仇池氐族部落酋长杨兴平请求归附刘宋
梁、南秦二州刺史吉翰遣始平太守庞谘据武兴	刘宋梁州、南秦州二州刺史吉翰派始平太守庞谘进军占据武兴
氐王杨玄遣其弟难当将兵拒谘，谘击走之	氐王杨玄派他的弟弟杨难当率军迎击庞谘，被庞谘击退
营阳太妃张氏卒	刘宋营阳太妃张氏去世
秦征南将军吉毗镇南，陇西人辛澹帅户三千据城逐毗，毗走还罕，澹南奔仇池	西秦征南将军乞伏吉毗镇守南，陇西人辛澹率领部众三千户占据南城，驱逐乞伏吉毗，乞伏吉毗逃回罕，辛澹向东南撤退，逃往仇池
春，正月，辛己，帝祀南郊	春季，正月，辛己，刘宋文帝前往都城建康南郊，祭祀天神
乙酉，魏主还平城	乙酉，北魏国主拓跋焘回到平城
统万徙民在道多死，能至平城者什才六七	从统万强行迁徙的民户在途中死亡甚多，能到达平城的，不过十分之六七
魏主还平城	北魏国主拓跋焘回到平城
二月，丙子，魏主遣高凉王礼镇长安	二月，丙子，北魏国主拓跋焘亲自委派高凉王拓跋礼镇守长安
礼，斤之孙也	拓跋礼是拓跋斤的孙子
又诏执金吾桓贷造桥于君子津	同时又下诏命令执金吾桓贷在君子津建造大桥
丁丑，魏广平王连卒	丁丑，北魏广平王拓跋连去世
丁亥，帝还建康	丁亥，刘宋文帝刘义隆返回建康
戊子，尚书右仆射郑鲜之卒	戊子，刘宋尚书右仆射郑鲜之去世
秦王炽磐以辅国将军段晖为凉州刺史，镇乐都；平西将军景为沙州刺史，镇西平；宁朔将军出连辅政为梁州刺史，镇赤水	西秦王乞伏炽磐任命辅国将军段晖为凉州刺史，驻守乐都；任命平西将军景为沙州刺史，镇守西平；又命宁朔将军出连辅政为梁州刺史，坐镇赤水
夏，四月，丁未，魏员外散骑常侍步堆等来聘	夏季，四月，丁未，北魏特使员外散骑常侍步堆等前往刘宋访问
庚戌，以廷尉王徽之为交州刺史，征前刺史杜弘文	庚戌，刘宋任命廷尉王徽之为交州刺史，征召前交州刺史杜弘文回京
弘文有疾，自舆就路；或劝之待病愈，弘文曰：吾杖节三世，常欲投躯帝庭，况被征乎	当时杜弘文正患重病，得到命令后，亲自备车上路，有人劝告他等病稍好些再走，杜弘文说：我家祖孙三代镇守边陲，平时就渴望到京城去，何况今日又得到征召
遂行，卒于广州	于是，杜弘文抱病启程，走到广州去世
弘文，慧度之子也	杜弘文是杜慧度的儿子
魏奚斤与夏平原公定相持于长安	北魏司空奚斤跟夏国的平原公赫连定在长安对峙
魏主欲乘虚伐统万，简兵练士，	北魏国主拓跋焘打算乘夏国后方空虚，攻打夏国的都城统万，于是，挑选精兵，严格
壬午，中护军王华卒	壬午，刘宋中护军王华去世
魏主至统万，分军伏于深谷，以少众至城下	北魏国主拓跋焘抵达统万，大军分别埋伏在深谷之中，只派少数部队来到城下
夏将狄子玉降魏，言：夏主闻有魏师，遣使召平原公定，定曰：统万坚峻，未易攻拔	夏国的大将狄子玉投降了北魏，他向拓跋焘报告说：夏王赫连昌听说北魏大军将到，就派人征召平原公赫连定回军，赫连定说：统万城
秦王炽磐还罕	西秦王乞伏炽磐回到罕城
秋，七月，己卯，魏主至柞岭	秋季，七月，己卯，北魏国主拓跋焘抵达柞岭
柔然寇云中，闻魏已克统万，乃遁去	当时，柔然汗国正在进犯云中，他们听说北魏的军队已经攻克了统万，才撤退北逃
秦王炽磐谓群臣曰：孤知赫连氏必无成，冒险归魏，今果如孤言	西秦王乞伏炽磐对他手下的文武群臣说：我早就知道赫连氏必定不会成大气候，才冒险归降了北魏，现在发生的一切都应验了我的预言
八月，遣其叔父平远将军渥头等入贡于魏	八月，乞伏炽磐派他的叔父、平远将军乞伏渥头等人到北魏朝拜进贡
壬子，魏主还至平城，以所获颁赐留台百官有差	壬子，北魏国主拓跋焘返抵平城，把缴获的战利品按等级分别赏赐给留守的文武百官
九月，丁酉，安定民举城降魏	九月，丁酉，夏国所属的安定城居民献出城池，投降北魏
十二月，秦梁州刺史吴汉为群羌所攻，帅户二千还于罕	十二月，西秦梁州刺史吴汉遭到羌族各部落的攻击，率领二千户部属返回罕
魏主行如中山；癸卯，还平城	北魏国主拓跋焘出巡，前往中山；癸卯，返回平城
春，正月，辛未，魏京兆王黎卒	春季，正月，辛未，北魏京兆王拓跋黎去世
荆州刺史、彭城王义康，性聪察，在州职事修治	刘宋荆州刺史、彭城王刘义康，生性聪明，详察下情，他在荆州，凡是职权范围内的事都办得很好
左光禄大夫范泰谓司徒王弘曰：天下事重，权要难居	刘宋左光禄大夫范泰对司徒王弘说：国家大事，责任很重，权要的地位，也很难久居
卿兄弟盛满，当深存降挹	你们兄弟的权力和地位，已经达到了顶峰，应该深深地想到要谦虚谨慎
彭城王，帝之次弟，宜征还入朝，共参朝政	彭城王刘义康是皇上的二弟，最好征召他回京，共同参与处理朝廷大事
弘纳其言	王弘接受了范泰的劝告
时大旱、疾疫，弘上表引咎逊位，帝不许	当时，刘宋境内正遭受严重的旱灾，瘟疫流行，王弘上疏引咎自责，请求解除自己的职务，宋文帝刘义隆没有批准
魏改元神	北魏改年号为神
五月，秦文昭王炽磐卒，太子暮末即位，大赦，改元永弘	五月，西秦王乞伏炽磐去世，太子乞伏暮末继承王位，大赦天下，改年号为永弘
平陆令河南成粲复劝王弘逊位，引从之，累表陈请	刘宋平陆县令、河南人成粲再度劝司徒王弘退位，王弘采纳了他的建议，一再上疏，坚决请求辞去职务
帝不得已，六月，庚戌，以弘为卫将军、开府仪同三司	刘宋文帝不得已，六月，庚戌，调任王弘为卫将军、开府仪同三司
甲寅，魏主如长川	甲寅，北魏国主拓跋焘抵达长川
葬秦文昭王于武平陵，庙号太祖	西秦国在武平陵安葬了文昭王乞伏炽磐，庙号太祖
秦王暮末以右丞相元基为侍中、相国、都督中外诸军、录尚书事，以镇军大将军、河州牧谦屯为骠骑大将军，征安北将军、凉州刺史段晖为辅国大将军、御史大夫，叔父右禁将军千年为镇北将军、凉州牧，镇湟河，以征北将军木弈干为尚书令、车骑大将军，以征南将军吉毗为尚书仆射、卫大将军	西秦王乞伏暮末任命右丞相乞伏元基为侍中、相国、都督中外诸军事、录尚书事等职务；同时任命镇军大将军、河州牧乞伏谦屯为骠骑大将军；征召安北将军、凉州刺史段晖为辅国大将军、御史大夫；任命叔父、右禁将军乞伏千年为镇北将军、凉州牧，镇守湟河；又任命征北将军乞伏木弈干为尚书令、车骑大将军；任命征南将军乞伏吉毗为尚书仆射、卫大将军
魏主还宫	北魏国主拓跋焘回宫
八月，复如广宁观温泉	八月，拓跋焘又前往广宁观赏温泉
徐州刺史王仲德遣步骑二千伐魏济阳、陈留	刘宋徐州刺史王仲德派遣步、骑兵二千人进攻北魏所属的济阳、陈留
魏主还宫	北魏国主拓跋焘回宫
十一月，乙未朔，日有食之	十一月，乙未朔，出现日食
河西王蒙逊伐秦，至磐夷，秦相国元基等将骑万五千拒之	北凉河西王沮渠蒙逊再次讨伐西秦，北凉军开到磐夷，遇到西秦相国乞伏元基率领骑兵一万五千人阻击
蒙逊还攻西平，征虏将军出连辅政等将骑二千救之	沮渠蒙逊率军回攻西平，西秦征虏将军出连辅政等率领骑兵二千人赶赴救援
魏镇远将军平舒侯燕凤卒	北魏镇远将军、平舒侯燕凤去世
夏酒泉公隽自平凉奔魏	夏国的酒泉公赫连隽从平凉出逃，投奔北魏
丁零鲜于台阳等请降于魏，魏主赦之	丁零部落酋长鲜于台阳等人，请求再次归降北魏，北魏国主拓跋焘赦免了他们的罪过
秦出连辅政等未至西平，河西王蒙逊拔西平，执太守承	西秦征虏将军出连辅政等率领援军还没有赶到西平，北凉王沮渠蒙逊已经攻陷了西平城，活捉了西平太守承
二月，秦王暮末立妃梁氏为皇后，子万载为太子	二月，西秦王乞伏暮末，立妃梁氏为王后，封王子乞伏万载为太子
三月，丁巳，立皇子劭为太子；戊午，大赦	三月，丁巳，下令大赦
夏，四月，癸亥，以尚书左仆射王敬弘为尚书令，临川王义庆为左仆射，吏部尚书济阳江夷为右仆射	夏季，四月，癸亥，刘宋文帝任命尚书左仆射王敬弘为尚书令；临川王刘义庆为左仆射；吏部尚书、济阳人江夷为右仆射
初，魏太祖命尚书邓渊撰《国记》十余卷，未成而止	当初，北魏道武帝拓跋，命令尚书邓渊撰写《国记》十余卷，书未写成就停止了
世祖更命崔浩与中书侍郎邓颖等续成之，为《国书》三十卷	于是，拓跋焘改命崔浩与中书侍郎邓颖等人继续编撰，称《国书》，共三十卷
颖，渊之子也	邓颖是邓渊的儿子
五月，壬辰朔，日有食之	五月，壬辰朔，出现日食
王敬弘固让尚书令，表求还东	王敬弘坚决辞让尚书令，上疏请求返回故乡会稽
癸巳，更以敬弘为侍中、特进、左光禄大夫，听其东归	癸巳，改任王敬弘为侍中、特进、左光禄大夫，准许他回到东边
丁未，魏主至漠南，舍辎重，帅轻骑兼马袭击柔然，至栗水	丁未，北魏皇帝拓跋焘抵达漠南，留下所有辎重，亲自率领轻骑兵和备用马匹袭击柔然汗国，大军很快逼近栗水
柔然纥升盖可汗先不设备，民畜满野，惊怖散去，莫相收摄	柔然汗国纥升盖可汗郁久闾大檀果然事先没有防备，原野上到处都有牲畜和放牧的人们，当他们发现北魏的大军突然袭来，惊慌失措各自逃散，根本无法集结
纥升盖烧庐舍，绝迹西走，莫知所之	纥升盖可汗只好放火焚烧房屋，向西逃走，没有人知道他的下落
其弟匹黎先主东部，闻有魏寇，帅众欲就其兄；遇长孙翰，翰邀击，大破之，杀其大人数百	纥升盖可汗的弟弟郁久闾匹黎先主持东部的防务，听说北魏的军队大举攻来，立即召集他的部众打算向他的哥哥靠拢；刚刚出发，就与北魏平阳王长孙翰的军队遭遇，长孙翰拦截并袭击了郁久闾匹黎先及其部队，大破柔然军，斩杀他们酉长等头目数百人
夏主欲复取统万，引兵东至侯尼城，不敢进而还	夏王赫连定打算收复统万城，他统率大军向东抵达侯尼城，不敢再向前进发，只好班师
河西王蒙逊伐秦，秦王暮末留相国元基守罕，迁保定连	北凉河西王沮渠蒙逊讨伐西秦，西秦王乞伏暮末命相国乞伏元基留守都城罕，他自己则退保定连城
柔然纥升盖可汗既走，部落四散，窜伏山谷，杂畜布野，无人收视	柔然汗国纥升盖可汗郁久闾大檀逃走以后，他的部落四处流散，躲藏在荒山深谷之中，牛马等牲畜遍布原野，没有人收集照料
魏主循栗水西行，至菟园水，分军搜讨，东西五千里，南北三千里，俘斩甚众	北魏国主拓跋焘沿着栗水一直向西行进，抵达菟园水，大军分散搜索柔然军残部，东西五千里，南北三千里，斩杀和俘虏的敌人很多
高车诸部乘魏兵势，钞掠柔然	高车国的部落，乘着北魏的兵势，攻打并掠夺柔然汗国
柔然种类前后降魏者三十余万落，获戎马百余万匹，畜产、车庐，弥漫山泽，亡虑数百万	这样一来，柔然汗国的各部落先后投降北魏的就有三十多万帐落，北魏军缴获的战马达一百多万匹，牲畜、车辆帐篷，遍布山谷水畔，大约有几百万之多
武都孝昭王杨玄疾病，欲以国授其弟难当	武都孝昭王杨玄患病不起，打算把王位传授给他的弟弟杨难当
难当固辞，请立玄子保宗而辅之，玄许之	杨难当坚决拒绝接受，请求立杨玄的儿子杨保宗继承大位，他自己辅佐侄子，杨玄同意
玄卒，保宗立	杨玄去世后，杨保宗继位
难当妻姚氏劝难当自立，难当乃废保宗，自称都督雍・凉・秦三州诸军事、征西大将军、开府仪同三司、秦州刺史、武都王	可是杨难当的妻子姚氏劝说杨难当自立为王，于是杨难当废黜了杨保宗，自封为都督雍州、凉州、秦州三州诸军事、征西大将军、开府仪同三司、秦州刺史和武都王
秦王暮末之弟轲殊罗于文昭王左夫人秃发氏，暮末知而禁之	西秦王乞伏暮末的弟弟乞伏轲殊罗与他父亲乞伏炽磐的遗孀、左夫人秃发氏通奸
轲殊罗惧，与叔父什寅谋杀暮末，奉沮渠兴国以奔河西	乞伏暮末得知此事后禁止他
使秃发氏盗门钥，钥误，门者以告暮末	乞伏轲殊罗惊恐不安，于是与他的叔父乞伏什寅策划谋杀乞伏暮末，然后带着沮渠兴国投奔北凉
暮末悉收其党，杀之，而赦轲殊罗	乞伏轲殊罗让秃发氏偷取寝殿的钥匙，不想却偷错了钥匙，守门人把情况报告给乞伏暮末，乞伏暮末逮捕了所有参与这项阴谋的同党，全部杀掉，只赦免了乞伏轲殊罗
执什寅，鞭之，什寅曰：我负汝死，不负汝鞭	乞伏暮末又逮捕叔父乞伏什寅，鞭打不止，乞伏什寅说：我欠你一命，但不欠你一顿鞭子
暮末怒，刳其腹，投尸于河	乞伏暮末大怒，剖开乞伏什寅的肚子，把他的尸体扔进河里
夏主少凶暴无赖，不为世祖所知	夏王赫连定小的时候就凶狠残暴，不务正业，武烈帝赫连勃勃不了解
是月，畋于阴，登苛蓝山，望统万城泣曰：先帝若以朕承大业者，岂有今日之事乎	本月，赫连定在阴守猎，他登上苛蓝山遥望统万城，痛哭不已，说：先帝如果早让我继承大业，怎么会有今天的事
十一月，己丑朔，日有食之，不尽如钩；星昼见，至晡方没，河北地暗	十一月，己丑朔，出现日食，太阳只剩下象钩一样的小部分；白天可见星辰，直到下午才发生日全食，黄河以北地区，一片黑暗
魏主西巡，至柞山	北魏国主拓跋焘向西巡视，抵达柞山
十二月，河西王蒙逊、吐谷浑王慕皆遣使入贡	十二月，北凉河西王沮渠蒙逊、吐谷浑可汗慕容慕都派使臣往刘宋进贡
是岁，魏内都大官中山文懿公李先、青・冀二州刺史安同皆卒	本年，北魏内都大官、中山文懿公李先以及青州、冀州二州刺史安同先后去世
先年九十五	李先卒年九十五岁
秦地震，野草皆自反	西秦发生地震，野草都根部朝天
春，正月，癸巳，以吐谷浑王慕为征西将军、沙州刺史、陇西公	春季，正月，癸巳，刘宋文帝任命吐谷浑可汗慕容慕为征西将军、沙州刺史，封为陇西公
二月，丁卯，魏阳平威王长孙翰卒	二月，丁卯，北魏阳平威王长孙翰去世
戊辰，魏主还宫	戊辰，北魏国主拓跋焘回宫
壬寅，魏封赫连昌为秦王	壬寅，北魏国主拓跋焘封被俘的前夏王赫连昌为秦王
秦乞伏什寅母弟前将军白养、镇卫将军去列，以什寅之死，有怨言，秦王暮末皆杀之	西秦国乞伏什寅的胞弟、前将军乞伏白养，镇卫将军乞伏去列二人对于乞伏什寅的死，深怀怨恨，口出怨言，被乞伏暮末先后杀死
夏，四月，甲子，魏主如云中	夏季，四月，甲子，北魏国主拓跋焘前往云中
六月，己卯，以氐王杨难当为寇军将军、秦州刺史、武都王	六月，己卯，刘宋朝廷任命氐王杨难当为冠军将军、秦州刺史，晋封武都王
魏主使平南大将军、丹阳王大毗屯河上，以司马楚之为安南大将军，封琅邪王，屯颍川以备宋	北魏国主拓跋焘命令平南大将军、丹阳王拓跋大毗驻防黄河北岸；任命司马楚之为安南大将军，封琅邪王，屯驻颍川来防备宋军的进攻
到彦之自淮入泗，水渗，日行才十里，自四月至秋七月，始至须昌	刘宋右将军到彦之率领大军从淮河进入泗水，天旱水浅，每天行军才十里，从四月出发一直到秋季七月，才抵达须昌
乃溯河西上	于是，进入黄河逆流而上
甲寅，林邑王范阳迈遣使入贡，自陈与交州不睦，乞蒙恕宥	甲寅，林邑国王范阳迈派遣使臣到刘宋进贡，承认与刘宋所属的交州有冲突，请求宽恕
燕太祖寝疾，召中书监申秀、侍中阳哲于内殿，属以后事	北燕王冯跋重病，征召中书监申秀、侍中阳哲来到寝殿嘱托后事
九月，病甚，辇而临轩，命太子翼摄国事，勒兵听政，以备非常	九月，冯跋病情加重，乘辇车到金銮殿，命令皇太子冯翼主持朝政，统率全国的军队，防止发生意外的变化
秦自正月不雨，至于九月，民流叛者甚众	西秦从正月以后，天旱无雨，直到九月，百姓流亡叛逃的人数很多
冬，十月，以竟陵王义宣为南徐州刺史，犹戍石头	冬季，十月，刘宋文帝任命竟陵王刘义宣为南徐州刺史，仍旧驻守石头
戊午，立钱署，铸四铢钱	戊午，刘宋设置钱币署，铸造四铢钱
到彦之、王仲德沿河置守，还保东平	刘宋右将军到彦之、安北将军王仲德沿黄河南岸布防之后，回守东平
壬辰，加征南大将军檀道济都督征讨诸军事，帅众伐魏	壬辰，刘宋加授征南大将军檀道济为都督征讨诸军事，统率大队人马讨伐北魏
戊戌，魏叔孙建攻竺灵秀于湖陆，灵秀大败，死者五千余人	戊戌，北魏寿光侯叔孙建，进攻刘宋兖州刺史竺灵秀据守的湖陆，竺灵秀大败，被斩杀的士卒达五千多人
建还屯范城	叔孙建得胜收兵，驻防范城
辛丑，魏安颉督诸军攻滑台	辛丑，北魏冠军将军安颉督率各路军队攻打滑台
丁卯，夏上谷公社干、广阳公度洛孤出降，魏克平凉	丁卯，夏国上谷公赫连社干、广阳公赫连度洛孤出城投降，北魏军攻克了平凉
春，正月，壬午朔，燕大赦，改元大兴	春季，正月，壬午朔，北燕大赦天下，改年号为大兴
二月，戊午，以尚书右仆射江夷为湘州刺史	二月，戊午，刘宋朝廷任命尚书右仆射江夷为湘州刺史
燕王立夫人慕容氏为王后	北燕王冯弘封夫人慕容氏为皇后
庚戌，魏安颉等还平城	庚戌，北魏安颉等人返回平城
魏主嘉朱之守节，妻以宗女	北魏国主拓跋焘非常赞赏刘宋滑台守将朱之的气节，把皇族宗室的女儿嫁给他
夏，五月，庚寅，魏主如云中	夏季，五月，庚寅，北魏国主拓跋焘前往云中
六月，乙丑，大赦	六月，乙丑，刘宋实行大赦
夏主杀乞伏暮末及其宗族五百人	夏王赫连定斩杀了被俘的西秦王乞伏暮末，以及西秦国皇族五百人
夏主畏魏人之逼，拥秦民十余万口，自治城济河，欲击河西王蒙逊而夺其地	夏王赫连定惧怕北魏的逼迫，劫持西秦国的老百姓十余万人，从治城渡过黄河，打算袭击北凉河西王沮渠蒙逊，夺取北凉的国土
吐谷浑王慕遣益州刺史慕利延、宁州刺史拾虔帅骑三万，乘其半济，邀击之，执夏主定以归，沮渠兴国被创而死	吐谷浑可汗慕容慕派遣益州刺史慕容慕利延、宁州刺史慕容拾虔统率三万骑兵，乘夏军渡河过了一半，截击敌人，生擒了夏王赫连定，乘胜班师，沮渠兴国受重伤而死
拾虔，树洛干之子也	慕容拾虔是慕容树洛干的儿子
魏之边吏获柔然逻者二十余人，魏主赐衣服而遣之	北魏边防官员，俘获柔然汗国的巡逻兵二十余人，拓跋焘赏赐给他们衣服，释放了他们
柔然感悦	柔然人又感动又喜悦
闰月，乙未，柔然敕连可汗遣使诣魏，魏主厚礼之	闰月，乙未，柔然汗国敕连可汗，派使臣出使北魏，北魏国主拓跋焘用优厚的礼节招待了他们
魏主遣散骑侍郎周绍来聘，且求昏；帝依违答之	北魏国主拓跋焘派散骑侍郎周绍出使刘宋，并且请求通婚，刘宋文帝含糊其辞地给以回答
秋，七月，己酉，魏主如河西	秋季，七月，己酉，北魏国主拓跋焘前往河西
八月，乙酉，河西王蒙逊遣子安周入侍于魏	八月，乙酉，北凉河西沮渠蒙逊派他的儿子沮渠安周前往北魏充当人质
吐谷浑王慕遣侍郎谢太宁奉表于魏，请送赫连定	吐谷浑可汗慕容慕，派侍郎谢太宁，出使北魏，呈上奏章，表示愿意献出所俘虏的夏王赫连定
已丑，魏以慕为大将军、西秦王	己丑，北魏任命吐谷浑可汗慕容慕为大将军，封为西秦王
是岁，凉王改元义和	本年，北凉改年号为义和
林邑王范阳迈寇九德，交州兵击却之	林邑王范阳迈，攻击刘宋的九德郡，刘宋交州军队击退了他们
燕王立慕容后之子王仁为太子	北燕王冯弘封慕容皇后的儿子冯王仁为太子
三月，庚戌，卫将军王弘进位太保，加中书监	三月，庚戌，刘宋卫将军王弘晋升为太保，加授中书监
丁巳，征南大将军檀道济进位司空，还镇寻阳	丁巳，征南大将军檀道济晋升为司空，回寻阳镇守
魏主治兵于南郊，谋伐燕	北魏国主拓跋焘，在京师南郊训练兵马，准备攻打北燕
帝遣使者赵道生聘于魏	刘宋文帝派遣使者赵道生前往北魏访问
六月，戊寅，司徒、南徐州刺史彭城王义康改领扬州刺史	六月，戊寅，刘宋司徒、南徐州刺史、彭城王刘义康改任扬州刺史
诏分青州置冀州，治历城	刘宋文帝下诏，把青州分割出一部分，设置冀州，州治在历城
吐谷浑王慕遣其司马赵叙入贡，且来告捷	吐谷浑汗国可汗慕容慕派司马赵叙到刘宋进贡，并奏报军事上的大捷
庚寅，魏主伐燕	庚寅，北魏国主拓跋焘亲自率军进攻北燕
命太子晃录尚书事，时晃才五岁	拓跋焘任命太子拓跋晃为录尚书事，当时拓跋晃只有五岁
又遣左仆射安原、建宁王崇等屯漠南以备柔然	拓跋焘又派左仆射安原、建宁王拓跋崇等人驻防漠南，准备抵御柔然汗国的进攻
辛卯，魏主遣散骑常侍邓颖来聘	辛卯，北魏国主拓跋焘派散骑常侍邓颖出使刘宋，进行回访
秋，七月，已未，魏主至濡水	秋季，七月，己未，北魏国主拓跋焘率军抵达濡水
庚申，遣安东将军奚斤发幽州民及密云丁零万余人，运攻具，出南道，会和龙	庚申，拓跋焘派安东将军奚斤征发幽州百姓和密云境内的丁零部落一万余人，运送攻城器具，通过南道，与北魏大军在北燕都城和龙城下会师
魏主至辽西，燕主遣其侍御史崔聘奉牛酒犒师	拓跋焘抵达辽西，北燕王冯弘派遣侍御史崔聘，呈上美酒牛肉，犒赏北魏军队
已巳，魏主至和龙	己巳，拓跋焘抵达和龙
庚午，以领军将军殷景仁为尚书仆射，太子詹事刘湛为领军将军	庚午，刘宋任命领军将军殷景仁为尚书仆射，太子詹事刘湛为领军将军
燕石城太守李崇等十郡降于魏	北燕石城太守李崇等十个郡，投降了北魏大军
魏主发其民三万穿围堑以守和龙	北魏国主拓跋焘，征发北燕百姓三万人，兴筑工事，挖掘濠沟，守卫和龙城
崇，绩之子也	李崇是李绩的儿子
冬，十一月，乙巳，魏主还平城	冬季，十一月，乙巳，北魏国主拓跋焘返回平城
壬子，以少府中山甄法崇为益州刺史	壬子，刘宋朝廷任命少府中山人甄法崇为益州刺史
魏主征诸名士之未仕者，州郡多逼遣之	北魏国主拓跋焘，征召国内没有做官的知名人士，地方州郡官府多强行逼迫遣送
魏主闻之，下诏令守宰以礼申谕，任其进退，毋得逼遣	拓跋焘听到这个消息，立即颁下诏书，命令地方官要有礼节地传达皇上的旨意，让他们自己决定去留，不得强行遣送
裴方明等复出击程道养营，破之，焚其积聚	刘宋成都中兵参军裴方明等人再次出城进攻程道养的大营，大破叛军，然后纵火烧了叛军的军用物资
春，正月，乙卯，魏主遣永昌王健督诸军救辽西	春季，正月，乙卯，北魏国主拓跋焘派遣永昌王拓跋健督率各路兵马，赶赴辽西救援
己未，大赦	己未，刘宋下令大赦
二月，庚午，魏主以冯崇为都督幽・平・东夷诸军事、车骑大将军、幽・平二州牧，封辽西王，录其国尚书事，食辽西十郡，承制假授尚书、刺史、征虏已下官	二月，庚午，北魏国主拓跋焘任命冯崇为都督幽州、平州、东夷等地诸军事，车骑大将军，幽、平二州州牧等职，封为辽西王，以及录辽西封国尚书事，指定辽西十郡为他的采邑
	并可按照朝廷旧制有权任命尚书、刺
壬子，魏主还宫	壬子，北魏国主拓跋焘回宫
赵广等自广汉至郫，连营百数	赵广等人从广汉来到郫县，构筑阵地，数百个营盘互相连接
周籍之与裴方明等合兵攻郫，克之，进击广等于广汉，广等走还涪及五城	周籍之和裴方明等合兵一处，共同进攻郫县，攻克郫县后，又进兵广汉击败了赵广，赵广等人先后逃回涪城和五城
夏，四月，戊寅，始发刘道济丧	夏季，四月，戊寅，裴方明等才发布刘道济的死讯
凉王蒙逊病甚，国人共议，以世子菩提幼弱，立菩提之兄敦煌太守牧犍为世子，加中外都督、大将军、录尚书事	北凉王沮渠蒙逊病情严重，国内贵族和大臣们共同商议，认为世子沮渠菩提年纪幼小，决定立沮渠菩提的哥哥、敦煌太守沮渠牧犍为世子，并加授沮渠牧犍为中外都督、大将军、录尚书事
蒙逊卒，谥曰武宣王，庙号太祖	不久，沮渠蒙逊去世，谥号为武宣王，庙号称太祖
牧犍即河西王位，大赦，改元永和	沮渠牧犍继承王位，下令大赦，改年号为永和
立子封坛为世子，加抚军大将军、录尚书事	又立自己的儿子沮渠封坛为世子，加授抚军大将军、录尚书事
遣使请命于魏	沮渠牧犍又派使节前往北魏，请求任命
牧犍聪颖好学，和雅有度量，故国人立之	沮渠牧犍聪明好学，文雅和气，宽厚而有度量，所以贵族们拥护他登上王位
五月，己亥，魏主如山北	五月，己亥，北魏国主拓跋焘前往山北
六月，魏永昌王健、左仆射安原督诸军击和龙，将军楼别将五千骑围凡城	六月，北魏永昌王拓跋健、左仆射安原等督率各路军队进攻和龙，将军楼勃另外率五千骑兵围攻凡城
燕守将封羽以凡城降，收其三千余家而还	北燕凡城守将封羽，举献城池投降，北魏军裹胁凡城三千多家百姓班师
辛巳，魏人发秦、雍兵一万，筑小城于长安城内	辛巳，北魏朝廷征调秦州、雍州的士卒一万人，在长安城内另筑一小城
秋，八月，冯崇上表请说降其父，魏主不听	秋季，八月，冯崇上疏朝廷，请允许回国劝说他的父亲冯弘投降，拓跋焘不准
戊午，魏主遣兼大鸿胪崔赜持节拜氐王杨难当为征南大将军、开府仪同三司、秦・梁二州牧、南秦王	戊午，北魏国主拓跋焘派兼大鸿胪崔赜携带符节任命氐王杨难当为征南大将军、开府仪同三司，兼任秦、梁二州牧，封为南秦王
赜，逞之子也	崔赜是崔逞的儿子
甲寅，魏主还宫	甲寅，北魏国主拓跋焘回宫
十二月，己巳，魏大赦	十二月，己巳，北魏实行大赦
辛未，魏主如阴山之北	辛未，拓跋焘前往阴山之北
魏宁朔将军卢玄来聘	北魏宁朔将军卢玄来刘宋访问
魏立徐州于外黄，以刁雍为刺史	北魏在外黄设置徐州，任命刁雍为徐州刺史
己卯，魏主还宫	己卯北魏国主拓跋焘回宫
甄法护坐委镇，赐死于狱	刘宋前任梁州、南秦州刺史甄法护，因弃城逃走，被朝廷强令在狱中自尽
杨难当遣使奉表谢罪，帝下诏赦之	氐王杨难当派使节，携奏章前往刘宋谢罪，刘宋文帝下诏赦免他
河西王牧犍遣使上表，告嗣位	北凉王沮渠牧犍派人出使刘宋，呈上奏章，报告他已继位
戊寅，诏以牧犍为都督凉・秦等四州诸军事、征西大将军、凉州刺史、河西王	戊寅，刘宋文帝下诏，任命沮渠牧犍为都督凉、秦等四州诸军事，兼任征西大将军、凉州刺史，封河西王
六月，甲辰，魏主还宫	六月，甲辰，北魏国主拓跋焘回宫
秋，七月，壬午	秋季，七月，壬午，北魏国主拓跋焘抵达美稷，又前往隰城
魏主如美稷，遂至隰城，命阳平王它督诸军击山胡白龙于西河	在那里，拓跋焘下令阳平王拓跋它，督率各路兵马在西河进攻山胡部落酋长白龙
它，熙之子也	拓跋它是拓跋熙的儿子
春，正月，己未朔，日有食之	春季，正月，己未朔，出现日食
辛酉，大赦	辛酉，刘宋实行大赦
辛未，上祀南郊	辛未，刘宋文帝赴南郊祭祀天神
甲申，魏大赦，改元太延	甲申，北魏实行大赦，改年号为太延
二月，丁未，魏主还宫	二月，丁未，北魏国主拓跋焘回宫
燕王遣右卫将军孙德来乞师	北燕王冯弘派右卫将军到刘宋，乞求派兵救援
甲戌，魏主如云中	甲戌，拓跋焘前往云中
戊申，魏主命骠骑大将军乐平王丕、镇东大将军徒河屈垣等帅骑四万伐燕	戊申，北魏国主拓跋焘命令骠骑大将军、乐平王拓跋丕，镇东大将军徒河人屈垣等率领骑兵四万人攻打北燕
秋，七月，魏主畋于阳	秋季，七月，北魏国主拓跋焘在阳狩猎
魏秦州刺史薛谨击吐没骨，灭之	北魏秦州刺史薛谨，袭击吐没骨部落，彻底消灭了该部落
杨难当释杨保宗之囚，使镇童亭	氐王杨难当，释放了被囚禁的侄儿杨保宗，命令他镇守童亭
春，正月，癸丑朔，上有疾，不朝会	春季，正月，癸丑朔，刘宋文帝患病，不举行朝会
甲寅，魏主还宫	甲寅，北魏国主拓跋焘回宫
夏，四月，魏娥清、古弼攻燕白狼城，克之	夏季，四月，北魏大将娥清、古弼围攻北燕的白狼城，一举攻克
丁卯，魏主如河西	丁卯，北魏国主拓跋焘前往河西
魏散骑侍郎游雅来聘	北魏散骑侍郎游雅到刘宋访问
八月，魏主畋于河西	八月，北魏国主拓跋焘在河西狩猎
魏主遣广平公张黎发定州兵一万二千通莎泉道	北魏国主拓跋焘派广平公张黎征调定州的军队一万二千人，开通莎泉大道
癸丑，封皇子浚为始兴王，骏为武陵王	癸丑，刘宋文帝封皇子刘浚为始兴王，刘骏为武陵王
柔然与魏绝和亲，犯魏边	柔然汗国与北魏断绝了和亲友好关系，开始骚扰北魏的边境
吐谷浑惠王慕卒，弟慕利延立	吐谷浑汗国可汗慕容慕去世，他的弟弟慕容慕利延继承汗位
春，正月，戊子，魏北平宣王长孙嵩卒	春季，正月，戊子，北魏北平王长孙嵩去世
辛卯，大赦	辛卯，刘宋实行大赦
二月，乙卯，魏主如幽州	二月，乙卯，北魏国主拓跋焘前往幽州
三月，丁丑，魏主以南平王浑为镇东大将军、仪同三司，镇和龙	三月，丁丑，拓跋焘任命南平王拓跋浑为镇东大将军、仪同三司，镇守和龙
己卯，还宫	己卯，拓跋焘回宫
夏，四月，赵广、张寻、梁显等各帅众降；别将王道恩斩程道养，送首，余党悉平	夏季，四月，益州叛民领袖赵广、张寻、梁显等人帅众投降了朝廷
丁未	别将王道恩斩杀了程道养，送程道养的人头进京，程道养的余党被平定
以辅国将军周籍之为益州刺史	丁未，刘宋朝廷任命辅国将军周籍之为益州刺史
丙申，魏主如云中	丙申，北魏国主拓跋焘前往云中
秋，七月，戊子，魏永昌王健等讨山胡白龙余党于西河，灭之	秋季，七月，戊子，北魏永昌王拓跋健等讨伐山胡部落酋长白龙的余党所据守的西河，彻底消灭了他们
丁酉，魏主遣使者拜吐谷浑王慕利延为镇西大将军、仪同三司，改封西平王	丁酉，拓跋焘派使臣出使吐谷浑汗国，封新即位的吐谷浑可汗慕容慕利延为镇西大将军、仪同三司，改封为西平王
春，二月，丁未，以吐谷浑王慕利延为都督西秦・河・沙三州诸军事、镇西大将军、西秦・河二州刺史、陇西王	春季，二月，丁未，刘宋朝廷任命吐谷浑可汗慕容慕利延为都督西秦、河、沙三州诸军事，兼任征西大将军，西秦、河二州刺史，封陇西王
三月，癸未，魏主诏罢沙门年五十以下者	三月，癸未，北魏国主拓跋焘下诏命令五十岁以下的和尚，一律还俗
夏，四月，纳故黄门侍郎殷淳女为太子劭妃	夏季，四月，刘宋文帝迎娶已故黄门侍郎殷淳的女儿，为太子刘劭的正妃
五月，戊寅，魏大赦	五月，戊寅，北魏实行大赦
冬，十一月，丁卯朔，日有食之	冬季，十一月，丁卯朔，发生日食
十二月，丁巳，魏主至平城	十二月，丁巳，北魏国主拓跋焘抵达平城
春，正月，庚寅，司徒义康进位大将军、领司徒，南兖州刺史、江夏王义恭进位司空	春季，正月，庚寅，刘宋朝廷提升司徒刘义康为大将军，仍兼任司徒职务；提升南兖州刺史、江夏王刘义恭为司空
魏主如定州	北魏国主拓跋焘前往定州
辛未，魏主还宫	辛未，北魏国主拓跋焘回宫
己酉，改封陇西王吐谷浑慕利延为河南王	己酉，刘宋改封陇西王吐谷浑可汗慕容慕利延为河南王
庚子，立皇子铄为南平王	庚子，刘宋立皇子刘铄为南平王
癸亥，秃发保周帅诸部鲜卑据张掖叛魏	癸亥，北魏张掖王秃发保周，据守张掖叛变
吐谷浑王慕利延闻魏克凉州，大惧，帅众西遁，逾沙漠	吐谷浑可汗慕容慕利延，听说北魏已经攻克凉州，大为惊恐，率领他的部众向西逃去，越过了沙漠
魏主以其兄慕有擒赫连定之功，遣使抚谕之，慕利延乃还故地	北魏国主拓跋焘因为谷浑可汗的哥哥慕容慕有生擒并呈献赫连定的功劳，因此派使臣招抚逃走的吐谷浑可汗慕容慕利延，慕容慕利延才率部众返回故地
氐王杨难当将兵数万寇魏上，秦州人多应之	氐王杨难当率兵几万人进犯北魏的上，秦州百姓响应他的很多
东平吕罗汉说镇将拓跋意头曰：难当众盛，今不出战，示之以弱，众情离沮，不可守也	东平人吕罗汉劝说北魏的守将拓跋意头说：杨难当势力正强盛，现在不出城迎战，向敌人示弱，我军士气将受挫折，军民就会离散，那时城池就守不住了
意头遣罗汉将精骑千余出冲难当陈，所向披靡，杀其左右骑八人，难当大惊	拓跋意头就派吕罗汉率领精锐骑兵一千多人，出城冲击杨难当的战阵，北魏骑兵所向披靡，斩杀杨难当左右亲兵共八人，杨难当大为惊慌
会魏主以玺书责让难当，难当引还仇池	这时，拓跋焘斥责杨难当的诏书也到了，杨难当于是率众退回了仇池
南丰太妃司马氏卒，故营阳王之后也	刘宋南丰太妃司马氏去世，司马氏是已故营阳王刘义符的王后
赵广、张寻等复谋反，伏诛	被招抚的刘宋叛民首领赵广、张寻等，再度反叛朝廷，被斩首
二月，魏假通直常侍邢颖来聘	二月，北魏的通直常侍邢颖，来刘宋访问
三月，沮渠无讳拔酒泉	三月，沮渠无讳攻克酒泉
夏，四月，戊午朔，日有食之	夏季，四月，戊午朔，出现日食
秋，七月，己丑，魏永昌王健击破秃发保周于番禾；保周走，遣安南将军尉眷追之	秋季，七月，己丑，北魏永昌王拓跋健在番禾击败了秃发保周；秃发保周逃走，拓跋健派安南将军尉眷追击
丙申，魏太后窦氏殂	丙申，北魏皇太后窦氏去世
壬子，皇后袁氏殂	壬子，刘宋皇后袁氏去世
癸丑，秃发保周穷迫自杀	癸丑，秃发保周走投无路，自杀
九月，壬子，葬元皇后	壬子，刘宋安葬袁皇后
十一月，丁亥，魏主如山北	十一月，丁亥，北魏国主前往山北
大秦王杨难当复称武都王	自称为大秦王的氐王杨难当，又恢复旧号，称武都王
春，正月，癸卯，魏以沮渠无讳为征西大将军、凉州牧、酒泉王	春季，正月，癸卯，北魏朝廷任命沮渠无讳为征西大将军、凉州牧、酒泉王
辛亥，魏赐郁久闾乞列归爵为朔方王，沮渠万年为张掖王	辛亥，北魏封柔然汗国郁久闾乞列归为朔方王，封沮渠万年为张掖王
秋，八月，辛亥，魏遣散骑侍郎张伟来聘	秋季，八月，辛亥，北魏派散骑侍郎张伟出访刘宋
九月，戊戌，魏永昌王健卒	九月，戊戌，北魏永昌王拓跋健去世
冬，十一月，戊子，王球卒	冬季，十一月，戊子，刘宋仆射球去世
己亥，以丹杨尹孟为尚书仆射	己亥，刘宋朝廷任命丹杨尹孟为尚书仆射
晋宁太守松子反，宁州刺史徐循讨平之	刘宋晋宁太守松子谋反，宁州刺史徐循镇压了叛军
魏寇谦之言于魏主曰：今陛下以真君御世，建静轮天宫之法，开古以来，未之有也	北魏道士寇谦之对北魏国主拓跋焘说：现在陛下是以真君的名义统治天下，建立静轮天宫大法，这是开天辟地以来从未有过的事
应登受符书以彰圣德	应该登台接受符书表彰和宣扬皇上圣明的恩德
帝从之	拓跋焘同意了
